uuid,name,chinese,math,english,physics,chemistry,biology,sum,
663aee82-35bc-4fac-a0d9-74bbb9bdae51,Aaden,40,7,42,43,97,30,259,
5b0160bb-5968-4151-aeb6-b3b50ce755cd,Aadhya,77,97,35,51,16,78,354,
ba606248-d4da-4c30-872a-cce20df7dde5,Aadhya,81,1,56,44,66,73,321,
a71b275f-63b3-49c3-bccf-fcc0eae49ffb,Aakash,46,19,97,82,32,30,306,
73098eef-f16f-42d2-8a90-bbb48d2ec325,Aakash,34,88,42,71,69,88,392,
b8d66be9-f699-404c-88c1-d48c36bc78c5,Aaleah,52,32,14,94,41,37,270,
4b66b9fe-b6d3-4f3d-8998-e113148d031f,Aaliyha,47,17,58,36,76,30,264,
b23567b5-2d0f-4f60-9f7d-40d7a19dd797,Aalliyah,76,51,83,90,48,70,418,
be934f15-1bb7-4687-adef-7178c1a2845d,Aalyiah,94,40,42,11,5,30,222,
40b8a238-44bb-4cb4-bd4f-8241652c1cdb,Aamina,54,22,71,39,12,99,297,
82c7bafd-d4d1-4feb-be98-2c303a425bb6,Aarav,69,29,94,24,63,86,365,
d36d53ab-ce6d-4be1-9e13-b918d7278db5,Aaric,97,47,99,25,39,10,317,
7b9ecc42-2ee5-459f-ba22-1492092b4664,Aariz,61,50,37,59,87,0,294,
6e42f4ad-e31b-48bd-8cd9-c05b8012e292,Aarushi,10,20,72,17,57,76,252,
5ac51492-0f84-4366-b138-209f24ecb4a4,Aashi,67,10,63,33,38,54,265,
bf27bf26-9a3b-4679-814c-6439fcd4a6da,Aashritha,46,56,92,17,57,31,299,
084f218f-e093-4094-be4f-0951432f7faf,Aayat,81,25,92,56,23,4,281,
db92fc5b-541f-4b36-a2b0-f7f1c11201f4,Aayush,39,11,39,12,21,71,193,
46b39e1b-c80c-4afd-93da-57edefccb125,Abagayle,41,48,62,39,65,50,305,
26a162ab-6d0e-4dd3-9a64-bf501f4d39ea,Abbie,97,52,21,58,25,31,284,
8b8072f3-084d-4f3d-b025-8d8466feff23,Abbie,42,63,11,29,81,27,253,
9b7d60e7-0ef4-47fa-9e25-7b962abb7a59,Abbott,82,97,65,55,13,24,336,
82a0dd1f-dbc3-4619-8b95-79ccd599d332,Abby,84,55,90,82,45,99,455,
756b3dd6-81fb-441d-9823-8db04e40dba1,Abbye,28,11,3,40,77,82,241,
7af042c3-0779-4e67-bc5f-7b62608e145a,Abcde,37,80,44,34,31,58,284,
e4768f6c-2810-429b-b601-a1dca77373cc,Abdel,70,83,73,92,88,15,421,
168befca-4383-4ea7-8331-16146d488593,Abdias,52,9,74,81,64,22,302,
952b426d-4f7a-4e43-9e96-a9772b84374e,Abdiaziz,82,21,89,18,4,23,237,
15adc3f0-2745-433b-b972-7720abd6cbd3,Abdiaziz,97,68,61,8,73,76,383,
5f749da6-e50c-409b-8712-d37e35aa6922,Abdimalik,49,70,64,66,83,1,333,
c22b4361-9975-48cb-b8bf-9e74573dd84b,Abdirahman,7,79,1,99,17,46,249,
17aca2ec-0e8e-439f-877e-9ce409a254f4,Abdishakur,5,93,43,45,50,44,280,
7b1517c4-79e7-4927-abd9-537483e6e717,Abdon,11,84,61,22,100,70,348,
ef362212-7f86-4a98-ae1f-55396712b7d9,Abdoul,100,78,1,60,2,77,318,
7fb415fe-7b19-40ef-950f-d01f8f769abd,Abdulahi,54,25,71,47,69,82,348,
38adddc5-94dc-4f1f-937a-0f517aca9b57,Abelina,60,90,22,2,91,5,270,
50b347c9-66a1-4099-8f13-563af4d3f662,Abelino,39,58,20,47,82,13,259,
9510b669-01f9-47cb-9baa-40be06c7e1d2,Abhiram,83,32,59,38,14,71,297,
83c8fe27-43e1-455f-b371-3b3f40227cd6,Abigaelle,38,67,56,62,100,44,367,
78f89276-61fb-4eae-af23-060f82bf3a1f,Abou,78,28,64,99,34,59,362,
8aea44bc-22c7-4ee8-9efa-b5e8a3df3c7e,Aboubacar,6,35,13,34,22,94,204,
117d2acd-0e45-4379-a0fc-36115326280a,Abrian,89,87,16,14,77,71,354,
80c82ede-5b17-48c8-8132-e334905b6cc0,Abubakr,82,7,66,36,89,70,350,
d63bb62b-602b-4900-ad19-0eeeb1c60a5d,Abubakr,99,22,75,57,9,68,330,
2d0934c7-30de-4f81-a8d7-6979ba46ccdb,Aby,38,2,86,7,100,52,285,
76a303ae-4296-4ac6-ac36-faedf03247ad,Aby,50,29,49,100,96,82,406,
b6484a2f-a91a-4f58-a9a2-86073d9f4a54,Acacia,68,49,37,10,47,7,218,
fcb894b3-1591-4b82-bd38-860b935bee44,Acelin,64,40,6,75,60,37,282,
5ad93a73-659d-40b0-8f4a-d22789078de2,Acen,80,38,99,62,60,29,368,
c42047c7-c2df-4429-9f4d-fac1cdd25256,Adah,8,97,41,55,36,79,316,
72a68338-1050-4834-99e1-18720d6c23fa,Adalee,94,96,97,92,51,31,461,
c0c48364-356e-4d13-a23d-83ad28da167a,Adalhi,21,32,22,84,68,95,322,
faeb4044-3977-4e1d-98fe-c0e7ac4f8487,Adalin,23,97,41,46,77,42,326,
69b92cc3-7cc3-4547-9b91-c8929b283bea,Adalina,61,32,60,58,1,5,217,
2b6336e5-323a-441f-b37c-eb98add95063,Adalina,58,46,85,35,27,45,296,
7ccfb47c-9a4f-4cf0-b5c8-47f8a73790eb,Adaly,74,73,78,46,61,43,375,
44e5b086-5416-4a6b-9247-95673688d9f4,Adalynne,17,68,85,9,22,15,216,
8542ae14-4026-488b-be71-abf099ab1e95,Adamarys,4,4,71,36,47,87,249,
68a8f531-dbbc-4da2-a758-f3ec4b68c08a,Adamarys,80,90,93,28,87,80,458,
6045ea5c-34c8-4243-8a7d-f01189283fcc,Adams,82,74,81,21,28,77,363,
dd4025fd-9310-4ce4-a8f4-b2908341738a,Adams,65,66,53,84,8,44,320,
976a7a8a-3994-4abb-8e68-b7f73b0ce830,Adarian,90,32,38,58,26,9,253,
6bd84e25-0b4a-455e-8f84-1d24ee4ab408,Addalynn,48,91,6,4,36,21,206,
77d50d88-d6f4-4b4e-adae-efbb6dcd9c24,Addie,11,76,96,0,55,78,316,
a3871e9d-aebf-4f98-9cb0-68caccb93a97,Addilyn,80,28,12,22,20,65,227,
3cfc7a1f-1e47-47fa-9a4b-b4697df5642a,Addilyn,5,4,24,13,21,16,83,
5f2eac54-458b-41bf-8550-c8159a89976a,Addysen,77,9,39,77,72,36,310,
73aba376-3eef-477b-a22e-e52deedcb116,Adeeb,19,43,55,10,16,14,157,
2c7bc1f4-4292-4d7d-baba-7121ec428252,Adelai,26,42,78,10,92,54,302,
4eec5b78-e2c8-4a49-940b-4889ab42e95e,Adelaide,7,6,5,16,96,26,156,
f9b709ce-55d4-458b-a86c-290f4df1eda0,Adele,25,57,21,70,99,42,314,
c8f8dac8-a588-471f-9d2d-2e4857337574,Adelfina,89,34,15,89,62,41,330,
4240a9f3-83f7-4da3-9190-1858c2da2ebc,Adelia,47,53,9,38,80,16,243,
a69b4368-56da-47e9-8181-cdf3c95c2974,Adeline,80,66,40,55,76,74,391,
c11d08b3-af11-4d40-9b22-d82118fd3ee4,Adelle,20,71,94,12,98,45,340,
874fbbb8-53c7-41d6-a776-15ed8bbc289c,Adelyn,34,87,49,52,67,3,292,
92655049-1d32-4459-bc83-f331639e7964,Adelyne,26,85,88,72,53,47,371,
66518586-9842-4420-880b-105a61d49785,Adelynne,70,7,24,57,48,49,255,
ab62da56-4283-4aeb-9681-4ba48b6d6614,Adem,83,87,53,20,73,80,396,
cea5575f-e272-4d50-abba-a474fb334c9d,Adeola,49,80,43,80,44,45,341,
6a7b6ec7-012b-47da-86f9-9b70ae26ac08,Adessa,6,22,90,97,98,56,369,
5d3c269f-0a6f-4284-8067-035252fff83f,Adger,0,20,75,70,12,89,266,
f06fdd14-7055-406c-8367-68eea4fc7a93,Adhvik,48,48,99,84,45,84,408,
27c342a3-da1b-46f6-bd96-b2bf18d49c61,Adia,10,62,90,12,100,9,283,
9e9b1552-90d0-4513-8e18-bfb2767d128d,Adian,37,36,29,39,19,59,219,
a5d39a30-1c33-4bb7-a645-9113634cfff6,Adianez,0,67,83,14,2,10,176,
391f8505-4eaa-4d0e-851c-f7e2e3921842,Adien,54,58,13,29,93,46,293,
4bbad1af-2a17-4319-b56f-00f14e14105e,Adilee,87,9,76,31,34,2,239,
551d1519-bf80-4ed7-8b01-e1824607ad04,Adilee,98,98,68,82,91,94,531,
48a5a7eb-c307-45fb-9379-7a05ed762afe,Adileni,47,1,64,19,99,23,253,
393844fa-6fd4-41ee-b1c6-8a3b0710d6fc,Adit,76,8,39,53,24,3,203,
ef7f9a87-c6bf-4a27-91fe-89b67401538d,Aditi,63,18,30,54,59,85,309,
85cf0be6-bb22-4942-b7f3-c3c1134ab2f2,Aditya,8,16,23,46,19,35,147,
23b89575-17a1-4cbc-8a28-c1d1f3950e75,Aditya,47,60,40,41,36,96,320,
329573c4-f11e-4cc4-93d7-292d7db74235,Adja,59,3,48,17,62,32,221,
a8e5b650-0e9a-4ec4-b5e2-f44fc3308e0c,Adlai,72,51,23,80,64,48,338,
0dcebf0e-88ec-4a1c-98d8-ed77202a4b53,Adlai,15,42,35,20,46,54,212,
5b74da66-c5a6-427d-9d6d-b9aa0df1094f,Adleigh,10,98,81,23,55,16,283,
b78cecee-da12-4590-82c5-75ad6830bc24,Adley,63,1,9,86,4,59,222,
386f66c6-3b42-46f2-9930-8528ee5b558d,Adline,92,80,63,13,60,40,348,
6a7c2948-a37c-4870-aafe-d67c8d51f90d,Adline,73,24,49,78,7,23,254,
5c0ba1ea-c9a5-4585-9ae6-3a87525cb331,Adolph,86,7,75,65,42,81,356,
c7348c4d-7477-4bc6-9870-d454cdad6cc2,Adon,56,94,70,52,74,77,423,
70dc976e-f930-45c7-bf40-48734d3e6659,Adrean,63,69,69,0,54,12,267,
f7f85bca-dd5b-4ce8-ab13-4a462bf28041,Adreanna,76,85,54,97,72,63,447,
33aac347-765a-4837-91f5-20b5b67a5817,Adreena,57,5,31,61,93,36,283,
adfb338e-86c1-4a6c-89b3-e238af636b7c,Adria,9,13,99,11,36,40,208,
404187d1-147f-45bc-af0e-c90875faf089,Adriano,16,37,49,2,50,44,198,
545b02b7-31f3-4829-aae9-ad7559a1e520,Adrina,4,16,29,57,64,98,268,
09efba3c-e7a6-45f3-a174-7f72246c559a,Adrion,8,26,77,5,57,17,190,
272325ab-63ac-4046-adf7-44c1031d3718,Adrion,46,91,17,41,56,11,262,
b0354620-3ea0-48c6-94bb-0f9986c8fc78,Adron,25,29,85,64,38,100,341,
1ad30a34-2810-4bf6-bc10-85019cedb92c,Adryana,85,15,86,90,68,17,361,
a6888a73-15f7-47d0-9ec6-e306f88a7cb5,Advait,53,80,21,69,84,99,406,
69864d23-6fb4-4921-a055-212c740c507d,Advaith,99,77,43,34,10,45,308,
fb778918-1819-486a-bb06-90a1198c4ddf,Advay,97,8,88,54,48,13,308,
8d985bd9-8a85-4779-95a2-f22258c52ad2,Advik,14,0,16,42,7,37,116,
3ecd4fc4-ad38-4670-9e2b-90d4fcbe0248,Advika,71,14,46,23,63,66,283,
02dfe091-9634-402c-92f1-b0f3cf0c3ffb,Adwoa,68,44,5,55,50,39,261,
a18f7252-ea0f-4854-b29c-a11bd061981a,Adyline,90,26,37,11,96,95,355,
3536841a-d822-43a7-a2cf-66b5577b48a9,Adyline,68,1,61,64,80,83,357,
c1a7e7ed-13b5-4bc0-86f8-6ca7023731ff,Adysen,81,89,86,85,43,6,390,
055eda28-67f8-4562-9598-b2b1d1304478,Aeden,2,51,54,63,93,53,316,
79ebd9d5-849b-44f3-99b6-5f4ee6b91a18,Aela,21,35,41,71,99,10,277,
c91c5935-0c7f-46cc-8625-be799cd8004f,Aerabella,37,12,29,43,52,8,181,
65c274fa-87db-4ef4-a818-1d995d0c0c2d,Aeriana,76,39,45,62,58,84,364,
fcec8bcb-ef6e-4dbf-8b8f-537640282e7a,Aerick,57,5,45,67,45,20,239,
1804c1a5-7ef7-4c4d-8840-a5884cd84102,Aeriel,19,54,39,39,47,51,249,
e05e9c39-8384-4596-a310-1634230ff341,Aeris,13,96,86,30,67,89,381,
a390d831-4326-4e0a-a0ee-535a4ded5328,Aeryn,42,81,56,99,74,43,395,
304d96cb-c7e7-493b-ac42-ab0e5ec40e26,Afra,95,36,98,4,20,39,292,
4e198be9-ea62-443f-bd9b-3926d88286a2,Afrika,60,22,72,19,28,19,220,
65bf3260-1572-4308-8c33-8ffc659e3a5b,Agastya,99,54,43,19,60,80,355,
9d7f7020-3c62-4100-a78e-2f74e855778d,Agatha,88,24,56,66,84,59,377,
21e17644-7875-4396-9ec9-d5779da8b6c6,Agness,33,99,9,40,10,49,240,
d850dfdd-1d87-4977-83d5-b1c6a1a9546d,Agnieszka,4,40,16,57,52,51,220,
62b63e8b-c24a-4364-8c66-c108bf02c644,Agostino,14,32,52,57,67,84,306,
6235e1e6-20f5-4760-900e-0cd68e2d61e9,Agueda,72,52,61,53,85,55,378,
0e6e0717-13fc-4db0-b7bd-3ef4d3a3bbec,Agustina,82,41,74,17,79,52,345,
828be11d-fc8f-4411-a6be-2adc7efffda8,Ahad,12,68,98,49,71,79,377,
4a0ff9f4-c5d5-426a-b20b-be843ff4eaed,Ahana,82,51,18,96,26,74,347,
4809ae69-155e-42a6-90c2-9aeac8a177eb,Ahlana,82,72,96,26,16,45,337,
177d5d56-af56-4275-80ce-c81d9c6caec7,Ahliyah,99,85,10,12,70,87,363,
8c0c3a5c-6161-4999-80e3-c0704dc464f7,Ahliyah,92,64,76,67,33,35,367,
815bfb23-f547-4caa-9393-9add1de2f3c9,Ahmari,89,47,2,37,14,51,240,
fa0f3180-15af-4a48-b445-3d8cc7d54153,Ahmed,76,31,49,45,79,51,331,
b1a8c2ad-bb0e-4b0d-a09a-13e9173552c7,Ahmod,45,36,86,85,8,45,305,
b1d6534a-d1ed-4ab5-a6c3-d5f34cedcbc1,Ahmya,77,35,25,79,17,33,266,
a7ec653d-7d3d-436b-8427-84b996f93fdf,Ahmya,59,93,95,7,97,49,400,
ef7e2d29-2181-4f1a-8751-6d44b6901978,Ahna,89,87,89,98,56,13,432,
28c6098d-059f-4fd3-b254-2d4f21572a05,Ahniya,44,94,75,54,68,25,360,
2a90aa51-3330-426f-8d93-171e0298f91e,Ahniyah,2,22,88,32,0,32,176,
88ef63f6-6b2b-4204-b407-ec33edec0eae,Ahtziri,20,11,23,38,17,96,205,
33777b23-75da-41ad-a6af-ef92f4471f2f,Ahtziri,27,97,43,6,1,22,196,
bd580303-931b-430a-af8b-b136f8e308dd,Aideen,68,29,8,37,38,99,279,
bec08326-5470-4b7a-8e5e-242f4d3e4648,Aideen,33,62,56,18,67,39,275,
9c4bf776-de5b-46ed-a514-e41cc82b02b1,Aidel,26,88,1,39,71,6,231,
f77e0971-7fc2-42f2-a060-8e9fd39e9415,Aidenn,64,86,40,63,57,26,336,
209b2180-d8fa-419e-ac09-7a6f44d51ae1,Aidenn,75,20,97,73,55,26,346,
536b0e2b-a994-43e9-bd37-f9b90b0a8897,Aidon,93,37,0,4,68,75,277,
a8d11140-f035-4f84-9968-2828bd04c6f7,Aidsa,77,16,21,15,42,20,191,
7c6ce436-887c-41cb-a7af-1e137579ad26,Aidyn,7,10,15,3,34,38,107,
1a824c1d-2980-492b-9df3-5cb85a187d9a,Aiesha,8,51,1,63,88,53,264,
033e8bf2-a11a-4e48-b24f-aeb23a5293a7,Aigner,82,9,29,26,30,47,223,
b43b4025-dd30-468c-bf58-cd272edb0f85,Aiken,36,62,95,23,66,70,352,
beab20d8-c7a3-43a8-af86-07853041da2e,Aileen,38,75,57,3,53,72,298,
6f6bfda3-79a2-49c1-a768-e5bbca66d7e4,Aileen,62,8,89,9,51,56,275,
9f11d677-b82f-4b70-abca-cfb3d279b4ab,Ailene,27,61,24,63,67,55,297,
7629a4ef-adb8-4773-8662-c109513ee8df,Ailene,75,97,19,31,20,62,304,
b7bfff13-a54c-4876-98de-e8bbb577545a,Ailish,53,19,31,65,83,67,318,
e0638238-13aa-4b0a-b0c3-1babd20da9f9,Ailynn,37,27,5,55,97,11,232,
0101ae4e-936b-4c02-afe1-5cb4d351d346,Aimar,84,57,12,89,24,93,359,
3f9cf877-8a56-4628-8940-aeb10a11fa3c,Aimee,55,92,0,27,63,54,291,
77d4461d-ce17-4677-b670-a22ecfcf8a74,Aimee,37,77,16,42,58,0,230,
6295ccfa-d00a-46a7-9a8d-008e32ac6ea0,Aimie,30,25,28,28,46,1,158,
acb0f0e7-8c22-4276-8710-8cefbfd32806,Ainsleigh,70,93,79,83,34,50,409,
e1e93448-aaa8-460b-9175-28f9a26842f1,Ainslie,99,94,25,56,82,98,454,
1df47b4c-d579-4eed-88d4-ffcff295f0d6,Airiana,30,24,43,10,54,92,253,
5dbee6fa-fe1e-41a2-8b7a-7c320e90224d,Airiel,68,69,22,47,86,36,328,
30a00492-2342-42f8-8720-d082d16f5c84,Airiel,26,22,51,81,6,40,226,
879069c0-619c-481c-9c67-6f530fe96895,Airyana,66,81,69,29,94,34,373,
c4eaf9e7-1f6d-4ca7-a459-56cc03bb5d6e,Airyana,12,75,67,63,6,34,257,
276af3ae-1053-4ed6-b617-b341e7615745,Aisa,81,21,80,6,89,5,282,
679a79ed-dac1-466b-b2c8-743f7694d77a,Aisa,4,14,40,77,14,89,238,
015b5ec8-3315-465f-af89-bc3bffb11910,Aisley,30,28,15,11,46,33,163,
ace91a30-36b1-433e-b927-07443cb1bfb2,Aixa,43,2,39,70,55,77,286,
86573365-61b3-475c-ba51-f7fb84ef7cda,Aixa,38,84,18,56,59,68,323,
8686945d-a976-41b3-a388-dd33e726805c,Aiyla,20,39,17,17,50,8,151,
b70b2fdd-ca81-4ea8-985c-d8dda8d2ffe6,Aiyla,41,67,0,77,57,91,333,
1c312ac2-2092-4902-abea-0611db6a7fc0,Aiysha,9,52,42,44,1,9,157,
72f16b8e-a6fc-4d6c-8cf7-03b704080d5f,Aj,52,17,4,97,15,36,221,
7a88ba46-da53-4bec-a1cd-572fd8670810,Ajah,85,3,67,7,14,39,215,
47f2853c-f78a-4153-b312-1a42a9ab6eeb,Ajah,8,74,16,53,95,84,330,
a509c202-5c94-4a34-927f-1093aca5a0bf,Ajah,77,45,69,95,71,7,364,
21b7b1d6-cda7-4227-92ee-92f86ebec7ed,Ajahni,46,75,62,73,61,61,378,
5d3ad9de-40cf-47f4-b07f-d6833fa06d76,Ajanae,24,59,99,86,31,26,325,
d4688093-00d2-4233-b2c5-a00cc950f40c,Ajane,3,58,43,69,74,35,282,
dc576ba5-905a-41e1-9bbe-8e48f637c6ab,Ajanee,10,66,10,30,19,40,175,
25b10c0d-93ff-4f3f-8edb-b387143727e9,Ajanee,42,88,41,70,84,90,415,
38f1c729-fc92-4153-9f4f-ca1925f5e4ed,Ajay,5,28,91,61,70,99,354,
fdb8e7bb-ee05-4616-af7f-a78e8923dab4,Ajayla,89,6,83,60,96,82,416,
8f69a75f-9758-4fed-ab46-5a51c33a8b31,Ajaysia,44,89,29,88,7,44,301,
4192e837-ccae-4651-b3a1-9a796a62cb8a,Akansha,30,52,85,70,66,40,343,
23094b12-36a4-49cc-8edb-077370789aa1,Akaysha,84,12,95,18,66,94,369,
7fa3039f-b63c-4e85-b31c-4ca5c1e4a657,Akeela,49,8,35,33,12,22,159,
3638893c-cc47-40b5-b594-1e777b601353,Akeelah,4,77,94,30,15,86,306,
eeba74df-827f-4265-a2a8-c397ed6e00a4,Akeem,62,54,83,30,36,23,288,
bdff4a45-14be-450e-994d-0bd7e6daaf9b,Akeem,0,76,31,75,91,41,314,
e2055e8c-0357-43eb-bd5a-c96fcdc1fb2e,Akeiba,43,7,24,57,14,68,213,
f32b494b-8ce8-44ee-98a3-72297456ef33,Akela,39,14,64,77,20,64,278,
48d84442-be07-481d-b400-160286664843,Akemi,67,47,15,76,15,40,260,
ef223126-9eab-49c8-8d74-2008ed5adb28,Akiba,14,3,97,17,50,90,271,
4d5ca311-5232-4953-91d9-4f165640ad63,Akiba,47,90,12,2,88,70,309,
5e8ddd5b-cbeb-45f5-b142-0c520501a10b,Akiem,87,28,36,94,29,87,361,
422d78cd-3fae-4115-b289-fec6ec6d6869,Akoni,12,13,96,54,25,48,248,
25d0c856-a3c9-410b-bba6-f0bb48a6b1c8,Akshaj,22,69,99,65,50,21,326,
2f0dc0af-33c6-43a1-b3c9-a88777762b72,Akshar,34,60,27,3,24,93,241,
fa854bfe-5be5-40b2-b44d-198c6c21980a,Akshara,57,24,22,73,47,43,266,
e4b58c1c-c220-421a-a4cc-ef210f9cfebd,Akshara,30,8,7,76,78,45,244,
b8c8c2d6-aaa9-4778-80f0-c85b63259e1a,Akshay,63,48,15,53,85,89,353,
46bfe4f3-100f-4c37-8cfe-986758c44474,Akshaya,16,65,44,25,17,94,261,
1fe72c6f-9a45-41f5-b47c-c5704bcbe67e,Alahni,64,80,46,66,81,72,409,
acde9700-fdd6-4e0f-9be1-c4c7410876da,Alain,40,17,38,77,86,34,292,
6ca5158e-e193-46a4-9ec4-273ccd418a29,Alainah,83,49,43,4,48,18,245,
3ee3ff3e-0940-4ee5-ba2b-8094e0c02f9a,Alainna,19,69,53,1,44,76,262,
e451a0f2-2bbd-4dd1-9e3b-8502c6e2b59a,Alakai,27,68,25,76,53,43,292,
b06f864d-3b1e-4596-a40a-3ad76df7fd39,Alandra,96,49,90,44,70,16,365,
78259ed0-615d-4593-ace5-4d2bcd8a9b32,Alandra,81,21,20,29,11,72,234,
1b9cb274-0bec-4ccc-b250-bd2b70c37f49,Alandra,64,71,93,79,41,18,366,
92e0af74-3d62-4aae-b621-a0251f64637b,Alanmichael,66,64,45,23,74,20,292,
bbb085d3-a753-4330-b21d-ee39b421e633,Alanna,14,53,78,47,48,0,240,
274bec35-65ca-45be-a726-b8a4bf863969,Alanna,80,17,36,18,54,78,283,
a185cbf4-66b0-48a1-82ab-2798f7d4cd1e,Alante,28,49,71,94,26,24,292,
0fdd9013-68f0-4d31-955b-83de988a7657,Alany,78,91,15,44,63,55,346,
6763f451-c770-49f1-9b97-d2638b8af9f3,Alara,42,32,72,4,22,26,198,
1b31c968-73dc-4a19-99aa-eb2cf87e320f,Alasia,47,47,99,51,31,90,365,
31037fc6-f25c-4259-9363-d90f678d3be8,Alasia,44,6,7,75,26,16,174,
dd5f6c5d-b201-4a29-84ab-44a01b58df62,Alauna,92,98,5,17,32,75,319,
91be09dd-94c3-451e-9c00-351a0ec88ac9,Alayia,0,29,33,81,95,17,255,
105b5a8a-bd31-4eb4-aa68-edbf233e09b5,Alayia,16,41,24,11,41,32,165,
60b9b95b-1b48-47ef-9905-ec9b43fc7cfb,Alayne,18,32,36,91,8,95,280,
c394a542-9a44-4e3b-980d-89b6fc700643,Alayssa,67,55,53,9,15,75,274,
4bb4c711-4dad-4732-93ec-1e1729d4d46f,Alazae,36,69,94,62,85,18,364,
9a9b4801-6914-411c-b4fd-abad31df3efb,Alban,85,57,5,88,56,47,338,
d9ca7feb-a6b5-4d30-a9c6-fd78550b4784,Albertha,84,48,32,75,9,81,329,
44ceb4b7-6836-4718-8f23-3f492479411d,Alberto,50,35,80,63,12,11,251,
39a4b229-b42e-4703-a616-e0b3ce3bdc32,Albina,74,47,37,56,94,70,378,
0ebe1113-dfb6-45f0-bf77-2d8dfd44092f,Albirda,8,42,50,39,7,16,162,
7b6ba866-b7c3-4567-a590-932feb5f7c91,Albirta,62,2,90,74,50,67,345,
fe013120-e30b-47d1-a70b-90a6cd8afcf1,Alcario,46,62,87,18,36,29,278,
8fcae699-0d96-47b8-92c2-54cd628d870d,Alcide,56,54,23,93,28,62,316,
0c78f2c3-fa1a-49d0-b8f9-c517acb79ce9,Alcides,58,51,77,1,73,84,344,
b126dff1-5ff8-427f-af8c-d0a378cb4af9,Alcides,77,67,30,83,33,80,370,
4a723c55-6f46-4593-963e-1f08fa31e195,Aldah,72,35,75,91,50,47,370,
5f25daca-adb3-4c60-a82b-181219bf87e7,Aldair,79,26,54,63,100,82,404,
07796a2d-f269-42f0-8c41-e7619138206f,Aldea,39,28,37,2,38,20,164,
7d5b3bb8-b377-41c4-bb8c-e34669591cfb,Aldin,99,47,32,59,10,46,293,
e8a811e4-6f36-484e-90a7-3d6b79d90fc2,Aldona,50,85,44,1,80,53,313,
7b223fdb-8939-4f96-b0eb-bf0b09940191,Aldona,96,67,7,60,9,55,294,
cd8915c9-8e70-4302-af1a-0c5f311bb22d,Aldor,64,91,90,99,50,74,468,
a219477e-4529-45f7-a8c6-dd18d39d0d39,Aleaha,72,63,0,20,75,77,307,
9b22a3bb-b64d-4ac3-8bd0-48c1dc39eab1,Alec,4,14,47,11,91,97,264,
fda09e19-27c4-4548-ba17-1411e7d48392,Alecxis,31,22,29,7,1,91,181,
1421cd2d-e70e-4023-9e17-db60d39f828e,Aleda,17,64,70,68,20,42,281,
d3fb6a18-cd6d-49c2-9e8e-6dc251b68876,Aleeah,70,41,30,33,86,100,360,
d64be04a-bf03-44cc-b843-b4fdfc9817bc,Aleen,54,84,19,63,42,75,337,
5221991b-380e-49e1-bb31-214facb55adc,Aleeyah,24,20,72,84,87,58,345,
ea30bf34-aa05-48ec-a339-e93ef79726ba,Aleina,11,67,100,61,70,86,395,
1d4bab69-4821-45d6-816e-8de1f9ac0924,Alejandr,54,100,54,75,13,42,338,
6aac7d0e-bc91-49a8-84ce-200ec6cab62b,Alejandrina,31,52,24,20,21,52,200,
8d30b373-124d-4169-9710-e46a5168edb5,Alejandro,19,60,37,83,1,68,268,
4cb21a71-867d-41cf-a5ad-243788443810,Aleksandr,30,41,36,90,13,89,299,
4f399dd7-616c-4953-aaa3-13b99fb7cc35,Alena,31,85,84,82,46,2,330,
068d4606-782a-4688-9424-ca1292da6d51,Alene,80,73,57,62,91,16,379,
ffe4e0f0-269a-4b53-8963-912d0bcefc73,Alenna,97,66,59,93,70,0,385,
dcad93cc-1c7e-46d9-81fe-6f1cd9605199,Alenna,66,40,10,2,37,99,254,
90ee4339-874a-423f-9fe2-731493f5c7cc,Alesa,5,30,44,90,56,77,302,
03b0b1fb-20a6-4023-9b2e-c99582f5b975,Alese,90,53,58,63,50,48,362,
f8c1edc2-256b-41c7-a31f-476b7f0f3e8c,Alessandra,24,54,61,18,82,71,310,
527f0aba-d719-41e8-8dcd-41f95e2f6e04,Alessandro,91,40,3,74,49,32,289,
7de044e8-3e3c-4883-b03d-e80d026fd7aa,Alessia,21,56,68,64,2,31,242,
0159ca66-18b3-4dfa-a359-cfcd2d0ea940,Alexanderjames,18,27,46,89,100,34,314,
7fbd0b2e-0f7c-4578-b794-ffb885881d0c,Alexandre,42,89,12,99,92,94,428,
c1830939-21e7-4121-9470-a07270eb90bf,Alexandro,76,70,70,63,87,73,439,
15987141-4cfd-41b8-aebe-2206ad5bd3b0,Alexcia,51,51,31,77,23,28,261,
43b239db-bea6-4037-b81f-f5e939b63202,Alexcis,92,60,92,45,55,64,408,
3a495128-9ff2-4551-8aa2-51ddb3db658a,Alexiana,78,32,21,85,60,44,320,
968434f7-b12c-4ccc-9f77-0442845a6270,Alexiana,21,51,80,13,0,42,207,
52c1ec50-c22c-4859-a7a5-1b3c35393de7,Alexis,78,32,12,99,20,26,267,
e080f155-5bac-4d58-a8e4-c91ef3cf09c2,Alexiz,62,100,31,47,56,78,374,
8e987cc1-b5d0-4460-ab1e-4aa7cabe621f,Alexsandra,37,63,91,67,97,100,455,
c8a23880-4514-439c-a823-8558637951f9,Alexssa,11,48,70,6,40,93,268,
cdd2bbf2-3946-4a4c-b4c4-f822d1670e78,Alexx,16,65,64,21,98,53,317,
d2276296-a0be-437b-be18-b6f4cf68b6f1,Alexxia,57,79,72,74,14,4,300,
aae5eb92-11a1-4294-be60-81e34380cf84,Alexxis,94,0,76,95,29,30,324,
a47e4b10-c717-44c5-9b0b-ce0e1c834b9e,Aleyah,100,81,25,39,7,35,287,
a14d1d2a-ede4-499e-ac1d-a029ddf7f841,Aleyna,50,30,65,18,5,5,173,
a46b7ce9-7661-4b0e-a892-22ea3a6b0b79,Aleysha,50,16,28,89,59,76,318,
2ab651d9-0c44-4773-8cdd-15acf8090496,Alezandra,95,40,41,82,82,12,352,
a2e6006d-0812-4262-91ba-596e8f1a0562,Alezandra,36,63,58,20,45,53,275,
3feea3c6-fd82-4cf9-ba98-be44044d884f,Alferd,3,100,0,7,84,79,273,
ca837c87-5588-475f-8587-90735bfe0517,Alfonzo,18,84,98,41,36,90,367,
b5464c37-9552-49d5-9585-9b55b3f9047a,Alfreda,98,6,80,66,56,55,361,
cb056681-b51a-43ac-a760-128a95ae455e,Algia,45,95,39,24,34,68,305,
194e8851-2eba-4698-b1e2-a0117b91120e,Algie,66,53,22,17,70,21,249,
db132bed-4c6a-4e25-a675-805c08356835,Aliana,88,81,0,92,60,45,366,
85d77cb2-6e28-4963-ba57-dd1c57f7e9c5,Aliana,83,58,47,24,92,70,374,
e39d5cb3-747d-4dc3-826e-c2d978d1c4c8,Aliannah,42,25,50,7,15,100,239,
a66c19b8-1afd-4910-afbb-753f03c19529,Alianny,46,34,42,80,61,49,312,
2ac8b4c2-85c3-4b7c-b030-7eb511fd774e,Alica,92,89,11,22,4,98,316,
df17dc5b-70be-4986-8d6d-f15f2a58b0a1,Alice,100,32,42,6,85,38,303,
31443b04-ed24-45c9-b89a-a1cf11b4b4cb,Aliciana,8,59,82,32,65,0,246,
4ceb7dd1-d62f-490c-a23b-4ff5b6efb607,Aliena,2,73,3,50,55,76,259,
4e18b6cf-1a35-435a-b4e4-0a500b95d380,Aliesha,49,55,87,91,5,46,333,
bb4488d3-1a6d-4b87-ae10-dda817bea1f4,Alif,67,61,100,41,99,23,391,
403291a5-2517-4b59-afd3-4c67db16eadc,Alif,25,69,98,72,3,48,315,
90ddf347-d67d-4821-b5ba-8c2bda2122a9,Alim,81,62,42,42,54,98,379,
c6c68a4a-9fa7-47d8-8deb-a6718cbd9105,Alim,60,99,77,24,28,94,382,
e299a3e0-9fbf-4dab-ad35-16efef908b28,Alin,99,50,8,62,30,45,294,
1b59c40d-836f-4965-8287-db7d9ae6c260,Alin,27,64,96,25,73,6,291,
bd99d9f1-1669-485c-8806-25d9e11d8513,Alin,83,33,19,74,34,25,268,
107f9b24-eea3-4ca1-af26-8b8f69f6f81b,Aline,62,7,80,72,40,8,269,
d83fbfd7-a4fb-4dc0-866e-c02e004d052c,Alishba,77,52,94,85,69,46,423,
926b3c4e-401f-4d65-aabe-a6f986ae055b,Alisia,0,87,68,17,18,96,286,
77e0985c-7151-4ddf-aa12-9c82a97e64d8,Alison,90,12,32,71,73,19,297,
83c3392e-b535-485c-8714-ac3d33f0696d,Alissandra,5,53,12,95,75,71,311,
ebe01cf5-2c92-4f56-96e6-8e9b4e2a21f1,Alissia,1,40,78,97,61,48,325,
fa15cfc8-1f33-48f5-91d7-df36c394099e,Alistair,92,85,73,85,24,2,361,
aac8a3a4-f783-4f92-bdfb-33d5af870c29,Alisyn,67,93,14,73,56,6,309,
099c29ad-2f80-4cee-80ca-0c49f81ae49e,Alivea,0,73,66,83,32,43,297,
e3330f08-579c-405c-884c-de7cfc86d827,Alivia,82,91,57,46,52,3,331,
0d82be81-cfba-4f7f-bdd5-c4e55bbdb09f,Alivia,60,80,71,13,84,27,335,
b7d0f6ce-1047-4394-8b37-b47085105f71,Aliya,65,75,20,30,24,63,277,
ddffba59-87fd-44fc-b6c2-c22d67c0c904,Aliyana,32,71,74,24,35,76,312,
3d820fde-bf67-45e0-88ac-6d166d4f4927,Aliz,65,84,68,15,30,76,338,
6f70b06b-cfbd-40e7-918c-c0b7bf921276,Alize,81,1,14,75,19,100,290,
ea11076f-eac5-417b-9f82-da41edf23cbe,Alizea,1,60,31,94,31,64,281,
65ecbdae-a6f7-4dcc-a615-865e3c6f4f6d,Alizey,55,69,67,80,95,69,435,
d3c06314-b3e2-4b59-a893-6f0605d0305b,Alizon,72,4,40,24,6,68,214,
6a2e6ecf-83bc-423a-b040-815fb0d3b2bc,Alla,32,34,33,46,5,46,196,
b2bf2429-7d4c-4b1e-837c-efb407a6ef5e,Allaina,12,19,45,85,64,64,289,
c1c3aa42-6214-4dfe-93a6-0964ca722656,Allana,37,40,47,96,16,89,325,
5ad83de8-a215-4837-9b1c-9f48b069d20b,Allante,88,11,25,73,62,59,318,
383d6807-0feb-4096-b23b-4aac04bbdd11,Alleen,7,8,36,20,51,0,122,
7a0045d9-e240-4068-a833-5410d52d5c84,Allena,16,10,46,45,55,16,188,
7ff6dc3a-33c9-4567-afb3-c20ce514fc9d,Allexis,39,89,15,5,44,37,229,
6e71aaa1-6659-44b6-b7a5-dd7e9177ad12,Allexis,94,31,23,94,50,81,373,
16ed550d-cd3a-48d2-b236-d20d8f168601,Alleyne,49,44,48,59,82,28,310,
1ee76204-36c1-4ec4-bdc8-768060b515c9,Allison,21,97,31,3,2,42,196,
9c834054-b02f-4c83-b0c9-fa67f6bf5f65,Allison,100,8,39,7,52,48,254,
5bd6f41e-6243-46bc-85b9-7a940c4a8c9b,Allison,73,0,69,89,55,27,313,
4f41c25d-170e-40b1-917c-bf6d7826388d,Allissa,92,40,74,93,18,90,407,
1af6a9f8-21df-45de-87a5-2c574adc1533,Ally,14,96,74,10,44,67,305,
81ddb0e9-183f-4174-8e87-34440496f3ff,Allyana,47,25,45,19,1,15,152,
7c860e87-7d74-4f27-84fd-13825d82c33d,Allyce,29,57,48,99,85,54,372,
2f3fe928-e624-463f-a574-21f0da030deb,Allyce,73,34,38,87,94,73,399,
7f86f9a6-05e1-4e54-ac9e-ddcd519bf629,Allycia,20,53,34,43,77,88,315,
01e39fd2-4a66-4589-88ce-69179d59ad6f,Allyne,6,55,64,44,88,61,318,
6aeb8503-f608-40d2-aef9-1c1935989849,Allyson,22,90,16,23,24,72,247,
89aaa63e-2cfb-4729-9b5a-5cb83f9da31c,Almarie,75,43,16,18,65,57,274,
a0bdfa49-1b3f-4d9e-83c6-d7c05eb4df2e,Almarie,35,66,15,28,3,39,186,
7b6390ec-1910-46a2-bab0-a42401bdac8d,Almeter,52,17,2,80,24,93,268,
4290098e-9f22-4339-baa6-a53d8c53a0e9,Almetta,42,29,40,11,64,95,281,
53467bc8-fb75-4c05-895c-3aa0a7b8ce88,Almir,54,39,69,40,77,50,329,
c996f0e9-c88b-4e32-a795-f975631e8c0b,Almond,82,7,33,85,91,99,397,
8e75073e-fddc-48c5-a036-391fe1ccea1b,Alondra,69,56,87,48,37,100,397,
d9ea27a4-68e7-434c-937a-00439f4acf12,Aloni,85,54,92,76,65,20,392,
ad4f521d-113e-4247-8b51-83995139d1e8,Alonso,74,61,26,23,15,81,280,
9c2ca75d-5571-4f84-bfa8-028d316233c4,Alonzo,19,57,34,11,94,20,235,
399c584a-0487-4404-a91c-b7fbb6952c27,Alora,69,84,91,56,63,37,400,
947b120f-5eeb-4f0d-9646-f694337f242b,Alp,16,50,16,38,99,61,280,
2e87419b-5d9e-4376-842d-8b9d765c285d,Alpheus,87,90,71,78,61,80,467,
9555c564-1e8a-4360-be9d-7901b4fb45fa,Altair,57,68,4,52,15,27,223,
1d2b1b9b-dde6-4001-8591-59edb682f3b7,Altamese,76,13,42,78,16,97,322,
d1fee38f-21f1-4291-874c-34e714c4efff,Altarik,63,88,54,44,51,26,326,
a8c38f1a-c911-4f9b-bbab-2ce4fa24a467,Althia,56,71,20,71,37,59,314,
d446d6ec-0aa7-4890-82ec-b35a216fcf13,Altie,85,87,33,95,72,90,462,
c17dd190-7a4c-47ce-b54c-334136cb63da,Altin,83,20,36,100,99,61,399,
98e4aff8-1809-4099-b43f-fccb567aec66,Alto,13,11,53,79,99,8,263,
fe18ec10-8e24-45a0-9dc5-dc7486b55f70,Altonio,73,98,0,54,51,12,288,
5a5786aa-230a-45cc-8304-66d27497c620,Alura,57,89,22,85,69,10,332,
45a53f09-7e53-4ca0-9af8-bf399768eebc,Alverda,6,7,59,52,49,96,269,
aa20cad0-80d5-461c-970e-85d90edcc59d,Alverna,32,81,85,68,30,74,370,
abf5d8d1-ca73-434d-83e6-d1b9d6022b83,Alvester,18,90,7,25,49,40,229,
f414c8fa-3d80-4297-8472-b138dc80f282,Alvey,18,97,74,100,94,4,387,
be4a8c6f-955e-4b44-9f0a-fc5ab6e269bc,Alvira,37,54,94,81,99,4,369,
682f726c-3b41-43ad-bc0f-c6988652e03f,Alwin,85,11,36,67,93,14,306,
4b3aa747-f077-4ce6-849a-457d2bf0efe6,Alyana,89,18,51,66,14,16,254,
50435c77-ef03-40d5-b7a8-1a60da5eac0c,Alyanna,21,60,26,100,63,41,311,
ce7e4957-ba85-427f-af5c-cf93e9d3c9d6,Alycia,8,45,5,81,78,33,250,
5fc3f6b0-8bcd-44a9-908b-a8500cad66d9,Alydia,76,48,66,92,3,24,309,
714edc65-404f-4284-b4cf-f9140413da2d,Alydia,91,1,42,92,3,8,237,
4b95a36b-46d7-431b-bc43-9c4b56128bca,Alyiah,58,5,91,18,34,24,230,
e4bc9df5-48dd-4e53-87dc-571b6de24fb6,Alyiah,76,77,24,51,75,64,367,
cd8bf3b9-a059-49b3-bd15-ec5a3605f3be,Alyissa,25,72,28,16,44,88,273,
f1b2fc7c-692d-4013-8bc2-4c676833ef22,Alyjah,84,98,9,56,30,7,284,
e6fbf20a-cebd-426b-a62a-1c931ba5f7a5,Alyjah,7,48,56,13,97,89,310,
52369b31-cd74-4305-86b7-f95a336e8df2,Alynna,37,32,68,51,72,91,351,
fbb09adc-f2c5-4267-bd01-46f5541a339c,Alysa,59,9,81,86,26,52,313,
a927cd1b-9b6c-4e14-904d-55e5e6ca6c69,Alyse,92,84,5,48,3,47,279,
51fcb191-aa18-4622-9d7f-cb36ad2d3e23,Alyse,57,20,43,88,15,44,267,
b980ded3-1bf4-40af-9a44-cde9120d5ff4,Alysen,61,15,50,6,78,36,246,
65607e3a-2537-43f7-b1e0-86f467452fcd,Alyson,15,75,98,73,40,9,310,
7efba340-9c6a-4340-ac52-d0b133f93b37,Alyss,16,61,74,99,53,23,326,
b8baac86-b501-4859-9ec2-096b27a16e64,Alyss,25,98,27,5,48,6,209,
3cd55853-aa22-42b7-ae77-045ffd83e3f3,Alyssamae,65,29,91,48,40,1,274,
ac53772c-5bc0-402f-a6ff-2788ae53ab5f,Alysse,25,90,27,94,100,17,353,
ac41de14-8859-4439-be9d-bfaa0c38909f,Alysson,30,91,61,64,62,83,391,
f4370858-68bd-456a-a12a-04ea63e7e9ec,Alyze,63,55,25,72,89,52,356,
ee8353f0-47c0-4906-9b27-bec6ecdca9c4,Alyze,55,7,100,99,83,10,354,
23c96b6b-178f-4bb8-a1f6-2ce0d0294588,Alyzea,68,63,0,82,4,67,284,
1da87467-9394-440a-87db-913e1f6c6556,Alyzza,71,1,100,0,70,35,277,
d7219356-ea7c-45d0-ae3b-5cc42d075760,Alzada,82,10,91,73,16,2,274,
4507f321-b1ec-47f9-af04-782cef8cee81,Alzina,15,18,66,27,73,21,220,
19bcfc56-f447-4f43-a546-9cd0446dcf7c,Amaar,44,74,16,28,33,81,276,
15298994-48bd-4b7d-9e75-efa893e06199,Amadeo,70,13,38,38,99,23,281,
47fcb9bb-c894-4c47-8325-a95385cb41f4,Amaiah,30,45,78,48,91,29,321,
903d8445-7bdb-4621-920c-f433677f0532,Amaira,71,68,25,98,67,36,365,
278502a9-6dee-4f3f-84f0-22e09d5e3036,Amairani,34,4,25,89,40,64,256,
5000c80e-3a1a-451c-8534-62a953fd3fa7,Amaiya,16,63,5,55,74,70,283,
c5f2db71-5b13-4617-9466-3eaabf3e7ca2,Amal,47,69,8,25,47,25,221,
dfdf24d1-4f17-4e4c-954d-e46fe99b74b5,Amalin,83,46,19,38,33,0,219,
d804a4de-ec64-4fb4-9f71-9b4c0d894d19,Amanada,53,6,73,83,36,87,338,
53c5456b-8608-4616-955d-ecaf18ecf3d2,Amando,37,68,76,95,1,87,364,
1c685880-1a8c-4561-beb2-cdce4d1b946e,Amar,10,25,2,49,93,45,224,
6349ee42-a341-4bcf-b0b6-6b89c75e272e,Amaranta,85,91,18,10,36,37,277,
b6716e9a-94cb-4558-b0d1-6f11f6ac5755,Amaree,46,52,99,76,59,42,374,
7daeb232-aba7-4f4e-9ba9-1136e4fe293c,Amariah,57,64,19,32,36,52,260,
3c7390f6-fb24-4286-b149-8dd45ddbeccf,Amariah,11,100,66,81,35,11,304,
0992a6cb-693e-4e3c-9522-48e7bbcde26e,Amariah,33,87,50,10,69,5,254,
296e15b3-b641-40b2-81e5-bc7e06fde563,Amariyon,9,51,26,32,95,72,285,
1f2a25e1-f781-468c-96cd-29b1727c754f,Amaru,40,74,89,62,94,42,401,
8c4a2304-92f7-4b46-b32a-8f8f270bd8aa,Amauris,2,60,35,32,57,34,220,
49538be7-2c83-4b07-a433-0de1c57e77ec,Amaury,60,59,85,13,74,26,317,
7858b857-f2bd-4d71-97d5-7d8fa3c7c45b,Amberle,83,2,3,70,13,15,186,
dc459434-9e0a-47da-80a7-b55727100960,Amberlea,79,49,83,36,55,48,350,
929774d8-3e8a-4671-a3af-9409fac7d6bc,Amberley,71,66,81,6,88,16,328,
631ca627-a355-42c6-84e1-734006e3a81d,Amberlie,54,74,40,31,0,77,276,
30434e3b-92f9-4006-832c-edc90da385f4,Amberlie,9,51,50,20,51,3,184,
3a4ff708-0850-46eb-a881-ceb9482f1d45,Ambra,27,54,31,65,37,56,270,
e4ab7389-7dd1-450c-a78f-7d1141461253,Ambre,99,40,65,76,23,21,324,
a18260c5-a0dc-4896-ad5d-8cbd812f4ecf,Ambrosia,24,68,73,6,85,65,321,
ad533a35-a8bb-4c82-85f9-ec79f810c062,Ambrosio,18,18,57,82,4,14,193,
b2ce07b4-930c-45d3-b4a4-8c0cbc0ad4fd,Amedeo,79,6,58,9,91,46,289,
b2c9b1d8-8130-43a4-aed8-ac1226c97046,Ameen,7,88,72,52,67,12,298,
4bc00746-706b-4ff7-803a-12a8c89e1753,Ameenah,6,40,89,58,75,27,295,
c76fef76-2b59-42f7-97d0-21a437aa673e,Ameet,15,72,8,87,7,69,258,
41bba29e-e733-40b7-b491-8765e666dd50,Ameir,71,70,93,2,41,26,303,
a6bb6ecb-a00a-45dd-81ab-ae0c28bb32f6,Amela,48,5,59,13,55,65,245,
add49d5e-3473-4fed-b2f5-6a37dc84b696,Amela,44,59,85,70,67,32,357,
9712d2c5-9115-4683-a77d-0b287c7b88f1,Ameliah,75,17,24,69,71,25,281,
d91ef709-7e2b-4cb3-b03c-9eec6e6394e3,Ameliya,90,25,14,0,69,2,200,
2bc40d09-f8e2-4845-9676-dbcd5da3fd43,Amellia,19,4,71,98,26,70,288,
f329abb6-e0a9-4519-956b-246f6da38954,Ameri,66,62,62,10,18,98,316,
da0ecfae-563d-4700-968c-f1df3594270b,Amerie,51,45,16,27,50,15,204,
beefd785-e9d3-467f-a6a7-bed92e131d30,Ameris,90,6,73,21,41,38,269,
f009c467-bca8-4da8-9506-4a852159dbbc,Ameris,38,26,24,31,0,24,143,
775f995d-2987-4a8c-b678-72530ac77197,Ames,29,46,27,90,67,83,342,
93f6250f-7f24-4d05-8905-5b1140c75230,Ami,71,52,14,47,12,20,216,
32fa6e4a-a4be-4bea-b041-0d612574c461,Amie,62,39,93,14,39,47,294,
cf1244ea-131e-4f95-9db7-c740968c3e98,Amiee,76,60,36,91,67,14,344,
9dcbe070-01a2-4e01-8212-56a911b8c0fe,Amier,20,20,36,52,42,98,268,
b954157c-d1c7-4e6c-9f59-f9aefb055574,Amil,6,52,91,11,60,3,223,
76f1270d-bae3-4a82-be50-bd32485ecdd5,Aminah,30,7,44,58,53,78,270,
7d0eaf56-1d5f-4747-9074-0388f1ea0b8c,Aminta,72,88,69,57,3,64,353,
45d83817-cdc7-476c-b3a1-057bef2c151e,Aminta,94,26,54,5,83,94,356,
895e4fcb-aef2-4465-9ece-9b1448948bd7,Amira,54,60,99,82,66,82,443,
2995989b-7e67-491d-b50f-92228054f886,Amira,91,52,56,87,42,84,412,
8ee2774d-77aa-44c6-9bc4-23cc73f8705e,Amirrah,59,65,41,97,55,49,366,
568d0bdc-7ddf-44e7-9664-81f15c6d2992,Amisha,54,95,32,22,16,79,298,
4720a449-8bc6-4c13-b460-bc1717e68628,Amit,89,34,2,68,81,35,309,
48d6b9f4-092e-4f17-a546-245690f83927,Amita,52,94,27,46,81,86,386,
dc7a157e-7690-4433-b6e1-eabdbbccf3de,Ammi,72,63,55,74,67,7,338,
b6bd05a4-74ea-4b6c-916f-3868f230d6ca,Ammon,89,99,10,10,61,41,310,
64997c38-7ca1-4b4a-b4f5-4b88bab8c0b9,Amonte,5,76,11,61,56,48,257,
e85acdd7-b206-4143-b02b-2187f26e0030,Amori,71,65,85,73,38,25,357,
495dadf5-63f1-4da8-b431-8684f92df8d3,Amparo,99,13,2,63,95,7,279,
0a43e304-416e-4264-b180-8d496d3016fb,Amr,17,5,34,8,85,76,225,
9f94177e-15c8-4276-b8cc-bf050396d195,Amrie,18,95,3,72,18,73,279,
1fd8c6ba-5039-4fb1-b0cf-6fa671e9aca3,Amya,45,17,54,15,38,49,218,
0b0680d2-9cf3-4d8d-8402-dc57871ea1c6,Amya,28,53,19,91,11,54,256,
528ee2c5-d076-4303-81d1-1e4f7839cf1c,Amyia,100,75,93,50,67,54,439,
2249a9b7-f3f9-4fee-8a86-192e895f2079,Amyre,63,35,62,34,13,70,277,
817ebe30-85ad-4ecf-9a5b-4a713b8971f8,Amyree,11,72,11,59,71,66,290,
2b9c604e-145c-4191-84fa-3d9f3ae56b4b,Amyri,18,33,55,63,82,73,324,
a842bf32-9913-4a11-9675-c954d4f85222,Amyria,11,4,0,2,68,28,113,
08f5c7f1-e09f-4e92-afd3-f2ae444b21d8,Ana,66,96,14,44,40,30,290,
1ff89315-f4cb-4595-a367-a656678fe1c3,Anabell,26,70,5,34,81,61,277,
47a14e45-e89e-4fef-a7e4-e2398ec025d5,Anacamila,87,0,41,64,64,29,285,
17c78bff-cb00-40a5-bf3a-853615e408b6,Anacaren,76,10,100,14,36,15,251,
c5a22876-bd4d-498e-b601-526ec21eb2a2,Anacaren,54,99,58,31,36,69,347,
f6d6b32a-1bd2-49ca-94ab-ab21a0de9d4f,Anaceli,22,7,89,51,87,62,318,
387db6d2-3b08-4b29-a6b6-4ac5ca1704d2,Anaceli,49,84,71,36,69,42,351,
eef8a9aa-79db-4cef-a5b2-07792e7bee74,Anacristina,11,1,10,99,1,26,148,
78b1df0f-12c9-4d71-b995-1cf91942a3bc,Anah,77,71,48,26,54,43,319,
7649c3d9-3ff2-46a8-9dfb-cf24a84ab2d0,Anaily,99,33,92,80,78,32,414,
fc39b1fa-7817-4e7c-bf1f-2f69c216bb57,Anairis,80,45,86,66,72,94,443,
b546d056-3b2c-4c68-a864-adc38bee67be,Anaiya,2,80,97,55,87,38,359,
643e8718-d42c-4248-9110-0e15d28c4f59,Anaiz,25,12,57,27,43,51,215,
28ef5f79-d16c-4026-aa02-69a60afb8653,Anaiza,23,60,30,51,38,70,272,
7b3c2d88-c56a-42ea-a3b8-ceb7e4acdff5,Anajulia,80,70,89,80,26,33,378,
1089cca2-454c-4971-820f-159071c471f7,Anaka,11,70,22,78,78,42,301,
a23b3cdc-bfe8-4ba0-85b2-159af0e3a8ba,Analea,36,53,68,34,24,62,277,
8c233995-ebb5-4dc6-8566-c9f2e8c14b03,Analeigha,97,36,93,92,61,60,439,
353a018a-5a02-4fd0-b181-4d6bf60a3182,Analeigha,32,99,69,49,33,74,356,
9ffbaf62-4c5c-4b7c-a2bd-6c697173eb8a,Analiah,20,66,19,96,98,7,306,
e75fe6e9-5e20-4b1c-b288-07067645fe03,Analiah,61,23,14,82,78,37,295,
f96d6529-da3c-41f9-8da0-d4415bbeecee,Analiese,15,75,96,35,18,90,329,
3a5b8855-84f1-4f01-b2ec-f088b9615f48,Analisa,80,93,98,72,51,83,477,
9606ac75-3c9f-4577-bf89-7f1b3b8a366d,Anallely,31,37,1,87,62,23,241,
a9f3343f-6848-4acb-a74e-686f755c0273,Analy,17,31,67,42,54,58,269,
08014d2f-b0a6-4b08-b4a7-137e26f182a5,Analysa,94,85,32,90,23,62,386,
f0b41627-37e5-4c4e-8a69-27fd0df935a5,Analysia,2,56,68,55,65,32,278,
edab323a-a226-4ec3-a55b-a8f6ad9f1acb,Analysia,31,80,23,41,0,38,213,
10d5c578-f417-4e8d-a947-19de481811ba,Anapaula,60,81,24,47,97,17,326,
5c833001-209e-4a27-a488-1c8492c20715,Anara,82,54,98,6,69,83,392,
62b39fc6-bd6e-4f58-9d88-5bcb8d5b2009,Anareli,96,5,50,83,64,4,302,
084ad7d1-4f44-4606-89a1-27d385342736,Anarosa,69,46,59,28,97,4,303,
76322861-bf4d-4e79-b0f6-56811ed23f41,Anasofia,26,22,77,19,56,85,285,
8e9804d6-aa7a-4090-abf0-170cfd7d77e5,Anasophia,28,64,70,69,9,53,293,
9e891459-8920-42c2-aea6-dec50bee9d37,Anastasi,0,56,4,91,40,1,192,
16461283-dad2-4ccb-9deb-cff9e78cf2af,Anastasi,24,3,38,30,31,49,175,
5e3146a2-d2c6-4fe5-b207-35d014c2121d,Anastasi,41,51,84,63,76,25,340,
fee8d3d5-230d-4af4-8f56-7e987a125049,Anastasios,46,20,80,67,81,62,356,
b361d9e7-4234-4e09-b182-de197ad3ba16,Anavictoria,17,25,2,60,70,19,193,
70e8fbc6-dd2c-4371-9068-3ae35114f71f,Anavictoria,62,18,49,86,37,38,290,
7ba9d23d-310d-45bf-b604-a0d78000ac96,Anayah,88,74,91,32,28,1,314,
16841fd1-12bb-4ca6-af5b-2aeda7691b2c,Anayeli,14,33,100,27,95,45,314,
86199b22-1908-49cb-975d-a6947c4c4e0a,Anayiah,64,19,15,98,28,44,268,
31485e3a-56fa-46ba-8d3b-7980bd10e6bd,Anaysia,96,54,8,76,30,92,356,
faea99dd-9490-401e-a78f-e1094be2aa6c,Anberlin,56,70,92,52,90,42,402,
986bae1c-c9b2-4650-8453-43ac9673fa01,Ancel,98,44,44,78,17,86,367,
24155b1b-a7ff-44b3-bc41-f3d08db03e1d,Ancil,27,77,48,49,49,7,257,
48c819d8-4f60-4c05-9f74-d0d1e85d4409,Andelyn,94,28,7,85,58,10,282,
7f5a56f7-d196-4b85-8484-76df0fe14703,Ander,1,78,1,64,46,67,257,
858a77a3-21d6-4f22-9324-dae4dfc938f6,Andersen,4,91,14,2,12,77,200,
8b2852e2-a3f9-4d0b-b0ea-d306a435621f,Andersen,19,19,89,29,40,52,248,
25f53268-e90e-4ff3-b07e-33b434ccfe57,Anderson,39,74,9,32,30,90,274,
c66b17b2-81ca-47c7-8912-2936b45a76bb,Andi,61,15,69,27,8,83,263,
72ebb131-8a1f-4129-815a-3523c5f09071,Andi,10,86,85,86,50,89,406,
0d79ea1e-12f0-446d-a1a0-37cfec3acf19,Andie,95,44,29,29,31,28,256,
f14d1c9f-cca6-4ecb-a438-27b72aa60886,Andra,58,55,64,77,17,78,349,
4c421404-0e0c-4d52-81d8-fd18453dd8bf,Andrae,28,81,27,79,58,1,274,
9c59552f-9779-4011-9c6e-2fd9aafa417d,Andrena,12,74,35,98,87,88,394,
9f3c730f-8927-48b0-8e7b-8f65ba6fc1a6,Andrewjames,17,26,44,72,65,9,233,
c3815729-c644-42f8-bd8f-8c39f66c5c40,Andrewjames,85,97,30,82,26,81,401,
169a6a6d-2839-43b8-a47e-ef6c91ebd2e8,Andrewjames,76,77,89,97,50,32,421,
890a1f42-3054-49f4-b19e-966612a81226,Andrey,21,31,36,1,59,76,224,
0b273396-9c07-4f91-9582-b0fb660981b9,Andrey,11,61,75,22,8,15,192,
a8117cf2-c0c1-4137-8453-a1a76be1621b,Andrez,12,98,74,52,39,7,282,
14e1ae1f-def7-48d1-9c8b-03085aaad943,Andrez,17,50,75,10,67,99,318,
6244791f-fc71-4ed7-8959-4e6e6a4242d1,Andrian,95,68,13,99,74,84,433,
d0fa9c78-cda3-4b38-bae7-bfa39faa96c5,Andy,81,33,92,10,68,71,355,
8da33361-1117-4019-adb1-b10776df0eb6,Andy,67,67,57,77,84,19,371,
07f2225b-6311-4052-8dfa-ec0b01737d7f,Aneesh,81,18,37,86,93,77,392,
c12df3f9-0eab-4dca-b22d-d31894d23326,Aneesha,18,87,94,87,71,24,381,
cb5b710a-237b-41a2-ab12-055894db96c6,Aneisha,87,48,49,17,55,99,355,
fa644578-c238-4fca-a78a-b7d0535af9a6,Anelis,21,62,94,46,67,75,365,
16c35ec0-e6de-4508-9348-3f384dc9ea50,Anelise,3,2,36,98,6,81,226,
80a9c464-7382-45ef-a25d-7d193273da11,Aneliz,44,67,15,84,53,16,279,
c4290579-b3c5-4067-988d-4cea16ed890e,Aneliz,41,95,68,12,60,96,372,
3b197f7b-e0af-4de0-9cac-336dbc097832,Anesha,43,17,91,15,33,63,262,
47a959f8-6fe4-456d-a088-f402a6c9b46d,Anessa,15,64,35,57,80,47,298,
2b8983cb-bba9-49aa-89a6-36206c7c0627,Aneudi,65,6,39,33,91,74,308,
007923ea-7303-4bf6-9ea2-48233d469409,Aneudy,17,83,28,96,11,100,335,
a0254a69-f3ec-459f-91ca-a150a0d1b519,Angel,75,73,55,60,55,39,357,
70d7932f-6ece-4829-9d33-5ed05a0e0f27,Angelee,34,40,53,19,98,83,327,
e31afbbd-873e-477a-a5e1-9cffb5473f90,Angelene,79,40,5,91,70,83,368,
27144f1f-b14d-4d4f-9d95-3e99971b893f,Angeliah,12,13,6,46,96,6,179,
c30b808e-6ca7-4bb5-8b71-403b53378487,Angelicamaria,1,17,37,16,86,99,256,
4c7f5ef8-9c72-497b-832b-e13da4cf6f42,Angelicamarie,19,9,13,78,8,94,221,
1a7327bb-b9dc-4328-b297-9e5d116dec27,Angeliki,86,1,63,97,85,67,399,
da2a49dd-85af-4b68-8753-5d35a0bcf792,Angelin,1,37,49,32,45,42,206,
a9422f45-63cb-4acd-b8c6-baaa094de593,Angelinah,12,27,75,78,68,29,289,
c5aea220-9b12-4d89-94c0-af768ef65be5,Angelinne,66,23,71,0,44,20,224,
0288b0c6-c262-4c33-a389-b01c357dc89f,Angelique,100,2,40,42,35,15,234,
770702ea-3e4f-43d2-b629-9182aeb6f22d,Angelis,92,26,69,16,63,37,303,
af12b238-d4ad-4d1d-8045-12b591ed637b,Angeljesus,6,46,66,32,41,20,211,
dd66d612-3a89-4534-a734-fe4b03d59dca,Angeljesus,65,61,38,38,75,89,366,
ca29a99e-5a6e-412d-9367-657f01d900c5,Angella,83,77,100,19,95,36,410,
202b7940-eb64-4cd4-9030-bab4fddf7259,Angelli,15,75,32,97,64,26,309,
27b46783-21ec-4c12-8048-d1c17a0c0c14,Angellina,28,5,60,47,50,84,274,
9a3c9b47-5f2a-4d8a-987e-b13949e47ba7,Angelly,12,68,11,79,17,67,254,
b774ea42-16b6-4577-83f2-6e87ab2d9d30,Angelyn,81,96,38,16,88,49,368,
d8f09bf3-d3c9-4b30-a7e7-9c239b868e65,Angelyne,22,73,3,49,88,97,332,
ff05d063-d0e7-402c-8027-29581070cb64,Angelyne,80,3,45,40,27,80,275,
ecc3604a-5e0a-4a88-aded-d8d9aa25e661,Anglia,17,93,77,26,37,37,287,
41e9435e-e2f2-4977-9950-356d6181612e,Anh,15,66,81,77,22,66,327,
9cb1e224-ac66-4c39-9173-60c3e50555f1,Anhthu,98,71,59,50,12,5,295,
c192aea8-0c1b-4828-bc75-b72e5b7e621d,Anicia,37,20,49,68,93,99,366,
c95df0b8-478b-4e53-bd09-37ff28642d78,Aniela,13,58,53,21,28,22,195,
6a6eae3b-1af7-4173-b030-e7e3ba1fa76f,Aniello,52,94,82,57,7,52,344,
0e1bfd3f-d02d-42b4-828a-698e90993c04,Anijah,61,18,69,6,76,93,323,
921436d2-4661-4fba-acca-cee17978774b,Aniket,89,31,14,73,36,41,284,
b5e93df8-70df-4a9c-9371-a2f2b35704a6,Aniketh,1,79,34,70,74,88,346,
bd416e70-bb2a-4904-831d-29e910f2aff4,Anil,87,12,92,20,4,35,250,
57e2621b-1a5a-4318-9359-f85180b33907,Anilah,79,2,31,41,66,17,236,
81f3da41-f688-48d8-b625-16ad12e90f00,Anina,35,93,82,36,4,98,348,
85d00d21-6ac4-4362-9d89-163f82f48ec8,Aniqa,23,72,48,91,13,74,321,
88b917c7-e342-441d-9f50-5ceafeb408af,Anisha,23,2,37,86,90,57,295,
e15e791b-34a3-4c36-8297-348cd6cbeb02,Anishka,12,87,99,99,1,94,392,
1de16ddd-b72f-449a-a8c1-95a121093122,Aniston,95,5,9,72,85,2,268,
f011201f-8f23-4a90-ab32-18a26d52f079,Aniston,55,35,77,26,6,45,244,
3e5fcf22-0c8b-4ce2-ab3d-1e9b65d95b83,Anita,77,10,40,0,98,26,251,
b439b7af-7b3f-4af3-b117-39fde84d2781,Anitra,14,89,16,96,54,23,292,
17e3619d-b618-48c5-8102-44948cd83bc8,Aniyla,98,96,90,83,34,64,465,
c9ffd4f7-6fd4-4047-b3d8-90371d01b6a9,Aniza,66,31,46,64,87,64,358,
6b6472bf-cf7f-490a-a01d-3f26bcb8cadf,Anjani,65,78,0,79,93,80,395,
675c1973-daa5-4529-b34b-93ab4cc8a031,Anjela,50,81,23,74,21,39,288,
7749e9e1-7ee1-4812-87b1-2a421606013e,Anjelina,62,82,78,81,98,94,495,
b586ba38-112a-48c0-9ed7-818baa8638fc,Anjelique,45,99,12,73,63,1,293,
bf901f66-e468-4586-abc4-a05b102ae842,Ankita,60,6,29,29,8,15,147,
af6a7348-b85d-4ae9-8ce6-33637525e1f4,Ankur,86,13,3,63,93,99,357,
28fd56e8-eb4f-41e6-be50-b308608fcc5a,Ankur,52,4,36,29,2,46,169,
a35220ec-66bb-43cc-a90d-81a2b85c111d,Ann,20,10,81,67,62,26,266,
d9635997-11ef-45a4-afac-c29bccc499aa,Ann,25,39,53,63,64,89,333,
a5fe0209-bbcc-4025-9105-64d3c84ccaf3,Annabelle,46,29,19,0,0,94,188,
ea254c6f-a651-49ff-ae58-215e6e2fe5ac,Annah,54,52,78,37,83,70,374,
83ebd79b-d865-45f6-ac33-12aaedfedff9,Annaleah,14,72,51,18,4,63,222,
a4419e31-aaf5-4c25-abfd-9a5fc19fea50,Annaleigh,34,25,20,83,58,56,276,
40e8df3c-0a0e-4dd5-9ab6-7393b55b1733,Annali,10,6,97,44,72,65,294,
cb32734f-5ae3-466e-b8b5-c191f734158e,Annalia,57,59,68,28,29,23,264,
b4f99f06-f6c1-4994-a68a-0664bcd47cfe,Annaliza,3,61,30,12,6,37,149,
d26a8362-5b3d-40c8-b4d0-e74388b6194a,Annalysa,76,39,64,63,25,21,288,
20d76cb5-7050-482c-8f89-87abc780aba9,Annalyssa,80,3,94,43,94,62,376,
487645b2-b68f-41c3-ab6b-aa8d94ad1d9d,Annamae,87,26,1,18,89,58,279,
bacf31b3-a6c7-4619-adb1-2cd2c932113b,Annamay,63,1,61,20,98,69,312,
a00afeff-8751-41c0-9d0d-b788c4d201fc,Annarose,56,92,43,48,23,100,362,
67acbe63-ffcc-4c54-b322-0cb73be5bcb9,Annasofia,77,88,43,4,17,77,306,
ddf9c732-a21e-4629-a0de-9cc876b8e144,Anneka,53,71,26,36,24,33,243,
3de8b895-c2a4-4137-8d31-cd556990e9d2,Anneliese,4,50,51,82,0,18,205,
d15d2532-a303-4723-a44d-a54d658dd543,Annelise,22,30,42,39,21,83,237,
0f3e11db-5406-45dd-b24e-f91fcf936dc9,Annelyse,79,56,62,5,7,29,238,
78f2ddc1-2103-4da9-8712-b249ff44626c,Annemari,98,14,63,61,73,44,353,
aee85ff7-059c-436d-8de7-d38cc147f7a7,Annia,16,59,18,4,63,88,248,
90821173-2dc5-4cf2-a150-1244459b8217,Annice,30,20,63,98,35,57,303,
1e5846a2-6789-4cf7-82ea-7b4512db6d77,Annie,20,92,98,76,98,61,445,
90d71e48-f229-4a02-93b0-7a49aafbf5c3,Annissa,1,62,70,89,7,76,305,
470ad236-cb01-4ea3-b7a4-bd49c48f892e,Annmargaret,31,92,76,8,49,98,354,
80871c47-2e3a-4abc-8679-8fff9b17bbd2,Annmargaret,44,34,97,42,6,92,315,
532ba107-474e-4a45-a238-5e801e0cb2d7,Annsley,65,77,10,75,9,18,254,
7778c3cf-151c-41d4-9a8c-875716243669,Annsley,48,68,20,56,38,44,274,
d6757617-fc08-43ed-b5ad-ba769aaae21d,Annya,19,65,1,67,7,34,193,
53f2528f-d73e-4659-bf80-45fb6d377579,Annye,51,49,73,61,66,12,312,
bfc36495-7c3e-4615-b66f-c2080b93d65a,Anouk,28,55,41,58,74,40,296,
89ea6c2e-949a-4326-8559-5ca12387fdbc,Anouk,93,24,42,29,71,57,316,
a12b4578-e2c2-47e5-aa17-1bf6e58b46bf,Ansh,99,17,95,86,91,11,399,
6bd56e6d-9fe1-4ed3-9f37-987ee2c7a30a,Anshika,64,13,11,10,40,51,189,
bbddae52-bfc9-4ed1-a5ff-d5a33dbfd293,Anshul,6,2,6,89,32,97,232,
52415f70-7ac8-4618-a589-fa22226c2534,Anslei,95,79,76,99,37,82,468,
e95ea988-11df-458c-8db7-6717016f10cc,Anslei,80,2,8,55,35,97,277,
5763b13e-6fcd-4279-8eb5-3f09e68d5b5e,Anson,35,26,13,66,28,23,191,
e3c5f222-f312-4325-a414-e99fd72bc5d9,Antara,67,61,57,76,99,35,395,
1820f5de-b8f2-435e-a8a9-969f0f77ffbe,Antavious,65,57,52,15,60,45,294,
17e0cd0a-a5ff-4ba3-b1ea-d5a712b4f14a,Anthoni,0,51,80,29,88,13,261,
e4c36684-1ac9-42b5-bc59-99240fc1e1f3,Anthonny,93,82,51,29,88,57,400,
7715d50c-0319-4772-94bc-3936aa7c36b2,Antjuan,57,100,39,43,8,1,248,
275afef4-b6e2-4b0d-9c0f-37e10fac738e,Antoinetta,22,61,94,13,12,67,269,
3ebed10f-fce1-4231-8612-cbbe294f8c5a,Antoinne,86,57,10,24,68,65,310,
d63e189d-32ac-41a6-baeb-97d1f24bf48a,Antoinne,88,71,15,31,97,41,343,
a54df541-d19c-40f7-9118-e32286d2047a,Antonela,68,12,40,39,8,35,202,
1dc2201f-af00-4fcc-8246-d346d05a955f,Antonela,81,46,21,64,90,24,326,
b1337437-d344-4339-a174-3ef0d7611a2a,Antoniette,49,23,12,95,64,36,279,
d2fa6790-79bc-4434-baaf-257ecd2d9bd6,Antonina,84,41,94,74,83,54,430,
e42450a2-97ff-4221-b486-60f368b4f6f0,Antoniodejesus,69,29,54,57,10,14,233,
f11a41ea-1cec-4732-bb60-ccc7879b932f,Antonisha,99,38,11,57,50,7,262,
a726cb90-218f-4f8b-8907-5242736e201e,Antwan,9,62,44,62,51,24,252,
b3675cf0-af80-4545-b8ab-8ac9e9d3e177,Antwan,62,30,5,60,34,71,262,
1212cb60-3e8e-4736-9d52-4d220025a727,Antwan,30,43,13,93,88,21,288,
00ee1096-50ff-4b69-9d13-08bd981413b8,Antwaun,31,83,66,42,63,25,310,
9695e6e6-b46f-4b94-bae8-c7f0cee1b4d4,Antwine,87,49,30,29,30,11,236,
0ed6ab65-bb6b-4a81-be7c-bfe14e5af432,Antwon,58,47,52,9,30,99,295,
11524262-c3f0-494e-81f4-29d01c22f9a0,Antwonette,90,25,55,78,28,75,351,
0f2ec2df-a8fc-466b-8e59-761ac13a61bb,Antwuan,94,3,90,52,63,61,363,
a33126ab-bf72-4762-835e-42cb3ef713a5,Anuar,98,36,17,21,79,52,303,
a9d0ab7c-cae2-4ffd-a566-d0b0ebd3422b,Anuar,29,10,28,16,16,57,156,
3730f02c-ab83-47ab-91a9-5569db4c8d2a,Anushka,61,51,39,80,79,39,349,
cfbb5fd8-2cfa-45d7-a16e-ed32946644fe,Anvay,14,6,72,62,5,57,216,
c5f00e3b-ddc6-47cd-a267-bd64f8d9d8dd,Anwar,27,98,8,6,61,7,207,
8d7fd41a-e45a-47b9-ba0b-bb48380e6b9a,Anwar,74,76,48,29,98,23,348,
2e7ce91c-04a4-4beb-bc3f-8ae4d0edfa9f,Any,82,17,39,54,71,28,291,
87a808fa-47d8-4a29-ac98-7f4b064ed2d0,Anya,76,18,51,26,88,65,324,
398d1422-d34f-4849-bed7-a6d05c6b2eb0,Anya,23,85,71,28,75,16,298,
15233fc0-46e8-4609-a1cc-85fa1c27d210,Anyah,55,74,8,63,25,41,266,
c080cab8-616e-4859-9103-a195e507e2fc,Anyah,100,72,50,96,94,2,414,
e7cd2419-a19b-470e-932b-74b4ecc51183,Anyeli,92,82,53,24,24,54,329,
42c51d34-8c72-4f75-ac7b-ba7d699d257f,Anyelin,36,35,82,78,53,90,374,
23b7f71e-aa71-4076-bacf-404a04cfdda8,Anyia,58,26,95,81,40,93,393,
971994d2-1b22-4a2d-9c8d-858330f7a7e4,Anyia,90,50,38,69,26,12,285,
f4bb0406-e1d7-46f7-a8ee-c3c229e070c7,Anyla,77,75,27,99,75,99,452,
0de20237-5853-4a90-8fe0-a39974f68d80,Anysa,67,25,68,23,15,35,233,
e4fa4bdd-5270-4db4-ac22-a2124e40c4a6,Aolani,72,50,61,0,62,73,318,
e2a467cf-21d5-4700-a014-e55a5d838b7c,Aolanis,76,9,34,62,49,31,261,
d5dbf55f-b5e0-4e92-9644-9fde8a876269,Apolinar,16,84,15,47,43,95,300,
eb2e9fae-0752-4189-8c99-c21eb63dcba6,Apolonia,94,94,95,80,90,90,543,
3237f52e-271e-4653-ad50-ef51bd671e34,Apostolos,11,95,51,65,62,14,298,
39ad7531-becd-48fe-9b43-4ac0d5d1f500,Apple,34,94,18,78,56,51,331,
2f947a95-d25a-407c-b20a-d78a7d6805d6,April,12,17,13,57,91,74,264,
95be54ce-c3ce-4b60-a1e8-ff91b8521b72,Aprille,23,88,38,86,98,61,394,
406b65f4-f72e-4929-b38e-0b030c7a3b0e,Aqsa,84,35,18,45,11,87,280,
ab0bb889-5526-49cf-8bdc-1d472750de34,Aqsa,14,90,7,49,25,81,266,
f128a83f-9b76-43f1-a1df-0c5e39c396ac,Aquinnah,21,82,100,88,65,58,414,
ca50f525-449c-41e3-9e2a-1767ea13ef76,Ara,2,81,92,22,46,38,281,
c1fe3ae0-bb38-4901-9d20-d9fe0c62844e,Arabella,54,37,86,33,69,9,288,
5fdfc4f7-67c1-4eb7-a416-d6a12f0062fe,Arabelle,27,52,45,19,33,77,253,
99569d3f-d7b2-42eb-9db1-70f46b15b602,Arabia,14,63,37,51,47,76,288,
b9c88b76-4d76-4dd9-ada2-6f4c233f6ce2,Araceli,60,87,97,63,13,6,326,
897f8c4d-9b8d-4065-941f-f0bd64ecce7d,Aracelis,76,21,92,83,22,47,341,
92f5b18d-d095-4bbd-ba81-4301912aabe8,Aracelis,77,98,16,2,44,52,289,
c8703eb7-dbaf-4640-a062-a974d21c482b,Aracelys,53,100,3,20,8,94,278,
d0e6f042-16b2-4d80-8c43-16ef57c2e0a7,Aracelys,60,41,93,49,54,52,349,
affb6d6f-bc9a-4ab7-bba7-4e99a9aab938,Arafat,53,7,71,90,60,42,323,
b3a655eb-58f1-4afd-ae39-0231514908e8,Arafat,96,21,98,50,98,72,435,
6a8cc93e-0774-4c3d-a809-6eb497d5832c,Araly,84,42,90,38,46,21,321,
8fb37adb-462c-4358-b253-3ef5d134f433,Aralyn,2,9,94,3,34,32,174,
b1ef18d0-3c2a-4810-923b-766de359f6b5,Aralynn,21,15,8,90,97,77,308,
32f532c2-c92c-4a09-9e13-e088c0e665b2,Aralynn,100,94,16,79,44,44,377,
7665b1d1-37de-41b4-9527-965d8bb936f8,Aralynn,32,99,53,27,31,69,311,
d2b1ba87-d38a-4cbb-9ed2-04ad8716e290,Aram,49,73,94,2,89,80,387,
b34125cd-1ef9-40e9-92a0-ad7fe220cf0f,Araseli,45,13,52,79,79,79,347,
9f0e4dc3-8f92-4c18-9b8f-bb78b8ac3375,Arash,2,63,73,11,90,27,266,
307f0bff-bf9c-449a-9b3a-c92a7c6f19f5,Arath,55,19,5,51,78,10,218,
388b4ab7-1079-4f88-b5f1-86c2f83443eb,Aravind,77,61,56,20,93,25,332,
860743fe-96fe-4200-b804-70bbc7112863,Araya,11,5,8,8,22,92,146,
ab92c2af-ffbd-4349-a737-3e62ffd58a15,Arayah,22,10,79,40,13,3,167,
8a12e494-3569-423c-92ff-e9fdf7c54843,Arber,95,20,29,75,60,97,376,
1ece5678-25d0-44c1-aba4-e71d51caeeb8,Arcadio,6,69,10,19,62,37,203,
a08ff248-3a78-489b-ad3e-953c569fb895,Arcenio,13,97,16,15,31,42,214,
dd312c3d-d216-45f2-96bf-c48dcd06200a,Archibald,80,19,8,86,83,38,314,
bbd8317b-9bc4-47f7-a169-2f44e0136229,Archibald,12,66,92,76,18,60,324,
f1e32639-3747-4657-9764-7807528562c6,Ardell,80,77,48,61,80,42,388,
a22e4af6-8a61-41dd-b91b-8095536b8308,Ardella,31,66,95,71,53,98,414,
3d433b85-88d8-42c6-8822-1a61cbcfbdae,Ardella,14,28,65,80,41,56,284,
cfcd31d0-da78-49c4-8d15-4972c21be073,Ardyn,26,84,21,0,6,58,195,
7cfa3e8b-5760-41d9-9549-2631e36ca8b4,Areatha,34,9,41,40,85,92,301,
7ee6382f-db58-42e2-ab58-66cf4f934382,Areatha,86,66,59,58,90,24,383,
aa6d056b-3491-4ea1-b932-48ee7f90da53,Areebah,100,72,64,47,5,18,306,
86207702-21fa-4eec-ad14-a243c05aa87b,Arel,74,73,34,13,73,15,282,
22c20e87-5a22-4a40-8b64-50481152b7d5,Arel,77,43,23,89,12,96,340,
d4dccf23-5628-4ef7-8598-81cc8b6065d1,Areli,36,17,66,5,76,22,222,
1897bf92-da61-4b2f-94d6-8423a2e83b34,Arelie,2,85,13,54,50,78,282,
45031486-c2b7-44c8-8ee6-44c064cd513c,Ares,21,47,63,22,40,50,243,
42f4989e-1703-4c02-91f3-65a411b1fef2,Aretta,51,70,23,1,96,40,281,
c176fec3-eb79-4ba3-82f3-e237cc19bd30,Argentina,19,21,60,30,15,44,189,
aa9dfe5c-75cb-4745-b5a5-9e7328a6099f,Argie,54,4,3,73,28,37,199,
ff68edea-631c-43f4-9f0b-665631ce120c,Argie,73,38,28,18,22,89,268,
9c896929-0612-471b-9b98-b86bf2b5dbb7,Ariah,91,95,86,23,63,95,453,
87295ec4-4aad-4893-942d-e0c80b191ea1,Arianah,33,80,7,14,89,11,234,
7e8a0e94-b204-4738-acf1-344f736bfe37,Ariani,47,67,21,62,20,54,271,
534315cd-06a3-4193-94f0-9f5a3744d6a0,Arianna,20,35,69,44,78,13,259,
8643a85d-40c0-4288-8c10-4cb91d1c14f8,Ariannah,16,15,64,16,9,53,173,
2537e9a0-392b-4f9f-8e32-31bb5eff1612,Ariatna,69,60,33,9,22,54,247,
7318f284-9ccd-4c05-93cb-b1f9b2212ff6,Aric,67,88,8,67,81,66,377,
37a642ad-fdae-48a6-8551-c6e4188edb78,Ariella,93,60,61,1,60,72,347,
5b988356-279b-4abf-b5b7-4e11e0348e61,Ariely,87,30,70,78,36,43,344,
0892d158-68c6-49c7-9eb3-cf23c7105b4b,Arieonna,99,73,68,11,19,94,364,
eb9e313c-0234-4d0b-a713-e59955b2c518,Arihanna,21,2,65,91,2,3,184,
ba1060c5-357e-404a-817a-c94a16765408,Arika,44,48,67,96,72,29,356,
84fb11dc-7731-4c42-808a-4515f24a9d48,Arilynn,39,4,40,4,19,80,186,
3cab503f-2222-4001-a484-10b98b104839,Arilynn,94,24,66,99,13,74,370,
66782c85-775b-45b4-94d5-7063268ee065,Arilynn,48,42,97,38,78,77,380,
abc40975-06e6-43d5-9f8f-448b62f99330,Arina,10,42,29,82,86,84,333,
0768e591-f06a-4bc1-b694-2d45edc42891,Ariona,27,30,74,24,81,94,330,
147b108d-c981-4d8f-aa78-fdb6aa42f786,Arisha,91,26,70,58,72,10,327,
ddacafc6-a2eb-4001-a76a-2cac63ef6221,Arissa,56,96,97,18,43,63,373,
0d4b27d6-3240-4ab3-9b8b-6660055da491,Arista,96,83,21,29,82,38,349,
8e532694-a547-4e5c-8dc1-9fcd63963d53,Aristea,72,60,85,87,4,28,336,
018c2a37-4d00-486c-9dad-af7a8e1848fb,Aristides,58,37,30,7,72,44,248,
04699f8a-22e9-4f15-b35f-9389bbf2cada,Ariston,55,11,8,26,66,90,256,
118eadd7-7ec6-4279-9c6a-ad3c03152b8d,Ariv,23,80,64,20,66,74,327,
f825812c-ec8e-4567-b892-1b09f140ad31,Ariyana,96,77,90,99,3,8,373,
c2b16f25-b617-428d-8097-622cf1eb3bc7,Ariyana,51,91,30,79,25,31,307,
235914e8-aadf-4a6b-98c4-b1310bfc0efb,Arizbeth,6,17,14,39,27,5,108,
27327125-4a71-4d3c-a15c-0b5aa57cee77,Arjay,90,91,77,54,57,14,383,
03f1d8a3-48d7-4035-8be6-652c569dc831,Arjun,59,73,85,46,1,90,354,
6ce7ca90-41ba-433b-8aea-26fcd75a463c,Arjun,34,7,22,27,16,7,113,
1dd52d33-8f3e-44f7-aa01-8396462f0e1c,Arla,70,58,33,66,99,42,368,
05832381-b6a2-40dd-ab2c-6c703962e5c0,Arla,60,75,90,36,70,60,391,
833a9242-c386-4c43-8901-ea10b255a7e0,Arland,73,56,79,0,2,46,256,
a71c4048-6729-42e0-be30-cd78ed4d45a3,Arlayne,92,9,70,49,3,77,300,
93138dab-7157-46a0-a029-8e5e5c2d8a61,Arlayne,99,61,22,53,69,13,317,
b7823d0e-6a46-4d6d-aee0-09d4a0d783d7,Arleene,75,97,0,42,53,55,322,
87cb31c7-043b-4bb3-b2b9-93358ef89aec,Arleigh,52,63,32,98,86,1,332,
7651c7b5-d5bd-4a90-b2ea-ccd8569f932f,Arlenne,73,15,34,24,19,66,231,
237042fd-8229-401f-af78-dd42794034c4,Arlette,67,9,71,28,39,98,312,
3d8c0bb6-c161-4180-b9c4-a0add3ca131e,Arlie,54,4,94,25,69,90,336,
da2dca2f-2382-4769-845b-ea03d94f64e6,Arlin,86,97,77,5,5,32,302,
6b9e50c9-4a91-4b2e-8ff8-5ea6603253c7,Arlind,36,82,67,70,19,70,344,
e326cc6d-7d7a-4acb-861f-14684e25b607,Arlisa,15,50,95,75,43,98,376,
ccc04ae3-d1d8-4543-85e8-3abd6e39a1b9,Arlon,70,18,100,3,60,78,329,
7abce698-011c-42f5-b933-945d2a705d4b,Arlyce,56,69,57,21,16,97,316,
85e5b5fa-4983-4f41-9dff-38e41ea81e85,Arlyn,39,61,51,79,99,64,393,
13086060-ec0d-4a5f-9878-4d4d6682beb2,Arlyne,97,1,90,36,8,65,297,
5703fe28-c5fc-4dbf-940f-876f315f8669,Arlyne,40,32,32,61,94,84,343,
4d9fbb6c-a6c7-4ae0-86df-01c454afab46,Arlyss,86,38,98,14,84,22,342,
e80aec2a-8a04-4184-9df8-927064ea34d6,Armaan,64,97,34,32,20,75,322,
0c2894e7-7523-490e-93f0-e3c0127d9104,Armando,42,87,42,25,21,91,308,
0a4e1745-e8fc-47d8-be64-6d7dba2049e8,Armany,34,33,65,84,27,17,260,
2229101d-4f51-42ed-b09c-e55e771aa35c,Armany,96,99,69,3,71,91,429,
880def4e-62fc-4be8-bf4c-e20ed4f9882e,Armelinda,12,67,87,53,100,76,395,
275d725e-8c24-4890-8a3f-7d3f966b54b5,Armend,32,65,48,30,29,69,273,
c70a769a-00ca-4f83-b937-29af761bdb95,Armine,0,83,89,10,20,96,298,
a17aad75-ae51-403d-ae83-ba16487b250c,Armond,28,70,94,26,57,12,287,
56371ea2-741b-4da7-aa48-ac0a735e58bb,Arnaldo,94,10,57,45,35,98,339,
2a097eb0-4bbf-42ec-88f8-209198e51b09,Arnav,12,79,47,86,70,73,367,
7f686ea7-ab7e-48d9-8890-7bea8de1b852,Arnelle,86,82,93,75,28,68,432,
b43ca52d-dd9e-45ef-9454-ca408875ee13,Arnetha,51,17,5,26,23,78,200,
50662af4-d24d-4304-a8ba-c9493f079dc3,Arnetha,50,45,30,64,26,87,302,
4309efcd-ff44-4883-8ad4-f5117c9c57e4,Arnetia,92,58,55,60,88,32,385,
57bbadd7-2d5f-4a06-a26d-5ae3c8973c20,Arnette,5,87,81,98,86,52,409,
e4d14644-b55d-462b-9192-0dc8ba84ccae,Arnez,52,23,37,12,93,20,237,
4cafad75-7218-44c7-8c81-56ca6f821b4f,Arnisha,0,46,25,5,5,48,129,
a313701e-bc09-49a1-b5c4-19406b5bcaf1,Arnold,84,42,86,24,33,88,357,
f487528a-e7f7-4d73-95b4-380f1a6a9d4c,Arnulfo,97,45,40,70,43,82,377,
b8790536-5a73-4b3e-bc69-4d2459d2f0fb,Arnulfo,18,32,45,9,41,15,160,
25ddd158-9df7-4454-8af2-f2f0bbf61c16,Aroldo,26,83,21,67,80,22,299,
e8f771e0-6f0a-48e9-9e9e-22314e6ece6a,Aron,16,56,86,14,18,18,208,
b84836f2-9c4a-44d9-a009-4e17da2891ff,Arrielle,86,2,63,74,26,93,344,
6ba4543e-6d19-4b04-9a89-406003f2f127,Arrington,3,13,72,2,65,51,206,
3469d9b9-5710-465c-aaaa-ed8624ddc98a,Arsalan,22,51,87,77,24,88,349,
c4d60d3a-c8b0-49c1-94c7-805618f4d1a7,Arsalan,43,36,9,15,35,62,200,
ef45f469-e80d-4c61-950f-389933c8e1ea,Arsen,91,92,47,19,17,60,326,
1f6fb00d-b8b7-46ad-858c-d441d97b9afb,Arsie,41,55,13,35,78,15,237,
268acc6a-03aa-489a-af5e-5b188d205dbe,Artavious,29,39,11,56,95,68,298,
f4611279-10da-444b-897d-50e91a087502,Artavis,66,2,67,85,29,42,291,
2b4e785b-d347-4533-9b8c-2a2f98c3f8cb,Artavius,73,67,64,28,20,49,301,
9f803ea7-48bd-453d-9ec1-0f82c6b65d64,Artha,81,84,54,1,68,39,327,
b156a818-c319-4564-bdbe-0c7f88866316,Arthurine,10,51,86,28,22,27,224,
80f908a5-d97b-44f7-a53a-976761d0b51a,Artin,63,87,27,62,82,18,339,
93e8ca9a-745c-406a-9c88-0236214510ca,Artis,5,30,37,40,21,79,212,
15f67613-bdce-427c-87d7-bdc627d732be,Artur,8,45,28,67,55,85,288,
fa38ec06-8e39-4070-b9a5-ffd3462c931e,Artyom,2,27,84,5,96,83,297,
252dc909-9522-4f7c-b08a-df0144867ef7,Arun,10,90,89,7,78,99,373,
8c8364ad-7ded-405d-a0be-13a196ab31e3,Arushi,57,34,51,64,33,25,264,
1ca06fc6-8fd8-4346-83d4-49d3f6074673,Arvella,94,47,52,32,9,46,280,
2b629927-903a-495f-bb00-101601a0b72c,Arvil,44,55,91,64,2,92,348,
b6d7f696-ea7f-4ad2-9eee-b2553255194c,Arville,26,90,84,37,63,63,363,
d9e5ded2-1b4d-4711-9d28-56169c0ccc73,Arvine,75,98,21,28,29,4,255,
2d17a7c5-07b8-4c69-88df-cede48c103a0,Aryah,78,92,47,12,57,73,359,
5b122c86-d691-4239-ab02-41e820955875,Aryam,74,60,30,1,64,18,247,
a60981f8-8c9b-4d6b-861c-f56c7cb010df,Aryan,3,3,93,83,50,81,313,
ce7e9367-bac3-4a7f-ae0f-6ec8fa368b6a,Aryanna,42,63,81,40,90,1,317,
811f97ad-d2d6-44d2-9581-700de492ed35,Aryav,45,51,41,33,80,68,318,
2e32d670-0e32-411f-8e96-c7d5db098ea2,Aryel,4,52,37,61,90,100,344,
32078a6f-9e62-4879-b86f-9ddbe2d93d66,Aryiah,17,100,9,13,52,41,232,
0611a04b-dfdd-46e9-9d88-b56dabb1a020,Asaad,41,55,63,34,96,39,328,
70e01064-71e3-4bc0-820b-3158d7125f85,Asae,74,58,43,92,30,75,372,
6ad29c6a-bd80-4b2d-af9d-c5c9bd9a1b09,Asahel,35,75,100,87,97,68,462,
3ea64bf8-b778-402d-8fa9-f75bfb2c96b1,Asani,8,35,48,15,27,12,145,
409ae654-e3a2-4bf9-ab19-2c8c8a4a2018,Asao,11,30,44,12,44,1,142,
96061eed-8cf6-496e-a36d-0a842bd14171,Asbury,77,30,40,79,15,76,317,
dd2a1aee-bf2a-4805-a590-9b25e4a045ff,Aseel,4,64,12,46,94,27,247,
553a025d-0641-4b6f-87f0-56c754345ba1,Asenath,63,17,46,79,62,76,343,
1d5bbd86-3e1c-4215-ab46-1f93e3b03da7,Asenath,15,12,56,52,44,88,267,
58392211-2c8e-452d-85f2-06aa74d7a112,Ashante,71,42,82,45,37,72,349,
3305f84a-95cc-40cc-8e4a-fcd4ae5cbb95,Ashantee,27,44,80,50,63,97,361,
3baabc1c-c011-4cc9-8cb6-eaf2886bf45f,Ashanti,8,6,60,37,22,21,154,
12e1e1c1-a4cb-43f1-8a33-7b9a954cd0ef,Ashaz,88,6,79,49,1,10,233,
a16b4723-16f2-49c5-ac32-eda325528ae1,Asheley,16,51,17,5,90,77,256,
cd506958-bd6c-4776-b30f-0a3a287e5097,Ashely,39,78,95,69,34,32,347,
17237404-8d4d-450d-916d-9d2e6429f416,Ashely,63,66,65,83,100,40,417,
1ea3105f-561c-46df-8ab3-51023b4c8227,Asher,58,29,47,51,44,70,299,
df0c04a6-1b5c-4731-84a7-5eede3b70592,Ashford,7,98,60,93,31,40,329,
13cb231d-ee3d-4cdd-b4d6-fc5b81406478,Ashira,76,93,60,73,35,73,410,
910c9ecc-d7de-4b8c-8cc2-a3ce8e349a86,Ashiyah,98,99,32,84,21,5,339,
738dd49d-b974-470f-83a1-2a5bdfa49ec9,Ashkan,91,67,2,76,45,93,374,
75afa60f-0d78-410b-a875-56f5f73cd22f,Ashkon,12,63,14,79,21,17,206,
2258e867-8286-47f5-be5f-b189fb6b0354,Ashle,96,9,85,54,40,9,293,
1ba37f60-fa49-469d-94e6-461b6f3df7c4,Ashlee,72,41,77,3,25,63,281,
a096fa39-4bcc-422a-af9a-ad43c36b7a30,Ashlen,43,58,6,95,6,43,251,
d34bef65-683f-4d83-8717-9923fcf78982,Ashlen,20,51,61,51,95,13,291,
9c6c750c-37ff-4d3b-9af9-2ae3cdf6cdd1,Ashleyann,74,48,34,27,94,40,317,
31acd0ce-3b68-49e8-85b1-8b1d09be2a6e,Ashlin,85,62,80,27,34,42,330,
7c76e3cf-f15b-4feb-a2e8-5595b9cee1be,Ashling,14,60,34,34,98,60,300,
c2e58cce-9647-4abe-ae6d-94877ab2a8ec,Ashly,90,3,73,56,37,33,292,
660b579b-7f2c-4000-bd56-a564d6bcdf56,Ashmit,38,59,92,10,19,5,223,
3d34b9b7-8711-43b4-8838-89beab4580cd,Ashmita,40,76,91,59,58,69,393,
734378ec-0f90-49f3-a67f-ac24e97b370d,Ashna,19,32,33,75,92,16,267,
076ed19d-f3fb-43ee-a7e4-11c1e7824e75,Ashunti,72,2,94,35,84,55,342,
6196b438-09a6-4798-8618-1598162ef659,Asif,18,22,20,28,90,5,183,
c83df6e9-84cd-431a-85c4-11c683e3e192,Asif,74,93,92,81,89,33,462,
d2a7777a-f5d0-44de-9fda-c86ff63b8e0a,Aslan,18,74,92,35,26,32,277,
c668f371-c06c-4754-8d97-cdc587cb44d5,Aslean,60,50,60,81,79,79,409,
925a898e-9a44-497d-b1d1-c3e0be55552b,Asley,18,4,17,53,44,25,161,
fce048b3-f48a-427f-b03f-8f1bb3b6cdfe,Aslyn,29,69,54,55,51,60,318,
33f38d90-f5a0-45df-af47-89a7a553e42a,Aslynn,80,35,73,50,20,38,296,
c84f87e0-c3cc-49cd-9a0c-1d43b979d1a1,Asmar,66,80,36,41,42,40,305,
95d68062-3d26-4546-bfda-007d9cdc63e1,Aspyn,22,11,8,48,87,14,190,
2cb83451-1b93-4881-a119-e1c0e74babb1,Assunta,93,87,69,76,19,98,442,
bde09b65-610c-4092-b3eb-954505f79c1b,Aston,18,53,77,42,17,32,239,
0435200e-e152-432f-9986-716875f50bfd,Astrid,73,4,62,26,9,55,229,
3b344be5-229a-4336-9a4f-6a70980a16e2,Aswad,10,90,24,64,23,13,224,
872ef4fc-6d7e-4d8c-8702-ce5199e4b6bf,Aswad,49,51,12,35,70,24,241,
f2df21b9-7226-4636-bb9a-83224c04225b,Atalia,85,48,88,4,40,100,365,
961bd2da-be37-4aed-890b-3eebf3d614de,Atalie,45,69,69,15,30,38,266,
a768a619-5290-4f3c-aca8-7d5b7948f963,Atenas,79,18,76,71,10,81,335,
b83bd946-a8cf-422d-882d-f5d60804c90a,Atenas,95,45,3,51,67,86,347,
66e87d09-a959-445a-b03e-8f4f56276f61,Athel,72,43,59,35,34,86,329,
28927df6-905a-458e-924c-1069399871b4,Athelene,42,62,18,84,80,61,347,
ae97670d-4422-4981-8116-f14b724fece0,Athos,39,90,26,88,66,69,378,
10ad1998-b4b7-4208-a844-879f8362bac1,Athziri,47,28,62,80,92,75,384,
279c3435-d135-4331-9f0e-8afba851d547,Atilano,40,22,89,63,96,55,365,
5e8455d5-8eee-4730-8ef0-034e01ca59d7,Atilano,62,66,36,45,73,33,315,
bc25ec14-35f1-4f86-be33-b2439a8ee843,Atira,15,60,16,65,67,89,312,
7c9b7656-c759-4827-b6be-b3537e71d499,Atiya,38,24,53,54,16,12,197,
de19b9be-7a70-48b0-a0c2-475e5473fbfb,Atiya,5,49,72,97,35,13,271,
1424a542-56da-419d-93de-eb39ddaf1b04,Atlanta,22,27,11,42,83,65,250,
a3059e52-b0e3-43c7-ae53-6f77a2ec084f,Atlanta,45,28,98,40,10,12,233,
c0b333e8-593d-4b04-8d69-1dc91af1222f,Atom,10,93,62,23,94,34,316,
ab284ce6-81e7-4d24-8759-4f2fadf3e201,Atsushi,89,59,28,100,21,64,361,
44b24491-1cbd-4f14-b67c-67bcbe5ef2d1,Atthew,83,88,87,10,60,29,357,
877e253b-ef0e-447f-9540-b5c98e4fd94b,Atticus,35,46,90,56,55,85,367,
29c984b7-dabb-470b-a0e4-06ede9dc5cf2,Attila,54,68,77,82,74,97,452,
237061e4-5766-4387-9b3d-40c74af051e8,Atul,17,7,0,17,97,14,152,
bf74b1bf-540e-48d7-81b6-4e209f43737c,Atwell,95,51,93,57,47,57,400,
aea966c1-3671-45a1-a8c9-c139109ceab4,Atwell,73,30,8,77,11,83,282,
dce6d934-9216-477a-8df3-cafc40f6f7e1,Aubre,28,45,92,88,22,85,360,
49755071-dad1-43ee-9247-89e951435845,Aubreyana,11,47,16,33,55,53,215,
af1ec5c7-1750-4bb7-b7c3-0f7187d501e7,Aubreyana,61,67,40,30,1,70,269,
fec06d1f-26c4-4cb4-8c77-ec418156ecc0,Aubri,73,75,10,27,38,1,224,
b3f6c50f-892b-4a5b-b640-897bf32c4b14,Aubrianna,1,1,6,62,83,62,215,
04db0d44-607a-4bde-9067-9ff4ece5e379,Aubrielle,33,85,27,62,1,55,263,
d327d30b-df53-44c9-9d7e-cfe8680face1,Aubrii,64,40,75,34,52,29,294,
a116c850-24d1-4ff2-9210-27a87041fd25,Aubry,61,32,96,2,37,58,286,
07fd02f7-06fa-4c17-8297-7d9673fa3e9f,Aubryana,21,37,62,30,49,31,230,
f874b65c-08e2-4887-b249-6af297b2f2f0,Auda,92,39,44,71,6,14,266,
b5195aa8-0108-48f9-a589-725339956982,Auden,40,25,24,10,47,50,196,
a0b6b472-7455-4d82-9776-1765a6f04807,Audon,39,60,88,60,72,38,357,
fdea94e6-4a75-4880-b328-70f36c51ce41,Audre,99,89,35,36,10,24,293,
9dbbe754-ded0-4189-82dd-f42ba74dade7,Audrena,51,42,69,74,54,14,304,
32531893-a685-400e-b519-2d24b9eeb2f5,Audrey,48,8,3,28,58,77,222,
20c61ef2-a62e-4465-a42c-6f10b8d79671,Audria,37,88,92,47,50,48,362,
ba998577-b4c7-4526-8b7c-47ecc219168d,Audric,20,6,17,2,87,43,175,
013287eb-6bf9-4152-b472-91f53778e60a,Audrie,42,53,5,6,94,66,266,
4767abce-a3be-45b3-98c9-9e13df327225,Audrinna,21,13,8,4,77,88,211,
b6f71c3c-49e7-448b-ba03-671b89d29aa0,Audris,21,34,59,53,98,79,344,
5262cb09-7a74-4068-a428-6dfb27f9507c,Audryna,44,58,65,50,18,23,258,
0c82815a-7116-4130-b43c-3038d47a1202,Augie,64,50,64,35,4,31,248,
2ac0513c-4242-4272-a074-7b114717562a,August,80,76,18,9,6,91,280,
79f32fcf-cf75-48f0-9a91-1381e9e0f71c,Augustas,52,17,30,79,46,1,225,
da8a3127-0648-4451-8eb6-0300a93f2874,Auguste,25,47,99,10,28,78,287,
b615c03c-0175-44c7-ae1c-c7b6d92d481b,Auguste,28,12,45,43,63,33,224,
edbfe8a4-c85a-4c95-a383-b15b54efba1d,Augustino,17,51,60,19,66,78,291,
a3068f9f-36aa-4e5c-8e85-298e83ba6a21,Aulii,30,99,47,70,25,9,280,
9ef530cb-c5ea-499e-b4e3-77144e8f5e6d,Auna,6,93,30,65,63,95,352,
9e330f0c-6521-4fb3-a8c8-332603f87d33,Aundria,50,23,98,65,3,83,322,
83c0b02e-dcb3-4f92-bb93-918e43b1dd4b,Aunna,53,35,62,14,50,65,279,
1be80997-338a-453e-b9f8-60114abd1cdb,Aurash,5,65,6,26,50,17,169,
38111356-8871-4a82-be6d-675818b3f0bf,Aurelia,84,2,86,11,30,32,245,
de80b542-9be8-4a3b-a6be-aec5bb49e4a0,Aurelius,93,44,92,100,8,50,387,
848e0546-c30e-43e6-9617-6e8a1c4c5470,Auron,36,56,100,36,22,58,308,
948f2166-b94c-4e3e-80ce-54c7ac212d92,Ausencio,0,93,97,55,35,89,369,
53065639-5144-49de-b746-25ee027e0f91,Autherine,71,65,12,53,85,100,386,
6ad028ea-e41a-4df8-a033-22b9095c6b35,Author,54,10,79,15,35,53,246,
1ffb56e4-1a3d-4766-a465-23a1185eb3f9,Avah,22,58,23,98,40,32,273,
1f0fd4ab-a298-4e59-bd93-a26a108a33da,Avalina,76,79,29,20,62,26,292,
43899aef-9005-424e-b714-acdc17c6c1d6,Avaline,66,47,21,46,80,72,332,
969c6e60-b376-4610-abcf-d568e9cfe324,Avalon,79,1,24,90,23,51,268,
d360999f-27b8-4a49-88bd-87c31c39fb34,Avanell,37,12,31,29,13,3,125,
d2af3a46-eac0-4b8f-86d9-a25e5dbccad9,Avanell,11,48,8,71,68,74,280,
42b7785b-3d07-4860-8ec1-0b100aa4ac12,Avani,63,5,66,66,14,49,263,
c6292f84-1e04-4e17-9ce9-61bf2ce682ee,Avani,96,48,82,21,13,46,306,
b069ca92-67b8-4ea9-91cf-244ce50afc15,Avant,50,27,21,65,25,92,280,
f9b16161-487a-4e64-b183-490935848489,Avenir,67,69,32,20,79,92,359,
c988e0e1-ba03-46a8-9c74-bc1c33d877f4,Averi,15,46,95,5,74,16,251,
47b62fa7-73c2-4e3f-b97b-a1a99e09c48e,Aviah,45,20,63,43,36,53,260,
ccbba3d8-c2fc-44ce-994b-98d57c6478d8,Avian,63,45,93,21,18,13,253,
47178d7e-dc7e-4fc6-bc99-418925996a22,Aviana,76,34,25,61,98,99,393,
1dc61d90-8a55-4759-ae95-1cfb7a7e182f,Aviana,39,36,20,90,53,16,254,
d2b33f90-2df5-4eb9-8391-9db5b5a51604,Avie,28,10,40,36,61,3,178,
e0cee5cc-c43f-4360-8d38-0604afb7e84c,Avigayil,22,53,10,75,68,49,277,
1678912f-7924-4c76-be1a-c8361c4710ff,Avigdor,34,82,25,83,54,44,322,
f1558507-5ac4-438a-ac23-ab0fe5d360c4,Avika,16,92,6,4,97,9,224,
4fa2e38f-0862-4c9e-9458-a42b223451b2,Avika,68,100,57,15,52,66,358,
46c69e5a-7d8b-4470-8126-93d8d1594ab2,Avishek,16,17,16,89,30,75,243,
e3c0597a-349f-4b5b-9864-574a0b06a37a,Avon,61,98,43,13,19,22,256,
14167270-4e25-4c82-87bb-f99866d6a537,Avon,97,62,29,53,7,80,328,
89703df3-e875-4f11-86b3-b994c19eb88e,Avonlea,47,68,53,70,65,41,344,
07345def-f366-4f8f-b2e9-c4f6ffb1ea95,Avri,100,97,92,37,68,71,465,
10da448c-012d-4016-9823-d9c4a01aaf47,Avri,27,22,27,90,43,32,241,
84ab452d-efbd-4ba6-9879-7b8adcf1f555,Avrielle,59,21,16,97,32,39,264,
ad9ea447-2dea-4ce3-ab1c-eafc77dda929,Avyaan,64,68,45,88,63,23,351,
c16e5de0-5c7b-4b4d-a756-0ef2e8d9b6fa,Axell,63,65,0,90,89,25,332,
fa172d21-87a7-4384-b2fe-fd180d6c0d73,Axle,6,87,33,43,67,8,244,
42027774-3644-4bb4-b060-60b7d24ce52d,Axton,84,85,69,19,35,91,383,
9cc3d406-99b2-4b2d-8b1b-eec9a2055c31,Axzel,16,55,31,40,80,56,278,
a0a903f1-a4f5-40ff-83b9-61ef65215a70,Ayaan,10,35,30,39,58,63,235,
24c92e0f-8f4f-4a3e-bf5a-9a3e1078a96f,Ayaan,53,99,32,84,56,38,362,
673f869a-86af-40c1-8461-9ecd80674305,Ayah,74,72,43,16,28,88,321,
e31d68e7-60cf-4287-ad37-2a0266342fd7,Ayako,50,68,43,85,35,94,375,
72beffe2-0b1d-4ee7-8cb4-44f83d57adad,Ayani,83,84,44,91,97,0,399,
4477f1b2-d2b4-402d-a718-c57bb8636ae6,Ayanna,59,93,80,25,21,39,317,
7531232f-f2d7-40a8-946a-8df54a3e103d,Ayannah,24,82,56,8,13,29,212,
cde60b0a-5739-415b-9dc0-7b038f44347f,Ayce,40,46,71,98,12,99,366,
9ac4cbe3-93b7-4e69-8eb8-3b8d75982609,Ayce,91,75,63,7,83,4,323,
562357a8-4135-41dc-8765-c72fd76d6f83,Aydeen,44,24,25,24,24,13,154,
9935a228-6e67-4208-98f2-8ef71aa7dd6b,Aydeen,68,10,92,91,47,26,334,
483dcaac-f52d-4cb3-b0aa-9052afc3068d,Aydrian,33,66,90,48,33,31,301,
53b294bd-f6cf-462e-948b-354e84b03ca5,Ayelet,98,18,42,50,11,88,307,
8390b4ec-bc08-444b-a638-5f8d833e75aa,Ayham,19,69,30,60,44,44,266,
ae3cb628-548d-4dfa-b40b-a348dd8f96d3,Ayianna,49,59,53,49,8,56,274,
06f075e6-d1dd-4a00-acb0-f01f1cfcec86,Ayinde,6,90,95,17,57,94,359,
f9608947-b62d-44af-9835-b1b857c36f6a,Ayinde,53,27,9,97,77,39,302,
33ae8c1f-c103-462d-81e6-88140624a5cd,Ayla,17,89,42,82,86,52,368,
ba2540ac-7f4f-4b99-b5fa-e39c65d10e5b,Aylana,66,83,82,3,83,70,387,
05f30e73-9c2c-47ba-9155-d6238875d0bb,Aylee,15,71,32,64,1,1,184,
e2224937-d67e-46e0-aef2-84327a7d5ef2,Aylee,84,65,76,72,9,60,366,
2787133d-6c68-4ba1-b7c5-c68f2540c4d0,Aylet,3,47,98,32,12,80,272,
1d49c8a7-484f-4c6a-b31f-5028958fb99b,Aylssa,42,99,80,10,83,3,317,
c48a033e-8d1c-47ab-a07a-3bcf13c903e4,Ayomide,62,32,89,41,78,54,356,
cd1e68ae-0197-4eaa-a864-b38293b67cef,Ayomide,80,6,71,71,54,81,363,
f9d5343e-0bde-4175-98b2-7784b9a8d09a,Ayomide,75,72,65,78,17,93,400,
47e791cc-5ef1-45ab-9271-8630c0ed95af,Ayoub,82,14,4,98,43,21,262,
0559e357-4edb-4c45-a82d-f756f4d53fce,Ayssa,59,45,41,71,92,61,369,
566bf6c6-af9b-4f93-a15d-79406827bf2c,Ayumi,38,73,94,53,27,26,311,
4461bd46-a497-4bcf-912f-c60b45b002bd,Azaiah,26,45,0,45,81,46,243,
6eac5f28-209b-4f4b-999c-7d34f2982254,Azaiah,23,68,73,54,17,54,289,
17e2b33d-8453-4076-889e-4335d414b759,Azalia,94,1,92,74,30,80,371,
ecaf0ff5-2d9a-40e0-a25a-f96b4cf2ca6a,Azariyah,85,62,21,60,75,28,331,
95e1768d-94c6-4711-8b0c-d3686f11d54c,Azeem,20,87,3,60,94,27,291,
eb5a5c82-91a8-42f4-85e4-db5107e7b128,Azelia,76,76,66,73,49,63,403,
c9206c58-9cad-4dd7-9c54-919a137ef1fd,Azeneth,18,18,27,11,84,24,182,
9ad8dd49-1b02-4789-9fb7-8619fa1fed13,Azim,19,85,67,2,18,57,248,
cc87821c-167c-4f2f-b03a-92c629590269,Azir,55,60,72,1,13,3,204,
d06cc09b-d8af-4329-8e93-b69848c6ff03,Aziyah,98,52,32,82,89,88,441,
81120990-eeda-4b95-bf01-46330ad92c87,Azka,16,38,29,38,9,2,132,
58213240-9446-4322-8f0a-7b71639a6c6b,Azra,86,23,7,72,58,40,286,
d3d87e7e-6f5c-41d3-966d-cec1d5498c36,Azusena,95,47,57,29,30,39,297,
ac7bdcce-eaf5-485f-9003-6b4345b3d0b1,Azusena,9,70,33,87,83,72,354,
0573b30c-5b88-4268-9682-ec71720786c5,Azyria,37,15,53,34,46,89,274,
a4fdb186-0dd7-4d35-a845-35f9f8cbc3b6,Azzie,42,86,84,11,58,27,308,
37764bad-8619-4a83-8a07-1a0689fff583,Babacar,50,83,55,0,36,48,272,
0a994b84-f1f8-478f-85ad-5c572016a886,Baby,19,99,68,30,55,53,324,
3b3f38f2-e38b-4c95-b0d7-3383a4a5d26b,Badia,50,20,47,98,30,4,249,
9bb2fbbf-823a-42f7-a830-4e2e26bd5da2,Baelyn,46,36,74,68,71,60,355,
c6d96aac-39ce-46af-8b09-bac38c2dbfcb,Baila,38,63,4,60,3,76,244,
57490205-9ed6-472d-8bf8-b2f152993e60,Baila,46,26,83,74,91,69,389,
38439a16-4920-43c4-9fcb-e3952469a5cc,Bailee,85,97,4,15,47,6,254,
fb9af0b3-fe7b-4813-9425-fa2b6d623128,Balbina,5,38,66,87,81,24,301,
e8e756f1-8a2b-4efa-9d8f-165e54dbf009,Balbina,37,4,56,84,91,27,299,
1a861249-6def-448d-9c81-0474ec6c0214,Baldomero,31,29,81,40,70,42,293,
824b171e-e16a-46f6-b915-bebc92a6a250,Baldomero,87,44,38,51,13,60,293,
d6d9c428-82be-4eb8-848f-683b8dce6d33,Balentin,83,63,37,11,7,53,254,
1d12a0c1-549b-4d55-ad21-cf36c30a9818,Balentin,91,22,93,32,94,15,347,
0dd80330-5452-4492-b172-95dcd28c3c27,Baleria,63,82,24,20,80,53,322,
1b61bb6f-c568-4499-bfd6-a332f22d1865,Balthazar,15,44,21,51,34,77,242,
0ae5b8c2-59cb-4f4d-96b7-168876c943ee,Balthazar,42,87,0,77,5,17,228,
bcc1472d-57a5-43b1-9a25-284ccd1cf175,Bama,24,26,84,39,12,51,236,
af1c7643-9b09-43c2-9347-2ee96bda53bd,Bama,8,71,76,85,55,42,337,
7b12e00b-c013-4de8-a82c-56192c55100c,Bambi,9,45,100,28,59,59,300,
82a27717-a273-463f-b699-5e5d243c5aa2,Bambina,32,3,26,17,38,64,180,
1f40fa97-40ed-4ec4-a94c-b48170cdbfef,Bane,8,95,61,65,39,8,276,
e6b56705-1048-4642-a744-a1aaa03c4879,Banessa,84,64,84,85,5,30,352,
c08fe9bc-842d-4e31-a7ce-d0691a900dbc,Bani,83,94,42,58,9,18,304,
8e39a3c5-af5f-4c39-aed1-9bf640348e02,Banyan,15,37,15,10,37,21,135,
03df60c7-7aee-4026-b39e-9ead6596b467,Bao,19,80,60,61,1,65,286,
661de9b1-5c67-4db3-a7fe-30b390adf419,Barack,10,65,60,12,55,40,242,
cb3ee763-d23e-49a2-8465-aa22f11e1a6c,Barak,89,18,82,77,56,71,393,
1679a468-bd9d-4cfc-ab05-814d2ec09291,Baran,77,24,89,40,57,80,367,
fcce1986-d048-435f-89ab-d0a4d4906126,Baran,33,83,48,59,70,39,332,
8ef6f76d-4187-4e0d-93c6-95e7c6ac48c5,Barb,46,99,86,47,84,100,462,
0af2e30a-6a3d-413a-bed7-87cce3bccfd8,Barbarann,97,2,66,76,11,59,311,
2ecbdfb5-f79a-463d-8169-b5c801f3abb2,Bardo,84,26,13,35,82,89,329,
42c508de-86ae-49c2-9b50-67bba8315b8e,Bari,59,57,99,61,0,28,304,
31421eb7-da82-4448-b93f-aa1efab4b435,Barnaby,75,61,63,59,28,19,305,
5f58aade-e3d7-4982-873e-38c7cd157563,Barnard,97,67,34,69,21,40,328,
0edac4d6-f364-47c8-8c6e-e49b329a38af,Barnie,65,11,56,53,49,50,284,
5ec4fc1c-bb36-40ea-bfe6-db611dc3d384,Barnie,11,83,24,23,97,48,286,
4187641a-1c8c-4504-873e-ade8cbd43bc3,Baron,18,32,15,63,46,83,257,
3121f8f1-96c6-4213-b61f-41dd66daed88,Barry,14,38,0,70,59,56,237,
f344a913-41fa-434a-8181-5af61d1ad126,Bartholomew,41,45,94,28,0,59,267,
3d9b098e-2724-4031-8c65-ae0491b30e38,Barton,64,60,49,3,65,98,339,
36d8deaa-bf9a-4d4d-b3b1-ed862452caba,Bashar,30,46,44,92,18,58,288,
07ab4027-af4d-401b-b2e3-ccf82a0bceb4,Bashy,13,79,75,46,83,58,354,
e72e8873-d34a-452e-a754-a61ed7ca23f7,Basia,62,39,100,16,86,7,310,
79de94fc-d9f0-4401-be43-984b206c5b58,Basia,19,36,3,40,31,54,183,
7fe4bceb-717e-4bdd-aa9b-0711f7f10012,Basir,23,1,100,5,97,0,226,
fba518f9-3a3f-4237-b960-88a53f013bce,Basir,15,10,45,67,4,31,172,
9e33b3f3-d62a-4494-8f6c-6a2faeb4f573,Bassam,11,57,27,51,19,75,240,
5cc52d49-8567-4dbb-952e-6b0d78b4453a,Bassy,85,82,67,63,32,34,363,
e4e009a5-28e2-43d4-a123-4f97f56a551d,Bassy,49,9,49,89,27,2,225,
846beee3-cf5b-4e7c-a9a8-33b7bd315e31,Bathsheba,91,13,43,64,17,85,313,
116d695d-28ef-4ad1-a204-c8169c6d8200,Batoul,80,56,62,18,12,34,262,
59f608ed-9fcd-4175-8103-e7f7ba51927a,Bauer,42,88,81,22,94,56,383,
0b4a8039-71f9-4fc4-a986-250d7b5cd36a,Baya,61,8,83,7,57,29,245,
962313d6-1ef2-43f6-a656-18635b8184b1,Bayardo,29,4,98,41,68,16,256,
ea0b8f7a-9f4e-4750-8b89-c2fd47711e77,Baylei,60,94,95,61,68,89,467,
bc5236f8-9855-4781-9c3e-5ef74b48d8eb,Bayron,12,56,46,67,71,68,320,
a104d4c9-cd3e-4974-99c5-1055e7b177b9,Bayron,3,6,50,28,12,15,114,
62c7ed9d-5ddc-4be8-a6fd-6938dd42fabb,Bayyinah,17,57,1,54,94,52,275,
4bc624db-0fcc-489b-be28-fcfa19b894da,Bb,18,55,24,65,11,100,273,
052d6c6e-a2dc-4d84-9452-b3ee89e054cd,Beatriz,17,86,99,55,77,73,407,
2d479ca7-bb7b-4d2e-a219-0a3736dcb3e9,Beaufort,6,100,11,11,74,14,216,
759a1275-3b57-4f6a-8d9d-1f6cf888ee04,Beaulah,15,88,33,24,34,47,241,
2b230345-b4f8-4593-a364-a80cbfa71766,Beautiful,10,45,3,45,57,1,161,
261aa8ba-0a2f-4de8-b585-fc379924a1eb,Beautiful,78,18,36,13,27,78,250,
4fbdce28-0f1f-40eb-9167-be367552a326,Beauton,25,9,77,4,47,41,203,
23a16c51-d742-4a23-b73e-4a7477a638de,Bebe,94,80,15,82,68,9,348,
5ea1bead-a256-47d2-9ed6-116d84d3f8ae,Bebe,88,41,52,2,54,59,296,
ff8e0ca1-de11-411c-95df-5db8018d880e,Becca,96,68,80,75,5,7,331,
7ed18d59-0a88-40f9-855c-dc0db87ff6c6,Beckem,40,34,59,41,65,99,338,
810ad885-197c-461a-ac5d-3c9c10f35da4,Becker,19,34,72,13,37,54,229,
40b323b8-ee5e-4c28-98b5-ccaff18ad1cd,Becket,21,97,10,29,27,77,261,
cc65ea57-41f8-4f0e-8397-105ed4a310d6,Beckey,5,83,92,46,93,8,327,
52077ab3-e4eb-46d6-b632-76d5de4d5267,Beckham,46,39,52,1,64,87,289,
9f72fa9e-ae58-4175-bad1-eb75d6fb6a7d,Becky,38,6,14,68,92,34,252,
d9fde536-dd6e-406a-b5b0-6394b1344942,Becky,22,0,97,89,97,60,365,
8f94a7c6-3736-485d-95ed-d849d493860c,Bedelia,57,83,80,51,73,47,391,
7d300000-0dfa-400e-ab1f-770e9cbb7a90,Bekim,41,17,25,8,10,14,115,
edc8a00d-803e-4e4b-881a-cb609a9e8ac7,Belinda,87,72,4,28,86,36,313,
3616da89-d601-4bb3-a29d-a8a550f41338,Belkys,80,81,97,2,62,51,373,
2cc155a3-99b5-4c72-8f14-3c4f7616d923,Bell,45,12,8,22,91,20,198,
221c150b-c09b-4bb2-9634-782f60beadac,Belladonna,47,50,48,83,34,90,352,
33e7ea3f-5f4d-4f61-aa26-07e79a7f0799,Bellamy,18,80,60,78,28,52,316,
d6b6cae5-551d-4955-b6c1-98f0acf0f71a,Benaiah,18,30,25,7,7,15,102,
bbdab414-a566-4b46-a993-290efd441360,Benaiah,87,57,90,17,48,72,371,
f47ef2e7-5b47-40aa-a37d-ec25612310fd,Benard,68,4,74,97,58,56,357,
625115ed-0d2b-41a6-9c4a-078655f19411,Benard,94,76,55,93,26,79,423,
a8a7ab4d-fe3e-4b71-ab33-7bb1658726ea,Benay,67,85,93,67,13,48,373,
481de0f0-a66e-4380-a504-0f6c87b75716,Benicia,86,35,27,13,81,99,341,
9937cf35-3b07-487f-ac73-f26b0a4cf078,Benito,15,88,69,50,11,86,319,
526cbab4-f999-4f67-b92d-008ac043647a,Benjamen,92,17,76,56,10,12,263,
45c6bd00-a230-4dfb-9b38-2148fc9fab1d,Benjamine,90,43,63,66,83,46,391,
230d141a-d027-4c83-942a-29996802acd9,Benjaminjoseph,80,56,96,93,35,1,361,
16f5ad91-0e11-4c57-a13f-da5e21a01e8a,Benjiman,78,97,52,33,30,41,331,
302a2769-60af-4a3b-927a-a751debe70ca,Bennet,92,29,100,29,36,77,363,
1dc22e88-1e0c-44a3-b026-1d1e3de3ee88,Bennet,71,89,80,69,27,83,419,
4ba7427c-157f-4069-8f98-90e09c9c802f,Bentley,27,49,18,76,52,58,280,
db9a8333-46d2-4bd7-a1e5-ca8d641bfec2,Benyamin,23,99,66,64,48,92,392,
a7fbdbfa-1381-451a-b494-e1679e148b2a,Benzion,49,47,89,93,25,17,320,
09d6563e-0df0-4467-8686-92d12b211629,Berdia,61,89,18,93,6,24,291,
2cae6826-c92d-4cca-b31f-f073c1b44954,Berdina,81,8,1,53,50,44,237,
55347fd5-0c4f-42ae-a99b-e8091dc58119,Berdine,69,13,75,76,51,13,297,
f9b88945-928a-4268-b762-b2ad8390dd22,Berel,64,49,55,39,81,43,331,
be986fd3-c70f-4ffa-b4d6-a492c8fe8d18,Berenice,82,82,31,62,3,58,318,
415f42cf-1b4d-4a4a-b845-bb4e40da1839,Berenis,89,24,48,16,4,34,215,
dcb87511-4484-4d78-8998-d0e4685a58fb,Bereniz,30,64,56,57,1,89,297,
4d6950fc-d5f9-481c-816d-6de4c6371019,Berl,74,13,24,0,26,8,145,
713e9569-f3e4-455f-94da-e6a6e19f8633,Berl,31,75,42,65,15,89,317,
7d399aaa-7d05-44d3-a2f4-ba7f7fdd35ed,Berma,1,57,40,70,25,73,266,
9a3e5685-7961-4ecf-b24a-e91045b46ba8,Berna,91,79,0,4,75,97,346,
a807f484-5b74-4409-9f58-04d3ab544d84,Bernadean,16,33,0,52,79,46,226,
eb543c18-e238-4dc2-9856-351c46e46117,Bernarda,0,47,21,66,58,64,256,
d396a270-408c-4241-a596-8faa54aa4438,Bernardette,58,96,36,31,4,12,237,
d8629e45-2c7f-4fad-b232-6c3dab349168,Bernardine,71,33,87,9,65,2,267,
64b42129-5e15-4f96-a262-a6f24b45e524,Bernardo,57,41,70,5,31,65,269,
7d0d81a7-fdfb-403b-b337-03b8f0c9c16f,Bernardo,87,36,43,27,41,88,322,
4c5a4f49-d097-4f2c-ad0b-cf6d8139c75f,Berneda,10,59,12,25,57,21,184,
9f2974df-367d-4409-ae06-b6c4f35c9830,Berneda,97,72,71,17,35,43,335,
68234475-9274-4b6d-96a9-4bf962ae7fc6,Bernestine,65,11,24,35,97,66,298,
b443ac45-b4f6-4f16-9c97-81e83c245926,Bernetha,0,35,98,79,64,13,289,
d40c5b5a-9197-4ea2-9613-dc1641c8dc00,Bernetta,6,78,0,89,83,40,296,
dfb7f2d4-51ec-4118-95e2-01fe6f0401ee,Bernette,8,50,74,37,30,98,297,
0a2306f5-4f3f-47ab-9215-4e600665b17e,Beronica,40,96,4,38,28,57,263,
c6a0ce51-faf7-453a-9b68-d83368be4958,Bertha,13,15,95,98,84,98,403,
1edaaca9-1419-467f-953b-361d1a536ee7,Bertil,91,34,24,40,7,31,227,
fe1f9880-3fdf-456c-a6d1-866271ba1e8e,Bertis,84,80,36,65,11,79,355,
d3711ec4-6756-469b-a245-6563ca727401,Besnik,46,62,41,11,26,93,279,
c21f0e5f-4e9e-4569-96b0-b52e7f0b1845,Bessy,73,76,91,15,46,32,333,
b294f9d4-fb25-4712-8c94-f90f34cdbff8,Bethanie,7,64,80,31,28,53,263,
e2ce8f2b-a494-4570-9d13-38cdf790fcbd,Bethanne,38,31,21,6,46,27,169,
5f1edbf2-2f4b-4d26-9d1e-affe669e8fb7,Bethsaida,74,95,15,3,12,10,209,
b6a53926-cced-4292-a4e0-62d7cea6a5c1,Bethsaida,59,74,3,79,75,62,352,
15f7cf8b-9487-40b4-9b83-cfa5412c7b82,Bethzaida,28,16,74,24,90,61,293,
2461c79e-a0a2-4c7b-8f2f-26b8bc03b022,Beto,14,42,19,35,52,64,226,
053f833d-701f-4753-b215-c838c872abc6,Betsey,42,35,82,59,6,98,322,
2481af36-6365-46cc-8fce-826755e6ba63,Betti,27,10,11,82,65,37,232,
c71f48a4-4114-4bbf-ad2d-f8c33d1a98cc,Bettina,93,99,89,94,21,61,457,
62688d6c-5bb5-4761-b5f2-d216ffa159e8,Betty,77,86,44,28,56,60,351,
d663a878-599d-4037-bba1-3969b38b1498,Bettye,28,6,22,92,24,40,212,
228e8e8a-565c-4687-b1e3-f0d679b5c3db,Bettyjane,13,31,24,5,100,14,187,
d64188e3-ed4e-4fef-9bc3-5de8f784b642,Betzabeth,15,5,70,44,47,89,270,
4a0f6f96-63bd-40cd-a834-e5a1e6176278,Bevan,75,79,25,64,82,91,416,
4c216237-dd73-4fe6-9325-40aa07bf1c35,Beverlee,32,20,95,30,20,18,215,
3115d34f-0788-443d-8a14-dd3a70b525c4,Beverlee,7,38,67,87,96,80,375,
7b91e00d-c54f-45d4-a456-2f1bcfbb4494,Bevin,49,25,67,87,61,68,357,
4a8dad6b-ffac-4033-8f00-dfdb1377b892,Beya,71,64,70,56,67,12,340,
ceb6a820-5e0a-4136-8143-b1424f88f8f8,Beyonce,67,70,35,49,90,57,368,
c11b274f-f632-4e72-915f-47834fbe40b5,Biana,6,95,47,44,77,7,276,
31c95880-ae25-4933-be29-a02328fdf66f,Bienvenido,56,44,47,2,39,46,234,
68d665a8-af1a-4a67-b7de-f04168bb1b8c,Bijal,50,13,98,40,82,51,334,
eed679a2-a5b9-48c9-bf09-f1ae22c60d03,Bijon,77,11,6,45,25,52,216,
5a09004a-2164-48c9-b3f4-56a73db488df,Bilan,24,1,52,46,4,4,131,
23f06aed-b566-4de3-b267-8084722a11c1,Bill,73,2,36,60,83,25,279,
6d18c099-d9c2-4d41-8f4b-74cdfe7cc82b,Billee,50,39,19,89,0,51,248,
694ad235-aa72-41ce-8881-d13c67627bc9,Billie,32,28,11,57,28,25,181,
bdb43726-4ccf-4ed5-a54f-9c3f6abb7778,Billiejo,50,27,57,20,58,92,304,
12848409-4f40-4721-b861-9a2373aa82d9,Billyjoe,54,23,55,93,32,32,289,
c309ca32-a88a-45fd-a882-565b5b090101,Binyamin,73,8,54,97,60,88,380,
602b2f48-9793-41c8-9bc7-2dc9de1d5e9f,Bionca,50,40,49,9,41,12,201,
cb9246ee-db30-4328-8b61-6c528502389f,Birdell,77,97,72,87,76,29,438,
b190d752-dfe9-4b3c-affe-10322d38c7aa,Birtha,12,68,79,62,63,8,292,
d460cdf0-ec71-4a1b-87b5-4da55e7f195c,Bisente,94,13,32,45,53,82,319,
ab46b7ed-c57c-4cb0-826a-8e7be922abfc,Bisente,22,88,92,82,13,77,374,
9ea32c7e-dba9-4dc5-9e27-bda9c1315c87,Bisma,15,25,33,24,15,4,116,
e2992ff7-e768-4fbe-be7e-08fa05d32c1c,Blade,79,73,3,62,97,2,316,
0dcee9b4-48f3-4c31-bdfb-8db2b8c8d8d6,Blaize,43,58,97,92,9,86,385,
626ae69a-616f-401c-984e-4ffd9222e29c,Blakelee,71,49,60,97,34,88,399,
22157335-f197-47d6-bc23-f3be9b28f334,Blakelynn,21,36,77,0,77,22,233,
d00c3fbf-07ee-4edd-a7f5-8c83dcf3db5e,Blanca,77,18,11,73,26,93,298,
442bca26-84fe-489f-abed-fae8f5270f92,Blanca,28,16,26,46,11,15,142,
8199e3d8-5a05-411f-9f75-ccba0c355c16,Blanchard,83,80,52,9,55,81,360,
e6b8e4f3-f8d1-4fe2-83b3-64342056040d,Blanchie,61,92,53,48,1,20,275,
fac66517-83a4-4bb6-8ff9-ff08f109153e,Blane,83,48,91,46,10,64,342,
d63abe75-9cb5-42d0-b735-0b9146f1d833,Blannie,100,81,77,73,9,61,401,
5ffc8b3a-e920-4e93-a79a-f0d8445c301b,Blayden,5,37,79,8,100,70,299,
80fe29d0-2f39-44a5-9930-52d60392f6d3,Blease,74,46,70,77,92,57,416,
5e7345af-af76-4d3d-91c5-a0565c78ec16,Blessin,68,84,35,77,70,2,336,
1aa47074-5581-42f4-867e-c3a0fda4c4c1,Blimi,53,7,92,76,33,43,304,
91ba1dbd-77ff-40e6-a807-01c1f837ef96,Blondie,41,44,51,1,96,68,301,
b43aefe6-69a2-4d7e-8ec6-0a15611e7e0e,Blondie,49,92,23,4,17,11,196,
9ee2846c-0dce-4974-8176-f8c161c155d0,Bloneva,92,41,59,57,80,85,414,
46fb9d40-5228-4a88-a2b5-94694fa54ee5,Blythe,8,95,56,4,46,66,275,
325afc2c-6a45-4d66-98bf-73acbabae5f8,Bo,58,15,20,52,60,94,299,
2f26f720-b77b-4528-b9e1-ad18cf700968,Bob,67,57,81,49,2,0,256,
5a74422d-c104-41f7-ba45-e9a64e01a90b,Bob,98,61,87,37,31,9,323,
2d82efd9-799f-4a8d-8daf-a0663e0a9aec,Bobbiejo,47,47,61,5,52,12,224,
94234d16-6d28-40fb-a954-110ad2ff621b,Bobby,7,59,36,69,93,61,325,
6fd272df-d14f-405e-9b8d-8d74c7134ebf,Bobie,99,37,18,68,70,32,324,
92e32aa5-ddae-4bef-8484-95882a7bd996,Boden,43,91,37,100,29,38,338,
17874515-5036-4307-8490-210d1ffae498,Boe,9,100,85,81,43,94,412,
29326b9f-e0f7-4b21-a607-ab71a78fe757,Boleslaus,26,74,85,28,60,47,320,
03f0e0fd-3bfc-4ce7-87ce-74f2d10cdf80,Bond,71,46,97,90,54,73,431,
43c9f016-2f78-4c9f-8d43-4990f7fc43a9,Bonifacia,29,1,55,63,50,83,281,
6467fe23-7454-4f80-9b92-12748bc0bc24,Bonifacia,5,22,68,51,1,46,193,
d78d6041-5f79-473d-aff1-8d9c14b16196,Bonnell,67,25,2,97,27,46,264,
9e9e4796-535a-4d70-b610-a0f528162d66,Bonnita,70,12,98,67,13,79,339,
6cda5c8f-7663-4576-95ef-70f1f9d90292,Bonny,14,91,96,4,84,3,292,
8d59d274-7b9d-416b-911b-23e5e6eb215b,Bookert,75,52,82,87,49,31,376,
5973b911-45f8-426f-8e1b-9e9dce44778c,Bookert,56,53,10,24,5,2,150,
56bc3517-a55a-4846-98ff-06a086771492,Borden,71,33,8,61,70,79,322,
49354b7d-f532-4b60-9af9-5eab8f209703,Borghild,31,78,22,47,5,18,201,
1d778904-444a-4425-991d-acf1578bd6e6,Borghild,4,23,94,43,97,28,289,
8ab86b2c-3c9d-4252-9eda-3e86038e7345,Bosco,29,20,47,68,85,98,347,
b46d7b43-1295-4d93-a29f-a8046e0758c3,Bostyn,24,7,4,19,42,54,150,
2d183bec-9b6e-4981-848b-9a74e5e0658f,Boubacar,42,96,66,17,79,17,317,
bab23793-fd42-40d6-9906-93622b337810,Boubacar,75,27,66,54,42,41,305,
15d4a599-c441-4886-8933-e902d8461653,Bradan,14,50,64,65,67,50,310,
fc244516-65db-4c51-ab64-c0b7290b720c,Brady,55,100,7,83,69,67,381,
0a70498f-a5ea-4de8-8465-afacb31c5940,Braeleigh,36,92,10,24,86,56,304,
49d20fb9-81b8-42f8-9289-d0546b3cb027,Braelin,74,40,70,100,89,75,448,
dbe2f2e7-f040-4ae4-bd0c-c76a5e674b79,Braiden,45,30,90,77,97,3,342,
1ee56e39-361a-4a20-aee7-eae842996445,Braidyn,28,58,84,1,85,45,301,
6e3c91ac-a71b-4aab-8b47-741f915d0c43,Braijon,27,9,8,82,82,73,281,
9ba1be89-0bff-4a05-8cd5-85248236d383,Brailynn,51,89,99,35,73,33,380,
5d966595-c35d-4817-b244-7e1e6fd5d1d2,Brain,76,88,81,68,28,47,388,
99df2f45-4cba-493f-8636-ae33c844f2a7,Branae,100,19,81,30,9,90,329,
894aaa72-4cf6-48a5-8a7d-5825867fdc14,Brandan,63,67,1,92,50,100,373,
069e0393-ed70-47fb-a6b0-93fe99ced1d8,Brandee,43,59,81,94,11,33,321,
87bc9b25-c436-434f-981b-ac1f51afb940,Brandie,100,33,78,29,75,6,321,
d35c8d4e-3867-44d7-be24-ebad815cdf2e,Brandilyn,4,26,46,76,37,12,201,
ecdb69a0-df05-4722-9147-a1c2a953b982,Brandilyn,15,47,11,14,46,11,144,
35eeaaf5-0c93-43b0-98a4-f940c59781c3,Brando,42,33,87,15,14,59,250,
aa433769-639b-445f-88cc-2c2b52a516ea,Brandon,78,35,67,0,57,85,322,
a9b12b57-b970-4533-9943-cd0ddbb47a61,Brandye,11,36,81,7,40,18,193,
a19557e9-f265-485f-b800-8fd31325b4b7,Brannan,42,90,20,36,91,79,358,
b0512f1f-6646-4cde-bda1-4d4e94986b2f,Branndon,81,85,73,1,45,16,301,
2bd88020-4544-4066-846b-8f02a19c74a9,Brannen,72,47,93,56,50,26,344,
5b53b155-0f08-4cfa-b06a-3e65c64435c6,Bransyn,17,21,84,29,58,8,217,
52982e7e-cc8f-4fd3-85ed-50cc00ad8eae,Brantlee,28,95,0,46,78,13,260,
a6c353d7-2ae9-48fb-b70f-5f95666ee6c1,Braven,23,83,29,63,93,77,368,
c7375e5b-172e-41f1-80b8-c15e554abf57,Bravlio,89,52,60,84,0,93,378,
649b0058-b87d-4044-a2f7-bf53df212124,Braxston,99,9,62,20,0,36,226,
bdd6204a-7bfc-4840-bc5c-ff2f88eb2ec9,Braxton,38,21,93,80,52,28,312,
9026e160-fd0b-4b03-b7cc-ed707c91517f,Braylan,35,7,24,52,8,54,180,
569a1c54-5902-4184-a736-b802758bd6bd,Braylon,99,39,56,14,72,38,318,
9f397c94-8b28-4194-a6ac-eb4bdd8c6d03,Brayn,54,12,78,82,40,98,364,
d2ebb725-5495-4f7e-ba39-141ece132ec8,Brayton,35,52,65,11,87,80,330,
e966ec20-6832-4167-aa96-0e6c93a598cb,Brazil,94,44,88,24,18,7,275,
88d8ed5a-e390-4da1-bc86-b07bacd604f1,Brazos,72,65,25,66,73,8,309,
271ccbc5-4b6b-4d14-8593-fc14fb0ea079,Breannah,62,76,24,3,67,31,263,
84964eb1-8823-468b-82e5-a2bc4102ff26,Breasia,51,33,100,49,81,61,375,
7adb0a94-db06-48bd-9394-a7e569ad771d,Breck,0,33,87,27,59,52,258,
fc2597f0-d733-4f76-9687-588fded18a4c,Brecklyn,86,59,10,80,17,59,311,
b8ca02e9-d410-47ec-b631-540950c12fbf,Brees,16,89,47,59,46,57,314,
1762fb3d-968a-411f-83a6-6ac00a23bf26,Breeze,86,26,62,30,49,4,257,
e63b745a-3ba6-4cb8-a57a-077b1c58e268,Breezy,63,26,84,19,14,10,216,
2201a180-e090-406b-84d5-608bccc3b339,Brekken,97,18,26,55,82,7,285,
d47444db-1922-4189-88b0-d5719073a6d3,Brekken,39,93,64,49,97,93,435,
8f5d88ac-72d8-4914-9879-713c0342b171,Breklyn,82,13,57,20,52,22,246,
bbaf8bae-fb15-47f3-871d-baffe1d9ef12,Brelyn,9,93,49,42,50,9,252,
ceb01e85-c622-44f1-b824-844cc1c6ebdd,Brena,96,52,60,49,35,4,296,
ab6e70ef-1859-40b6-b478-681ba8372f75,Brendyn,5,52,39,28,98,81,303,
35c6a09d-374f-4363-8366-5ff07708c0bd,Brenleigh,69,73,48,69,13,60,332,
aca482b4-4947-4788-b860-1bc117311e8f,Brennan,54,4,30,41,32,79,240,
d95a4e9f-5cfc-4375-a0a3-071e6140716c,Brennan,80,23,53,20,81,83,340,
8ac07c82-20c9-43ec-b948-e719015b26d7,Brenner,49,95,80,72,93,75,464,
b8730b42-af07-4f33-ab8d-8d204484a0d2,Brennon,7,8,22,8,16,76,137,
f57c49eb-7d00-4872-a0e9-bc0a368cfbe7,Brennyn,61,32,70,22,68,44,297,
c65bf2d8-fd13-4278-b45c-e6373c75df66,Brentlee,29,83,5,9,34,44,204,
efc8600e-81c3-431d-9cb7-80ad97ffcd29,Brentt,42,64,40,74,90,96,406,
f7452b0b-7fa4-4d0c-bccf-f30297971727,Breona,39,30,96,33,61,52,311,
e4b739ae-5804-483b-a114-71174d35af43,Breonna,48,3,77,38,22,27,215,
9b00e3af-50e7-445e-bafd-fd0884bb0004,Breslyn,69,82,67,0,63,80,361,
4f044702-dc6c-4a22-a8e0-f0c253e68f12,Bretton,72,89,99,82,32,46,420,
ca995722-5612-4187-a50e-806c16189ae8,Breunna,15,59,93,19,18,98,302,
6bd14087-67c6-4127-aff5-9d0d89fc29d6,Breyana,26,78,29,3,79,53,268,
3b896edb-44e3-483d-9de9-120f3dec024f,Breyana,31,92,35,54,64,11,287,
e9d6c1d8-bba3-463b-ac4e-2f48c437f876,Breyana,72,21,84,84,15,68,344,
ce4d167f-2a17-4814-9a26-fcd74e933063,Breyanna,3,29,3,5,21,15,76,
4c0cf438-564c-44ee-9a49-a5fb148470ed,Breyden,29,27,34,96,4,14,204,
effbe925-c8bd-4c6f-a839-5732851cad49,Breylon,100,84,79,42,80,48,433,
2914d0c6-3121-477b-9ea4-9337ce75dfe1,Breylon,73,100,97,86,0,83,439,
0ebe55e2-e021-45bd-9721-fe7c4a11afe3,Breyon,23,57,7,95,9,42,233,
18970bf3-afbd-4a2b-82a2-91f306206b25,Brezhane,84,23,40,59,83,62,351,
5616508a-8cba-4bbd-8284-f9cd85db0b25,Brianah,70,35,19,48,53,54,279,
a174b639-940b-4ab7-ad3b-08f59844928b,Brianda,59,91,8,49,69,64,340,
10014788-9a09-4c31-9c09-7f77e3126db5,Briani,60,46,82,17,36,77,318,
32e2625b-26f2-48d1-886f-922d6a1feeed,Brianne,70,39,88,73,35,28,333,
4a958d51-0222-4b16-9a56-e027f4f6825c,Briany,69,35,18,10,57,85,274,
9251dde5-b5de-4d36-a2de-daf30775ab22,Briar,95,30,69,93,97,13,397,
2cf93924-12d4-41e1-99e4-b865c3bf99c5,Briaunna,46,100,5,97,10,59,317,
e4eef404-b8df-4020-ad24-4258be0eb9ff,Brice,46,78,79,86,2,24,315,
3351a659-93b7-4af7-aebd-20d4882c69ac,Briceida,70,74,17,20,9,15,205,
0dd83293-9222-49dd-8a64-b197c08252a9,Briceyda,86,6,22,33,30,76,253,
ce719f4e-2995-42bb-8c03-669e6b18c6f2,Bridger,90,65,24,25,41,83,328,
96414f1b-af35-4f22-815f-1a125f039800,Bridgett,26,28,23,75,82,38,272,
44ed3a8d-93be-4965-90f3-ee4dd03eee42,Brielle,69,27,24,68,50,21,259,
9246acde-d6a8-4c81-99b1-7309ec5bbc6d,Brileigh,10,12,80,51,18,25,196,
7417ea11-d8c8-4e08-874d-64eafa282bcb,Briley,58,23,80,45,45,86,337,
6711fd11-2674-402f-800a-a0d0f29bcf0c,Brilynn,71,28,23,79,19,53,273,
2ccce569-625a-40cc-a286-71efbe2d9be8,Brinkley,69,72,91,39,76,99,446,
fb99b6fd-48a0-433f-94c2-49ad55874c6a,Brinlee,91,26,57,33,99,58,364,
b33e3a70-4cbe-4844-abfa-368fc6c784de,Brinlee,29,9,47,66,90,68,309,
be5da1bf-1a66-4984-a174-6ecd6f4d7dc5,Brinlee,89,69,43,67,52,75,395,
ebf214af-1efb-4a31-a726-3567e069e42a,Brinnley,52,63,31,97,45,40,328,
c51116ba-2d4e-4dcd-b18a-220208b491db,Brion,47,99,34,95,76,99,450,
8d46d03c-0994-47c2-a033-5dbcc221e1cd,Briona,51,12,86,97,25,29,300,
2747c30d-f32c-4ffc-80fc-2287fa63a961,Brione,4,90,5,0,8,25,132,
c559e416-ea3d-4c42-84e2-ba1166e5cc48,Brionna,55,81,84,42,26,23,311,
362b8956-8817-4951-b2be-ad1901fb5ba1,Brionna,53,68,16,55,49,84,325,
281dba49-575e-4095-8ae4-1ac5d462fe0d,Briseida,40,31,13,2,95,89,270,
9df6427a-e82f-47c4-b3fb-7af79f1f94d5,Briseida,24,8,21,44,83,3,183,
49c7ebc9-a2cf-4fc8-a09d-5c38782d836f,Briseidy,22,94,22,50,2,8,198,
dd11a274-5c7b-49bb-bffe-a53a1f9ded0c,Bristal,61,68,95,9,75,40,348,
150c1a05-2015-4bac-b430-94a4a9ba6d74,Britainy,40,23,98,34,72,65,332,
359eca88-9dae-4487-b403-2168b4a07742,Britanny,28,37,85,91,77,52,370,
c88d4005-1db6-46c4-82ba-0bd75a1777cf,Britini,13,98,61,37,8,28,245,
77108ca3-1f76-498e-bed2-12569d614d21,Britini,91,28,47,75,42,32,315,
c63529ec-7ab1-44b3-89e7-5566246c6b99,Britney,26,85,91,57,52,22,333,
190e91a6-957a-4023-aa3b-0da8d74f5d69,Britney,49,74,76,82,53,20,354,
3dc3e500-637c-4a7a-8716-58008ba6ce56,Britny,46,56,71,21,94,33,321,
94269a9c-7a26-4128-829c-67d853791aae,Britny,14,46,62,44,33,99,298,
5be9b743-7904-483d-80ee-4c835d6d1519,Brittanee,41,85,12,36,32,57,263,
5d2ab742-bf41-4f79-9c22-aa51561b43ea,Brittani,0,24,29,5,14,48,120,
b977638d-82b0-4fb0-a847-60f158dc03b1,Brittany,41,94,86,52,63,26,362,
66f200c0-e9a3-4069-b233-c46b7a3fcbe6,Brittany,63,90,2,24,44,50,273,
607d736e-9bf0-458a-a6fe-3f12335e92b1,Brittanya,29,63,21,52,55,62,282,
0d0cfcae-449b-49ee-8b83-2b145773d348,Brittanya,61,29,96,100,32,26,344,
62ebaf56-54ef-46fa-95c6-d8e48bf65fc2,Brittanya,35,47,61,6,6,89,244,
463280e9-1b48-4a29-a539-18f5e595ef0f,Britteny,100,53,1,20,85,26,285,
31467ee0-4a73-4fcc-b7b6-e2fb7d3e4452,Brittnee,36,74,83,46,50,99,388,
6d95e1e4-441d-49aa-9740-37c04957eff6,Brittyn,90,86,62,12,93,11,354,
cab02f78-8a31-43d1-869e-2dce53c1b6ee,Briunna,32,72,81,93,55,18,351,
2520881b-b0e7-41bb-a403-cba085145a34,Briyanna,7,28,21,73,89,86,304,
3bbdcb11-13fc-40d0-b8d3-a6f6024466e2,Brodee,67,54,24,93,73,53,364,
c41e4ade-b452-4160-ae48-2ad196dbc845,Broderick,63,59,83,99,11,77,392,
d0a3a134-d7eb-4c0d-bf06-04ea9452a8f1,Broderick,23,74,20,87,40,23,267,
6571ee2f-554b-40f7-b24e-b8b22987da3b,Brodey,24,76,76,10,22,40,248,
6f3ae064-68c3-4420-8e10-0d7252262d88,Brodyn,40,93,60,17,27,43,280,
95d92ac5-23c0-413f-947e-7300e9a455db,Brodyn,52,22,18,54,54,83,283,
c42bb4fa-173e-4470-bfb3-6446c5ef57a0,Bronislaw,87,83,92,51,35,100,448,
8f6c6e22-1ce1-4fc5-aab7-15b6fb6e1bbd,Bronner,14,48,11,28,41,66,208,
068645f0-ddfe-40f0-bb17-05ee44a90837,Bronson,95,65,89,14,90,91,444,
92900e8c-1daa-47b5-9b58-94be99ea1ab7,Brookie,3,53,22,30,10,90,208,
4f30d371-9fe2-4c4f-ac03-7673ebf1ebcf,Brooklee,8,49,72,86,82,58,355,
8ab378ec-ec63-4ab3-81de-35dc09a4a4e2,Brooxie,31,85,45,67,89,95,412,
233066bb-76d6-448c-a8c6-9835a480d0dc,Broughton,38,74,16,31,6,100,265,
24d8e9e1-3ef7-43b6-b879-0a9038c7c08c,Broward,74,6,34,37,32,83,266,
e4152b1e-73c7-4f80-9dcf-b22692e15fdf,Broward,46,72,69,26,21,64,298,
82c42150-70b2-4d68-9c2b-6f8bbc21a31e,Bruce,21,80,12,82,25,96,316,
aded3beb-f280-415e-968c-ad07b3708673,Brunilda,56,82,50,87,51,67,393,
d009ae20-d7af-49a0-84f4-c42cf9a2b85a,Bruno,70,31,35,24,22,100,282,
fd74a937-3426-4943-93d7-8a95251ca695,Brunson,17,36,6,79,85,35,258,
2a074dea-910d-4cc4-a972-f481449f29a4,Bryant,66,77,96,4,27,51,321,
e2979f13-2a09-44f4-8632-d4d9302dcb9d,Bryceson,5,32,82,48,46,52,265,
2dc60d29-5b1b-4403-8699-b2e66b1c9627,Bryceson,87,62,8,86,96,5,344,
16a0f2c6-ab3a-4565-8f33-d998e0d1a98b,Bryen,52,66,32,92,22,85,349,
476d8133-b931-4f83-84bb-222e21ac02ca,Bryndee,75,99,92,90,68,83,507,
2992d666-ded2-4928-9c15-221c7d8fb301,Bryndee,36,57,56,81,1,67,298,
9cbe6d75-b712-4031-b92f-1d722b0b0e74,Brynley,52,91,16,29,7,50,245,
f99e5c96-4dc0-4432-aff9-2ff1c31f280b,Brynley,28,7,100,19,100,66,320,
209c1146-f871-41d4-b962-9b7f5102bb88,Brynne,18,38,13,37,40,92,238,
090f12aa-63cb-4281-8ac0-f056dc2f8aee,Brynnley,13,39,83,22,5,0,162,
d1857863-c46c-49a6-b1e9-952f3c071959,Bryony,78,45,71,58,61,54,367,
815fe776-5cc8-4082-b2e7-c8e11eb6facd,Bryttani,13,7,15,51,86,2,174,
f1906250-a6ed-45e9-91c1-35f723380481,Buck,25,95,36,70,100,58,384,
6b870443-07b4-44f7-a9e8-b63c7de2c44c,Bud,85,47,8,74,12,3,229,
b9e1a3a4-f569-4a64-ad31-1f758898581a,Buel,53,37,77,58,51,58,334,
cd572edd-2bb9-4130-a167-8df39c40fd80,Buelah,82,33,82,63,30,73,363,
1020420d-5972-4328-a31f-9e96c29d0194,Buelah,80,39,31,57,74,60,341,
aa7eb22e-f6f2-43c0-ad36-6acd2ee9dd43,Bula,45,89,39,54,9,73,309,
f647e13d-f64a-4c8b-95ef-53f6aa852484,Bulmaro,3,71,86,90,37,92,379,
5b345d09-6696-44db-9c20-7f0fea5d591c,Bunia,85,87,11,87,100,95,465,
87146db7-7d22-4f8a-9606-41b49d8e3511,Bunnie,19,8,8,47,41,57,180,
34d24cbb-317d-4685-b0a5-6def3bbe9f57,Burach,56,51,50,25,30,64,276,
bff02630-ae52-4cb4-9fb3-37ba57254177,Burdette,24,45,4,53,3,9,138,
171dc720-369d-44a1-80c4-282094495fc6,Burgandy,70,81,44,48,45,81,369,
096e8de6-3393-4079-a450-bfb7f77b2c24,Burgess,84,66,49,40,87,0,326,
072dcca2-2584-4aa4-925d-2fae06788f34,Burhan,36,23,51,9,24,90,233,
872ec60c-c397-400b-833d-565687420259,Burley,34,41,73,68,9,45,270,
7659957b-facd-4801-b803-722da56c7964,Burley,14,100,46,21,30,56,267,
b27fabf5-df5d-4d2c-a0f2-a8d3641758a8,Burnell,6,54,86,5,2,75,228,
e8fcf487-30cb-42f3-9157-d2ad0028667f,Burnell,87,74,51,58,67,75,412,
25434109-94d4-443b-abfa-e0879481aacc,Burnell,8,19,69,24,32,73,225,
d15bb183-4398-43ed-95a5-825fa7cb8034,Burnell,94,64,1,87,93,75,414,
1d526958-9205-4735-83b6-ae710d504be1,Burnett,79,40,68,27,32,18,264,
91c6e9b8-6472-4c24-8e24-49ae6d3313f0,Burnice,87,31,66,47,80,70,381,
194df000-cd80-433e-8179-26862e457327,Burnis,73,88,60,39,70,72,402,
2f2b0fd0-7fcc-4e0e-be64-005513255bd9,Burrel,64,85,58,70,56,40,373,
9a486ce2-31b0-425f-aaa8-c09ca2ab20d0,Burt,53,66,96,18,90,97,420,
7008ae8b-89dd-43fc-ab53-cd04e27d5101,Burt,98,98,0,14,69,77,356,
81a89484-d37b-401a-8da3-0bf61acacc8c,Byford,91,71,40,11,24,97,334,
2ee479ab-a864-485c-ac6b-0f5659a4fea5,Byrd,3,89,80,77,49,53,351,
107fa589-a1e4-4621-8def-6db570b87f80,Byron,55,62,98,42,10,26,293,
52e19f34-2acb-488c-90a7-6bcc3729c734,Cadance,44,51,20,45,60,67,287,
2404841e-781e-443e-b63b-d2c0922c42ca,Cadance,31,64,77,83,24,15,294,
1303c9a6-eb51-4ce0-b884-ca0cf768815c,Cadarius,46,19,15,23,8,8,119,
a0288610-d6bd-43f3-a50c-0450712ccfa9,Cadarius,93,26,4,70,26,23,242,
91f6eb01-d19b-4daf-9a25-218ce613fdea,Cadee,67,12,86,41,86,47,339,
88773610-834d-4520-a707-c1bb07125249,Cadyn,27,57,10,95,11,95,295,
f0d4bd93-c344-4dcb-b95c-f5178dc25dda,Cadynce,77,63,46,10,31,45,272,
e6e3ae41-6da7-456a-a65a-b9ddf2c47775,Caedmon,16,29,98,19,42,64,268,
ede0fd33-8d79-4bb8-8c30-ddc682fc21bf,Caedyn,31,21,34,35,100,30,251,
9be87e00-87f0-4504-a12a-81c4a60a9f1e,Cael,85,5,97,33,7,12,239,
b928ad9f-e718-459e-b881-d91ab74ef7c4,Caesar,91,62,72,32,69,70,396,
540064a0-a2ba-4eb4-b742-e8b4918de8ea,Cage,95,45,30,16,92,60,338,
45403460-634a-4f5c-8ede-efe7c985eb23,Caia,15,91,16,62,47,97,328,
86a871c5-51c5-4d31-8255-bc45616cf929,Caidan,62,100,86,17,13,77,355,
f07c4706-4c96-43e7-9d12-38d4dd16a355,Cainan,63,59,31,77,27,78,335,
6270a96a-eba0-4184-9da0-2ad1b8440e13,Caine,47,76,20,32,96,12,283,
306a4552-8f96-47a8-bc50-f638b3a0d1e8,Caio,90,32,64,54,95,92,427,
2b0b23d5-ccd9-4ba0-acf0-24ba83903607,Caitlin,64,14,96,71,21,74,340,
159b5e39-3797-4840-a036-82c3fc529be3,Caitlynn,45,73,67,71,31,34,321,
3663e77a-eb9c-4372-9e98-c076e08e67d4,Calder,56,28,37,82,83,80,366,
01f4c033-aab6-43e1-b64a-8cfac5da80f5,Cale,78,2,62,89,91,60,382,
b2bfdee5-f39f-44dc-a5f7-92df950d3d2e,Caleigh,77,57,76,21,49,27,307,
80c2b36d-5ef7-487b-9efe-2771117e45ae,Cali,30,68,39,25,30,23,215,
49753844-ee92-4dfd-9bab-d0cc3ff7d4a7,Cali,0,37,14,0,100,58,209,
9866479f-11b5-4eee-a775-e6c1091e9a03,Calia,43,73,94,46,66,35,357,
bb435020-e294-4b96-a3a1-6ea311f58f96,Caliah,56,35,44,19,51,29,234,
6d0068cd-8848-4691-8c00-6f952d48b1e3,Caliah,100,47,21,41,63,79,351,
c687e721-f4de-4963-8e43-6d65687e1b3f,Calib,59,57,69,18,24,52,279,
4e2632ad-c2b2-41c8-9dd4-542e6734a3e3,Calie,17,56,30,6,5,50,164,
0e923fc1-71eb-4899-b78f-35b4bab4e00b,Calie,83,56,20,79,60,71,369,
0feeb08b-5957-4b25-a1af-5c540772cb44,Calissa,98,93,38,32,12,34,307,
e92affa9-d129-4575-82b9-47277a478cf4,Calix,70,47,2,64,76,87,346,
577ec215-67c8-4b2c-9d7e-12e237b55a11,Calixto,35,78,49,46,27,86,321,
5df0bdc9-e352-46ab-a2c4-90c660b34888,Calla,87,16,36,43,12,33,227,
49f5f0a9-2f3d-4316-9978-75fdfea6e7d9,Calla,59,96,45,14,13,47,274,
1654db9a-a0ff-4e46-a6fd-eff408592785,Callahan,59,3,71,66,75,6,280,
78fb7b52-3903-466c-8705-8b92e9f17a08,Calleigh,39,62,72,48,90,14,325,
f86554f3-e726-415a-ae3c-685cb6b55582,Callen,71,83,69,34,78,77,412,
7a450b3e-04f5-426d-b1c3-5e3bd8863d40,Calley,42,41,49,37,29,68,266,
ca819555-2593-4921-90eb-24e72245293d,Callia,15,25,26,72,58,17,213,
045eb911-0b31-4ad0-b0ef-87202c73798f,Calliope,1,98,0,71,88,70,328,
05273647-2078-41ba-8da9-c14a3d9d0b6f,Calloway,23,53,100,30,47,75,328,
28c6841c-47e0-4f8f-b1d0-faaf561edbd8,Calogera,18,96,68,22,56,24,284,
9c4f7ad1-862a-4608-a1e7-c08ea001b626,Calub,46,44,82,20,49,93,334,
36b00e06-9616-487a-9618-c2f763b39b72,Calvin,24,18,64,7,38,17,168,
627fb7c4-3e13-455c-b5a7-655f61a2c8a8,Cambree,23,9,49,56,63,59,259,
40ac8d3e-6b1c-4842-8b7a-223f689790bf,Cambree,89,7,78,36,17,26,253,
6ca84cf2-178e-4e6f-9639-86e9d6c3760e,Cambri,38,48,10,40,56,64,256,
db670014-1e19-4a8e-a313-3c5fe7f30af4,Cambry,45,77,32,54,30,95,333,
54ad1000-876d-41a8-9492-0ace2566d8b6,Camdin,33,25,30,21,47,45,201,
e12fb791-2245-452b-b94c-d6c03d583292,Camdin,74,98,27,69,10,41,319,
7d7f4179-80fa-450f-b366-6c06b00fcb49,Camella,96,31,55,95,38,8,323,
2ef40e49-ce04-41d6-9970-fc2ef65cd497,Camerina,93,24,47,21,8,17,210,
77f677b6-174b-4dcc-b7c7-d674b24f793a,Cameron,66,53,93,47,58,27,344,
f834fc51-6527-43c2-bfee-f218c0bd1127,Cameron,93,99,97,65,76,14,444,
ed5daefd-01e0-44b2-9a67-b4989327a520,Cami,64,81,39,4,55,87,330,
163109da-c32b-4297-8ba5-6e300878a3df,Camile,8,11,23,26,79,20,167,
d4b37af1-f9cc-4494-882d-490783e01428,Camilia,6,77,75,77,85,33,353,
f1f8a15c-f387-476b-b20d-fe408b9ac7e8,Camilo,57,57,4,5,69,87,279,
7af15cce-5972-43ad-82c4-d50b9441aad4,Camiyah,1,9,60,66,79,41,256,
ad8edf20-1c1a-4bf0-bda5-ad5e770da052,Cammi,64,47,40,8,74,0,233,
9ff0f557-7ab1-4159-9242-6646750917dc,Cammie,61,16,61,91,61,5,295,
7e01f222-c949-4431-b213-04c45edc73b0,Camri,94,76,52,55,99,9,385,
cdca8283-19b5-4b08-b503-febc7d573e66,Canaan,15,58,87,99,53,37,349,
f04a2dea-f45c-4f89-bb62-209352cce4e4,Candee,60,55,45,52,25,24,261,
23d8c1c9-b6f7-4f16-a9ee-59641a2a666a,Candie,71,8,17,22,27,40,185,
c111a46e-8e1a-484e-8870-0bbeaca03832,Candie,1,2,31,54,1,83,172,
d0628ae7-4035-4ba8-9379-069272b73557,Candise,49,18,80,52,95,76,370,
0d3dd22b-0628-4304-a767-8cbf850c3af4,Candise,47,100,61,5,52,50,315,
a46fb574-e72f-4c06-8fd3-b1a6c088b184,Candler,86,94,6,49,68,71,374,
d7d4594f-4197-496c-925a-7e831aea406a,Candyce,45,36,91,29,54,30,285,
2ad81ba1-fc18-4766-9ff8-4c7533f448b7,Caniya,9,64,18,7,26,40,164,
a7ea650a-95d4-421a-9d13-e5ca9fe15818,Cante,90,88,84,2,66,66,396,
7c4ce615-cf0a-4c34-8f14-7d12ca20cc57,Capitola,87,6,9,70,52,10,234,
3221c6fe-fa46-4c41-b0d2-1c6405e3c52a,Caprice,63,91,37,56,41,82,370,
9fefa10e-d75e-45f9-b1ca-bbd8c68627ab,Captola,45,83,53,1,94,38,314,
d1184c68-577a-4036-9f80-e371ad1be4bf,Captola,70,80,41,67,14,0,272,
e30ded71-605a-40ef-b6b4-055248c1eb4e,Captola,80,78,84,11,7,24,284,
0783a488-d32c-4aad-9d44-c781371f3591,Carely,96,28,13,45,32,54,268,
8a4b8a5e-bfc1-48ed-8fb0-7d8d2a7259ea,Caren,25,53,78,98,91,90,435,
727426aa-2328-4577-ad4b-651732ff85a1,Caretha,82,59,80,54,7,22,304,
00367572-f5a0-40d4-8192-735309f059c7,Carie,48,77,72,9,55,63,324,
4b1b1880-c74c-4d34-9b96-e661b10d6a8e,Carisia,93,13,8,95,94,32,335,
89eb2967-9492-460b-a7d1-4c6dacfddfe3,Carlene,40,74,65,17,63,40,299,
9a2d0372-d056-498b-b804-630877781510,Carless,62,86,84,33,27,56,348,
39fc0bf6-96c5-40f0-9e3c-273a5f4f6eb0,Carlester,0,24,33,79,81,44,261,
74486df7-f30f-476b-8bd4-fe01d98a8c87,Carletta,32,17,16,55,0,54,174,
a8eaa1ac-6652-4aea-b713-7dce32b4d9a9,Carlette,14,10,75,78,89,26,292,
a8d5a004-5f03-42d6-b139-ed1919467101,Carlin,29,54,9,34,56,53,235,
f238c4cb-8755-49d0-9f32-76409d178f90,Carlin,15,1,95,73,6,33,223,
dc026976-8910-4a6d-b499-c052e3ea29d2,Carlis,88,0,58,29,52,43,270,
ab09a16e-1921-4c6b-90c9-7cf3e77eb5b0,Carlisa,88,92,31,27,75,48,361,
0baa6ff3-d26b-4b0e-8573-e4b017fe1c06,Carlissa,5,40,7,91,72,55,270,
e74a2485-99c7-4235-a6b0-bc82bfc48349,Carlita,77,66,68,89,5,59,364,
bf29be46-9ec3-403c-ae61-ec775e891cfb,Carlitos,70,26,20,25,33,63,237,
122a94e6-6b39-486a-adad-093e36c78095,Carlitos,67,24,86,48,38,49,312,
ad29ed68-0e8d-4d55-9b2a-1548308b00af,Carly,63,88,89,45,9,98,392,
7622ed59-2692-493d-a058-20ff5e325127,Carlye,30,8,53,40,64,29,224,
b06b7829-2eb6-441e-82ea-d539c8cbd191,Carlyle,19,65,56,23,46,87,296,
9755cd45-bc60-445d-ba06-124921391113,Carlyn,2,71,57,71,81,4,286,
1b6090cb-f386-41a7-9c86-a50d25083219,Carlynn,96,89,61,12,15,21,294,
8f8d79c6-0e8e-41be-a263-d1a0490b5290,Carlynn,30,47,8,72,39,92,288,
c31480d8-f1c4-440f-8b1d-91f1f009870d,Carma,79,89,0,48,87,63,366,
bbe5fdb8-d58f-434e-9001-c5f33fc298e9,Carmel,6,0,41,36,76,17,176,
85838560-908d-44bd-b46e-a5c356029529,Carmel,92,80,63,12,63,85,395,
f827668d-55fd-4490-bd2f-4977c0b9548b,Carmelite,96,45,12,88,59,35,335,
332a5825-8ef8-4774-9dc1-d80429cbc617,Carmella,0,61,43,47,38,4,193,
1d79ab14-894e-4c16-b3ab-e4c1a0227cbd,Carmello,22,20,9,23,99,38,211,
fa2609c8-5b25-4c3e-99ba-fb7bc6cbac58,Carmesa,11,82,62,82,89,23,349,
65d73f5a-ae3a-4889-8022-63d5f1a11bd0,Carmina,85,5,66,86,80,39,361,
92cfe10f-ac69-4e07-b2e0-c06dbef389c9,Carolann,63,0,30,78,35,53,259,
65192a87-8d03-4ea3-9198-bfe9156e3716,Carolanne,61,66,36,10,25,52,250,
32d897bb-0520-4bc4-8417-93e0069d0de1,Caroleann,16,12,91,66,34,26,245,
cafdb8d5-e67c-448c-b55a-9c0d0cefd35c,Carolene,95,95,7,19,9,86,311,
09f40cdd-2aad-4a49-8ef9-84892d784466,Carolina,39,61,6,83,60,98,347,
f49c4e4f-226f-4200-9d0f-2ca1b1611b0a,Caroline,11,7,0,11,43,75,147,
f438d5f3-29ea-4014-af81-e00fe9c9ee92,Carollee,37,60,82,36,23,59,297,
40b70e8d-39a7-45ed-b35a-875765f6f30c,Carolynn,9,60,78,32,24,56,259,
766c3719-6a8e-463b-9bc5-3913719f21e3,Carra,95,10,27,42,61,87,322,
7a3cf850-8df7-4b5a-b5d1-ac8e8e3b4ac0,Carra,96,91,29,1,6,46,269,
5c1ee432-a665-4fc8-8cda-3c1f5f55590d,Carrieanne,47,2,28,82,3,85,247,
cc83b8f5-6a99-414a-b49c-84fdce1408bc,Carrina,26,67,18,67,38,70,286,
a7735f8f-749a-4817-ad9e-eadb953e5db0,Carrol,89,34,43,43,48,52,309,
9aae1050-5ade-4966-a0e1-15ff99f3c509,Carron,100,92,17,29,16,80,334,
a81ea6ca-a6f6-4292-8f02-5a54fc8dc799,Carson,7,81,12,9,36,67,212,
81aceb9d-399b-40db-8de2-7d80bfc04072,Carsten,0,36,68,43,21,13,181,
2074243d-f61d-43b4-a8fe-3b458a4198fd,Carter,12,77,58,60,0,49,256,
2e59d631-b5f3-4cdc-a6c6-37719fc06f30,Cary,36,83,66,36,52,83,356,
b8881356-97a3-478b-970e-a1b8acbf9310,Caryl,92,84,96,96,82,14,464,
55bc2c77-1c50-4456-9910-d622de772fb8,Carylon,33,28,79,41,96,39,316,
5511e766-56eb-482e-a585-8dca00091f3a,Carys,21,12,63,18,69,45,228,
085d2645-502e-4058-8499-1b6f43689d9c,Casandra,19,58,9,98,94,41,319,
ded1dce0-7a11-4f6b-9042-8e2cc250de9d,Casandra,90,5,94,30,93,92,404,
2a79149d-a9fc-41f7-bdda-0c0004f2146e,Casaundra,97,2,30,14,18,33,194,
c2cb8b6c-c5b0-42ea-9f5a-c85d4eae915e,Casey,9,55,81,81,1,82,309,
8c723883-33a2-41ec-ab5e-b1b891b9f053,Cashius,5,11,17,22,48,15,118,
e26336cf-f88e-47b2-857e-439d27d60526,Casie,27,81,83,70,3,96,360,
8eed950c-cabb-4bec-ac18-98a7fb8e6a4e,Casmira,15,28,55,0,35,74,207,
ba9a8ab7-00ce-4351-aad5-734c20a3f8af,Cass,98,28,93,99,16,80,414,
e7fc5026-d99f-482d-a565-1283b3d2b724,Cassady,40,83,21,15,65,6,230,
f6b5c379-9922-48e9-a33b-ae31e3114699,Cassaundra,85,59,42,22,28,45,281,
e10dfa3e-6b0c-4316-b32c-05fa43ef7660,Cassi,42,38,53,77,71,93,374,
11f38c12-9aa6-44fe-b0fb-9258328512f3,Cassidee,82,22,90,75,14,94,377,
d5347aad-a498-4d70-bdce-cbccfab9b0aa,Cassidi,40,74,67,70,15,23,289,
6099a572-2db6-41e5-8fdc-4bd4e436cea2,Cassidi,8,96,33,15,34,68,254,
0089340e-f356-46f6-82f5-bedfb2811f87,Cassidie,85,48,92,78,31,60,394,
cb0b4116-add3-4f51-ba7d-e7c3c05fb90d,Cassidy,79,100,9,7,97,22,314,
7eea136b-b081-4d6d-b7ca-fff3231c4d30,Cassie,36,99,86,19,93,92,425,
3de7f217-2921-467b-b0a3-b6186921f355,Cassiel,56,49,69,16,6,88,284,
dfce5836-2345-45fa-bc00-ad0c283f9b98,Cassondr,33,25,94,75,31,40,298,
521e5945-7d63-44fc-a8b7-1c1e63182854,Caston,5,57,94,80,54,19,309,
08a9c294-5801-4516-aaef-eccfdbc1b936,Casyn,81,38,62,64,90,72,407,
319a2419-e7db-448a-a642-6c1df9f161df,Catalaya,30,89,55,19,89,45,327,
468c5600-dade-4253-bbc6-e044fa668944,Cataldo,84,42,63,72,96,59,416,
d0b47524-3c96-49fc-b5e1-68ec08105a5f,Cataleyah,22,7,38,90,21,98,276,
0c4c8f1a-3795-49ac-8dbe-6331a23bcad5,Catalia,71,48,47,79,69,36,350,
d3a669ef-8349-44ef-b916-72dc3b965765,Catalina,9,28,91,38,51,90,307,
00d1fc0f-b4bd-4952-9f72-192db0b55842,Catarina,28,66,83,90,28,58,353,
4bc5a8a2-fb11-4b47-bbdd-7aee73322c30,Catarina,19,66,9,50,71,55,270,
77102e55-5db3-4d4f-80d6-c31872aba4ac,Catarino,66,85,42,21,20,35,269,
4a9f2158-f4c7-4705-8ab7-56ba4dbd98ba,Catarino,34,49,9,79,85,59,315,
574dd549-22a0-40f8-bca9-37ad444ef037,Cate,7,92,90,22,48,81,340,
3f2a16b4-efb3-470a-8350-7c476de042e5,Catello,0,6,35,17,6,31,95,
c130a474-af9e-457a-99fc-02a97b8134e1,Catello,80,69,0,31,73,56,309,
6dbee354-d7c3-49fa-9035-df7f04e589d1,Catelynn,56,60,35,36,34,59,280,
9e026072-2be6-4efa-a560-8e4045750e1a,Caterin,27,79,34,89,1,5,235,
bc8ae7dc-8516-42af-9082-1ca3a129dfb2,Cathe,53,6,60,58,96,6,279,
a1876432-07a0-492b-aab6-8d1f3ac77cd1,Catherina,52,38,10,14,77,24,215,
c61e24ab-0700-4380-bd3a-f7a4723a2886,Catheryn,15,92,22,51,81,47,308,
f768cfe2-e4c4-450b-bdfe-8897cde35e76,Cathi,84,62,33,30,50,61,320,
3577320f-28f5-4686-85c6-b63863917fd0,Cathrine,43,75,42,96,2,60,318,
ebf6f44f-1bd5-4767-9313-e3a4d4d96bf0,Catina,88,72,3,52,51,15,281,
e34612d9-d07f-4af3-958c-65a211def161,Catriona,67,18,95,92,70,22,364,
3211cad5-4f58-4e7d-8492-baa331bc6946,Catriona,63,74,71,19,58,91,376,
9b30b2ec-fb26-44df-bde3-70eb30fa1399,Cattaleya,72,80,57,50,40,77,376,
d8d254bd-2c52-4530-992c-635a9f8a94c2,Cattaleya,89,37,89,14,92,39,360,
3bab3de3-c0d6-463f-af24-2b6cfd830248,Cattie,45,35,59,10,76,31,256,
7aacc24a-1b91-4721-9044-4c7b487b5407,Cauy,27,7,71,49,42,77,273,
e51603ce-bc6d-4116-aa58-dbe016490c87,Cayenne,67,73,65,44,63,74,386,
0d2f2246-bc4d-491f-8cd4-bd1fd0a7d405,Cayenne,94,26,3,12,97,12,244,
b2565fe8-596d-4904-a1b6-d32127e682c0,Cayla,11,75,67,6,80,81,320,
44c7515f-2072-45a1-af2d-ee11227cc4d8,Cayleb,51,98,47,36,84,85,401,
0caabf3c-37e8-4987-b689-1dea66a4ea9b,Caylin,87,43,92,76,18,15,331,
ed0e9c0a-e2d8-4d1b-b486-861c21451088,Caylynn,88,12,32,17,92,19,260,
23647907-0efc-49d9-af96-f211eb59e2c4,Ceceilia,58,93,6,26,73,16,272,
cd9d71af-6eaa-44aa-a7c8-ae6c2089015c,Cecelie,23,49,100,2,36,1,211,
e29481c4-3d6c-4cdb-a289-ba9e6cd96372,Cecely,45,77,88,61,87,26,384,
beef543a-758b-45e5-837b-3df058750747,Cecila,24,99,69,67,63,64,386,
911f2226-7932-4754-8929-8c9c973c7edb,Cecilio,91,35,57,34,54,35,306,
0e4c6521-f3f8-413b-9ccb-00e0a1a66f26,Cecille,37,99,29,87,95,30,377,
3dd9e807-40d8-4640-b424-077a0df32568,Cecille,82,70,44,68,86,74,424,
7f2ec861-05b1-42cf-a4a8-db29f8ee39f1,Cecily,90,82,28,69,100,12,381,
164d158c-6594-4486-892b-b7b21dd086ed,Cecily,10,94,33,70,60,52,319,
6172f035-557e-4d5d-b1a5-035c8c30b304,Ceferino,1,28,72,42,43,14,200,
f918c635-efb3-4a4c-a621-67a7564bd1ca,Ceirra,12,23,11,14,25,60,145,
a9e8c290-c0e7-4ec5-85a2-a6e700c65ffa,Cele,41,97,40,89,25,23,315,
6a7d1604-4b2f-4409-bce2-cc785d5bed0d,Cele,89,6,97,36,67,83,378,
0cfef915-3afd-4eb3-aa02-e86e29fb32ae,Celest,50,60,82,22,88,100,402,
ad3b3882-0aef-4543-91c5-c55d66da6b9a,Celesta,62,30,55,73,16,12,248,
32b0933e-3735-4a9f-a844-704f0ca117d4,Celestina,10,97,5,73,53,18,256,
685b62e0-c6fe-4309-b9ec-041fb223e900,Celica,77,4,8,15,58,36,198,
b4fba8a8-d0d5-41a5-ae92-4c2c6d9b06c0,Celisa,32,29,26,86,33,61,267,
b01a8cad-a80d-4e55-afda-3fcd7fd96217,Celsey,46,15,30,8,7,87,193,
bad81060-5873-4465-82f3-b80b7186aebe,Cendy,76,65,54,50,60,85,390,
87fc63c3-0d80-491d-9f0a-97aef17e7416,Centhia,33,13,18,36,18,83,201,
912390e0-9f26-4cb9-ac78-a5fdd29ae537,Cephas,3,18,28,50,14,99,212,
3ac41222-3240-427a-8a59-3800787fa0b9,Cephus,87,17,55,63,71,89,382,
4d3da8f0-637e-407e-9806-87e92e5fe76e,Cera,52,22,52,56,65,76,323,
eaeacbaa-a8d5-4ef9-af0e-3f2d408030af,Cerina,57,36,56,5,45,63,262,
05da8cca-9254-40cc-b908-1047509b8abd,Cerissa,45,54,42,22,57,55,275,
42d1411c-1ce2-481f-b0f8-bf0d2f03b14b,Cesare,19,35,35,12,32,20,153,
ba52b05b-d835-45dd-8418-15684749337e,Cesario,48,56,6,37,49,87,283,
e88b3a57-bbdd-4bfb-896f-51ae1f46c800,Ceslie,95,94,2,63,73,3,330,
aafc849d-6c20-4a84-a545-1cf8920c7b9f,Cha,58,7,53,46,37,29,230,
50ca305b-99ab-4d5e-bcaf-ed13abbf3a86,Chabeli,50,83,96,30,77,6,342,
50d3ce43-9286-49a0-b537-247782060fca,Chabeli,20,5,6,65,34,40,170,
369c4b04-4d95-4269-a653-83fbc0e7d19a,Chadd,51,14,22,100,44,0,231,
74cf6e36-d296-44f6-9954-ef0e51f6ce53,Chaddrick,50,91,94,87,19,65,406,
f7ba55d7-fe0e-4aaa-93b1-c73601d8de2a,Chaffee,17,95,83,87,76,55,413,
1a72193f-a6bb-4dde-bfe3-b71ab297f9df,Chai,77,8,20,94,24,64,287,
b21349a9-1a38-4648-a768-c4a4406af0bf,Chai,79,53,69,12,82,98,393,
eeb3358a-acec-4c9f-9d8e-17759a7c0bb9,Chaim,75,4,32,10,100,22,243,
404331e9-3bca-4118-bd19-2613273fa563,Chalisa,40,50,13,60,44,52,259,
597682fa-ba8f-4d3d-9144-1b239f58f698,Chalmers,67,90,57,14,31,19,278,
306c81af-bad9-43e3-baba-71618ee59e90,Chamisa,65,26,18,23,22,48,202,
aa7b33e6-e54c-42dc-8070-b1e950ac833b,Champ,8,29,4,83,91,20,235,
6bc35f18-4e71-4c8f-b84e-0cb8ceee275f,Chana,93,48,12,37,49,90,329,
884b3021-388f-4690-b453-3ade6423eea7,Chancelor,7,96,5,61,4,25,198,
38efb208-2128-43a6-a5b1-1a91100dc226,Chanda,35,94,6,82,93,10,320,
6d11d9a9-1f23-4f3e-9a21-1e352950f28e,Chanele,67,19,22,74,54,87,323,
17820b2c-a23b-4db1-9b4e-833d27c0aec4,Chanell,10,51,97,31,70,81,340,
4823f108-d4f7-43b9-baac-49aaee778e63,Chani,22,90,4,90,38,100,344,
4211f17a-b50b-4dbe-b49c-fdf6694d6987,Chanice,53,8,92,74,77,51,355,
d486221c-76d3-4760-9bec-394f18e235ea,Chanise,15,33,10,46,3,7,114,
b5bf5ed3-17e8-4afc-8447-a9a368ef2ea1,Channing,39,67,66,3,60,92,327,
5abd2d94-1512-4c3f-a564-6699404228e3,Channing,61,82,52,98,94,42,429,
1bbb6714-02db-4b69-a91c-ca042b1ae67a,Chantal,89,88,78,25,18,100,398,
45048e00-0763-4c52-82df-64fd415a7c2e,Chantee,75,36,16,84,5,61,277,
667edfae-8c8e-4e3a-9798-de7e8f05bce5,Chantel,94,3,50,40,52,96,335,
31b55726-b836-421b-a06c-989c3869370e,Chantell,40,94,86,48,88,37,393,
eaf6fa60-3514-45ff-868b-ddd0d712be1c,Chanteria,42,69,40,46,18,13,228,
8770f0c9-4268-4480-b5bc-cd6c883ab885,Chantha,21,5,16,25,41,13,121,
5f5c797d-97b9-4b04-bda8-3458dc349972,Chantil,59,13,64,43,90,37,306,
aa484f2a-dc2a-4370-a4e5-ea4b57223de4,Chapman,55,47,80,30,33,17,262,
1ebae8c3-1116-4044-879d-b6167eb7b542,Chaquille,36,44,20,23,82,35,240,
b12e3720-3360-4297-ac25-34c149fea584,Charda,78,70,84,20,3,95,350,
edcc5394-366b-48c2-96e3-d922d9439f08,Chardonnay,84,23,78,44,64,24,317,
74532c2e-44f6-4e1d-b9b0-54291ea26b39,Chari,32,31,81,59,62,20,285,
71176787-2b88-4052-890e-3f54df5b0f60,Charis,54,69,30,100,97,49,399,
905429a7-a0ff-4db1-b7b6-073ee674de89,Charissa,57,55,7,45,38,59,261,
19f87bf0-140e-421f-bc23-2e239ab190c4,Charissa,41,51,70,36,10,60,268,
46319c71-149c-4974-aa00-b392bf95d1c7,Charisse,90,81,22,25,50,89,357,
efad42ed-57fc-459f-80c6-a3048bdd1bc4,Charito,49,63,13,63,30,67,285,
95e0c758-2014-4616-9445-ec2aa22e4d05,Charito,39,20,87,72,79,76,373,
17af04c9-fdcc-445b-a341-1e0802d4e759,Charito,76,38,86,47,8,22,277,
5945fe4c-c5d5-42d1-a74a-f026ef0dde23,Charlee,96,92,61,77,42,3,371,
44efb1f5-8054-45bb-9f82-1a81117967b1,Charlee,1,30,46,62,70,41,250,
7b55c4b4-2170-4d2c-89f2-916fed44785f,Charles,79,23,93,56,7,92,350,
2590d1b8-254c-4f08-83a0-afcbc5699121,Charletta,26,31,86,1,20,75,239,
865e3ac0-a802-42fa-b089-8dc285ae918a,Charley,58,86,86,35,91,40,396,
fcb1151b-ced4-4f8a-8e42-9e30e9dd6d87,Charlsie,30,1,15,99,72,13,230,
f6691c9d-0c4b-415d-ac3a-6acfdfb997de,Charlynn,1,40,16,64,72,83,276,
1abfd861-8435-4235-8b05-42e7875d1917,Charma,38,89,99,97,40,70,433,
a0e9b3bd-1a47-4407-b40b-fe4206506d4c,Charmian,66,92,3,37,38,37,273,
f4dcb2a4-9b6c-4acb-b330-081f5f919952,Charmon,73,5,36,43,0,32,189,
048efc1d-6aac-4e0d-98d4-cded20f76336,Charnae,1,43,74,24,90,22,254,
44ce6d0c-151f-4681-a4ea-c9b0a89d4fb7,Charnele,81,51,28,97,13,3,273,
ae616c94-9d33-4899-ac8f-00eb0426c578,Charnell,96,27,42,23,94,58,340,
9212ad08-17c5-4354-91f0-6fe9c3b77532,Charnissa,3,18,53,29,71,89,263,
49f477e9-76ef-42da-ab35-c61f8ddd732d,Charolette,79,71,67,70,99,2,388,
c89a45cf-8a07-4f83-9af5-dca97ac057e0,Charolette,54,85,25,13,97,38,312,
7b33eb8f-b302-41e5-af30-050fa41ca1d9,Charrisse,93,81,28,9,94,79,384,
933672ec-ddc1-4855-b87c-b8d75dce5d86,Charvi,14,59,49,100,93,96,411,
913b46c3-f86e-4163-aed7-8b9d2b8bc95d,Chas,47,59,95,97,95,75,468,
00a80b07-78ef-4e6e-8a0b-aa09f85ada8d,Chas,98,42,16,40,53,82,331,
ddc368c3-311f-4b10-8233-2f479dfc8bff,Chaselyn,72,66,83,5,31,93,350,
ac132dad-869a-419f-bedf-7778010db5fc,Chasen,43,76,41,23,4,27,214,
b07cbb33-c71d-4adb-b768-b919dbffb2e0,Chasey,87,35,78,75,7,17,299,
648c39b3-c4a7-4d33-9bf8-ae7da3624e5b,Chaskel,32,85,8,33,53,50,261,
9a5d4ee9-9cfe-40b4-a800-5c63984c4502,Chaskel,14,32,75,100,90,11,322,
1ee09119-37c2-41a7-b760-ee37cb8630ae,Chastelyn,68,15,42,57,0,46,228,
52397f77-2456-4c21-86c7-d6832773db80,Chasten,45,33,97,41,95,52,363,
768b0c1a-555c-4b16-8c17-adcea52647b4,Chau,52,61,25,70,13,57,278,
cfa137c7-7489-4859-9b4b-9053085a73a9,Chau,33,71,3,44,70,48,269,
c48bdd34-a173-4d55-9ed3-3880ea6222c5,Chauncey,8,91,25,9,12,10,155,
10443e2b-6277-4fff-bb8a-7f169dbcfaa1,Chaunte,74,26,92,71,2,56,321,
5bb37bd2-ed3f-45f6-965a-cad9dbb8f914,Chava,94,91,27,84,57,47,400,
f6850341-9cf0-4c9b-be0a-b0f6a86dd82b,Chavez,14,76,14,14,34,83,235,
a1947f5e-6729-4653-a310-e9e8f2ceb806,Chavez,3,53,30,12,36,65,199,
7ef3e108-ac96-407c-9708-0dff4a0a7240,Chavie,3,62,76,96,13,44,294,
f450320f-4a10-4d8f-a453-c4f383435cbd,Chavis,84,36,65,72,90,29,376,
4dbfd4d3-f33c-4718-bab6-4574d19ead73,Chavonne,38,2,2,13,0,23,78,
a4986fdd-ceff-4c92-9320-b782cacf0baa,Chayanne,48,34,69,15,89,25,280,
b7a1e7ff-c7d9-4e74-962f-7def1261a0d8,Chayanne,80,8,20,8,47,71,234,
ef572ec7-7a58-4bad-a51f-4b259f8c5022,Chayla,36,99,53,88,28,28,332,
43cfdc59-5afd-4429-9cda-8a2c61bbeafd,Chayse,98,33,20,42,61,64,318,
fe642c6f-5a9e-461d-8e64-ad08b83c18ca,Chaz,74,100,67,49,97,12,399,
86bcab9f-0f78-436f-b3d7-7ade652d6d44,Cheetara,6,76,53,86,83,98,402,
63610beb-9b2e-425a-a19c-8650927f6f59,Cheikh,24,23,63,60,17,3,190,
a85003fe-4e91-4480-bfed-973b216fe36d,Chelci,94,5,35,22,79,97,332,
275fa422-312e-42fe-a10c-89428d03e3d2,Chelesa,42,97,16,34,51,77,317,
8c1eeb0a-0796-4e9c-a486-3d2aefa91158,Chelsea,4,62,31,1,83,14,195,
f7a255ab-33ba-4d5c-846a-aad07fe2040b,Chelsy,68,92,16,44,97,69,386,
5ff6832e-fd05-4980-9047-13da0923f40e,Chenay,45,74,57,73,4,37,290,
bdfbd2c2-4622-48ad-99ce-d976cfd03cba,Chenin,83,56,63,76,35,24,337,
1b0a5bc1-a79a-4879-8c70-2d0854b25a0c,Chenique,15,82,78,56,1,49,281,
4b544cdf-792a-407a-9a18-585dd05ab3a9,Cher,37,25,89,3,22,63,239,
d2a8cf60-c2c7-4093-992c-b6a7e4796192,Chera,66,0,90,99,28,15,298,
61d8b456-d929-4da4-a16f-cd7cbfaba82e,Cheree,51,31,14,94,27,13,230,
97c50f19-1841-42a3-9c53-862db14d24dc,Cherene,75,84,83,11,79,62,394,
f2c5ee7d-19a7-4349-ad04-b08dc8ab9b51,Cheri,13,91,97,79,76,6,362,
a752ea40-d83b-4a55-8ee7-e4429e3c390a,Cherice,98,80,99,27,53,83,440,
6f5e6977-7a25-4bd5-8207-7c41ed5debc2,Cherika,8,82,58,96,71,70,385,
7740a0ea-8eb6-461f-8453-f87b9d29d884,Cherika,48,42,59,35,32,34,250,
7e6333d6-d751-4e09-adcb-e76e04254719,Cherish,91,53,28,33,51,5,261,
0b7247de-56e7-420e-b0eb-fa559d42b4ca,Cherith,51,3,31,23,56,61,225,
0c77ea5c-b09e-475c-878d-b7473e67ccc3,Cherlene,5,30,5,3,99,73,215,
74bad411-6d6f-42e3-8582-43048c5ab9aa,Cherlene,23,6,77,34,95,1,236,
917c02b1-353b-4766-a0a6-06dd331ba83a,Cherrie,31,70,34,18,13,20,186,
245b53d5-c4c3-423d-b552-55b8bbc30ff8,Cherry,73,97,46,78,64,1,359,
147adfde-d66c-4a50-98e7-cd2db515c93e,Cherryl,70,88,78,27,9,17,289,
ab1b5706-3f2f-4d3a-a345-42bf58da2234,Cheryl,53,75,29,34,50,5,246,
8ccde0e8-0f35-48ca-bae1-606c5e014a2d,Cheryle,38,33,22,59,35,5,192,
7c72c4a4-78c2-42fb-8b89-552e646cdbfa,Cheskel,12,98,58,4,70,13,255,
1e084963-4d03-44fd-877a-1242abc5dd8f,Chesley,78,32,19,76,35,73,313,
b4563262-81d9-4fa4-8887-606a1b0ad74f,Chessie,94,100,47,11,43,20,315,
aac2f450-d71a-489c-836b-a6d87e410f15,Chevelle,92,84,58,45,8,71,358,
cc8f1fb4-f022-4281-8507-bab137a84b3b,Cheveyo,2,32,50,28,85,58,255,
6873bb7a-2a43-4bd5-b25d-c983b221a782,Cheyanne,76,97,84,73,19,42,391,
c4b13c53-524e-473c-b4b1-cbf879ecc881,Chezkel,97,81,13,86,74,4,355,
ffc10dfe-f86b-4556-8cec-9d430b7bf356,Chia,60,37,76,55,77,59,364,
3edc5406-e537-4aed-b922-6ec58f48a4c6,Chia,57,19,79,17,94,48,314,
773e8bd2-4c51-4b72-89b1-648572534550,Chia,75,40,37,9,67,5,233,
7bfb7aa0-7215-49bc-adf4-a494a7ae61f8,Chiamaka,63,58,96,29,68,91,405,
10b8f393-66dc-49ff-b3a3-4d1b8108df92,Chianti,2,82,11,43,91,96,325,
9790d072-e0e3-4643-953b-4de510020c66,Chiara,54,3,14,16,40,32,159,
960dac20-5ffa-4c9b-8cfd-bb3e196ae3bc,Chidera,12,13,86,25,52,85,273,
13530b54-5557-4598-b8d7-8d9e46474462,Chiffon,79,75,68,14,9,97,342,
da17bc25-b7da-4615-af6b-e3e2451a597a,Chihiro,39,52,32,42,82,9,256,
35ce16d5-dc46-462b-9f6e-ca354057a029,Chika,84,51,94,10,63,98,400,
4ada5866-8f7c-4ba3-8262-ec622ea61fac,Chimene,17,78,42,32,8,99,276,
5729e879-b70a-4d75-a5fe-4d810140201b,China,25,26,58,85,63,52,309,
b28a4a22-e4c2-4862-b851-2c98ef32b8b9,China,96,73,54,78,13,22,336,
a13188cf-e308-48fe-9773-404e2b4ea702,Chinita,35,9,39,53,27,6,169,
7e06e55f-754c-436a-8b80-6291d05608a4,Chinyere,99,33,63,62,60,92,409,
673f0fa1-e505-400c-ac1c-0b217364b8a0,Chioma,3,16,22,64,82,92,279,
eec88fd7-e0c0-442d-9335-64ef56fbe2a4,Chisom,23,49,65,61,96,41,335,
612ca734-e375-411c-bcac-694f65a287ef,Chisom,13,65,83,22,0,21,204,
193c9923-d1c9-494d-bc53-eb9dcb01b647,Chistian,64,75,35,58,83,61,376,
287da8c7-69a5-4a2c-bc63-cbfcaf5d7b03,Chiyeko,92,59,10,74,39,98,372,
2ae5b24a-7a82-4bc6-ba0e-ab864f5ae0e2,Chiyo,75,83,81,21,23,14,297,
b7f6b5db-4a70-4788-8802-7867c3070a76,Chizara,95,30,88,35,53,42,343,
02873d30-e5a0-4a5c-b9a2-b6ac3810a79d,Chloey,99,72,39,5,42,91,348,
b0392ad8-bee1-4892-abec-597a24fc2b50,Chloie,38,41,16,83,36,42,256,
a641a1aa-b0ca-4ad3-8d93-fdb97197de52,Choice,44,40,54,79,30,83,330,
598eeebb-cb15-4236-b305-b008fc5fa94f,Chong,43,62,71,90,97,36,399,
2a640567-1cce-4464-9faf-8a09cbdc17a0,Chris,42,71,55,46,87,84,385,
744d7447-8f60-4ca4-a0b8-9a0211ee9943,Chrishun,93,8,33,59,93,73,359,
05a5398b-2847-4688-9bd8-413561b96144,Chrislynn,65,57,86,66,58,92,424,
f499e4bb-1de0-41f5-b593-0f7898fd8978,Chrislynn,76,61,59,36,63,38,333,
a1fa3394-bbd3-4f3c-bde9-d91ab9e14940,Christabelle,72,100,12,13,75,24,296,
279be74d-a59a-471a-8582-33957e8557a1,Christe,27,87,16,26,67,35,258,
d155a94c-f1d9-4f4f-b37d-785940569cab,Christeen,83,34,60,64,84,6,331,
ff8d18da-bffd-4707-b17f-3e756cb55533,Christella,64,4,71,75,7,71,292,
afb4295a-7f62-4b31-a1f0-9ab873c3426e,Christelle,53,5,72,16,11,13,170,
d42121f3-007a-4e75-9fd5-b00f7a426f89,Christiaan,32,60,17,95,1,39,244,
e517dd00-bcea-44d9-9ddb-1cf8021916ba,Christian,31,80,60,90,35,87,383,
8e23d6eb-030f-40a2-bbab-2da7f46af3be,Christianjames,35,27,96,28,15,85,286,
e26e6035-801a-4b18-8b8b-76948110f501,Christianna,31,69,19,48,66,48,281,
fbd0e793-7a87-4588-9690-5714ecaab142,Christianpaul,91,16,14,33,61,63,278,
6da13429-2e4b-4823-a1e6-fcb5b6435f10,Christie,8,17,69,56,100,74,324,
0caf73ca-f619-4ff3-97a5-4d1f8a9aca33,Christien,6,15,82,38,45,98,284,
8394b47d-4eda-4514-8397-9b57f6fea346,Christina,32,77,82,7,2,97,297,
7a7e4a0c-0922-432d-9c1f-20062f4a1022,Christine,14,73,7,80,82,89,345,
004e2411-bf2a-4825-a197-7d1819efc5d2,Christion,40,15,79,83,10,89,316,
351dcd91-8460-48de-8f68-fac91d6a11bf,Christle,42,78,86,71,25,50,352,
d4c474f5-d4bc-40ad-96a1-e6730d13c9b7,Christle,69,38,57,51,49,70,334,
496193b3-0466-493b-8c95-5880a11a521b,Christoper,68,74,97,40,36,7,322,
c60d75c3-4632-45c9-8da2-59265f61511f,Christophe,50,32,97,92,21,90,382,
2bc9c130-b7c9-4ee6-9bb5-f2c9f982700d,Christophere,53,11,21,89,74,26,274,
ac9ff349-619e-490c-b0c9-a95ea73dbe6c,Christpher,61,37,97,10,78,94,377,
023c60a0-3e1c-4de5-ba55-07da2b290f94,Christy,85,82,17,34,67,57,342,
235f369e-c9d8-42e7-8176-6004647c2edd,Christyana,89,92,27,34,98,30,370,
45be778d-6567-4572-b6a5-a05aa1a58b84,Chritian,61,17,100,13,85,43,319,
6dc225ca-c2c1-40f6-ba4e-6ff8fa7326a3,Chritopher,16,9,47,19,44,60,195,
1a12cf91-affe-4075-92f7-5d282840c713,Chritopher,1,91,90,20,74,28,304,
72fbe964-317b-44f2-9551-6156d9572526,Chrystian,38,15,81,71,77,3,285,
0e205a97-15a0-45f1-9f91-2e155829210a,Chrystie,50,27,2,61,79,97,316,
1cdbf849-f622-4f16-9587-1c3cfd78d588,Chrystle,33,80,65,98,15,54,345,
d24d4705-db7a-4df8-80c4-f527a8c394dc,Chrystle,28,7,19,24,7,75,160,
aa3cf97f-79b1-4560-9582-7b6e66959446,Chun,16,94,94,80,23,26,333,
2dc7caaf-f91f-42aa-b3ab-55253b037858,Chung,19,84,93,64,14,9,283,
c7641a16-00b6-44d8-9e27-605c6d26856f,Chyanna,78,72,33,14,99,61,357,
ea7091d3-ab8d-456b-8ea3-b152ce457343,Chyenne,72,17,63,60,94,36,342,
3f3bd7bf-d9ed-4fda-8fd5-eedcf3608d1b,Chyrl,87,6,11,50,82,71,307,
ee1fb4fe-6f25-47e0-a007-8c95c493e1e5,Ciarah,51,29,22,97,24,79,302,
a594ae28-c0cd-46e3-8794-6b61ebd641a6,Ciarra,65,37,88,56,33,48,327,
4a695fdc-9cfc-4c1a-871d-aa2ef6676a49,Cicily,95,45,84,45,10,29,308,
f3aebfa8-2e26-47fe-bcdd-e6ecb9ef12d7,Ciclali,35,13,49,82,81,3,263,
9c1ff31a-0221-48fb-8765-8a1a0b4abe54,Cidney,21,34,55,39,59,49,257,
336ab294-2568-4a62-aaa3-f5fbb09cfca2,Cienna,8,85,75,20,48,21,257,
800ad643-9292-4f8b-96d0-d1d7beb6dfe6,Ciera,21,73,18,0,43,91,246,
6b58ddf0-6e3a-4ec4-b049-1a86cc49be53,Cigi,4,79,9,52,55,61,260,
ec520a24-54c6-4564-b9f1-73714ec3c704,Ciji,96,1,26,31,62,17,233,
eb162059-4214-4a2e-920c-a31d256ca652,Cilia,1,86,26,12,47,67,239,
a63c80f6-357f-4114-90ba-5ac894c54d9c,Cincere,52,40,38,23,30,11,194,
d2a27fe9-63d0-40eb-80e3-2a3048ac1509,Cindee,23,58,84,18,76,43,302,
2bc38d77-6a97-45be-927c-30c8685b68f9,Cinderella,35,17,85,53,82,2,274,
72294faa-5de0-4797-92b6-ac73e3defb1b,Cing,62,4,42,19,49,27,203,
27bdb6ba-0b78-4c9e-a29b-5d2ee9ce32e7,Cing,81,40,17,17,79,47,281,
f91bbac7-ab87-4c3f-8c42-d4d6d3d1504c,Cinthia,43,56,75,38,69,24,305,
b052d467-1db6-4f48-a76b-f8c43ce02f72,Cinthya,60,69,48,31,23,97,328,
d9122e50-7c77-4293-9b51-57e1ed07dbfb,Cisco,31,48,56,68,71,93,367,
473ca6c6-5ce3-47ea-8c18-e2da7fd838c1,Cisco,16,72,30,71,29,84,302,
b7f59ff5-d1f5-4240-8165-64e020092f19,Citlali,6,22,31,22,55,9,145,
0dba221f-b224-4af3-bca6-050e047ef016,Citlali,87,18,7,80,37,23,252,
78204bb7-5458-42a1-9fde-f42587cef393,Citlally,75,55,25,84,47,66,352,
8bc94ac9-5647-4403-a556-34836b96568b,Citlally,4,49,72,31,3,60,219,
7530c725-dd87-4747-b548-5cee91ff3ae6,Clairissa,62,53,12,90,2,12,231,
0cf69566-08ce-49bc-aa5a-9c124d442c63,Clarabel,94,59,27,61,80,3,324,
04a1fadd-9c2d-4d77-abea-bbd087eee4c6,Clarabelle,4,15,45,16,98,34,212,
616b55f6-5128-4c88-8057-02155b64f6c9,Claramae,12,21,32,70,43,87,265,
f07bf2d6-234e-48f5-a258-50439756780a,Clarice,31,12,54,54,49,79,279,
950db95c-0625-4155-9557-3a6f004b051a,Clarice,23,44,60,12,69,56,264,
48e1f329-052c-4a84-bd4b-9bb73e1395e1,Clarinda,19,45,41,9,23,9,146,
92065fcb-97c6-45cb-acb8-43addca830e0,Clarine,31,49,34,37,99,21,271,
df9bc10a-e4e2-4fca-99ab-e2ba16ba5707,Clarivel,90,75,8,8,38,91,310,
b3aa91ba-2f29-4711-abc1-0fd4955b2eb3,Clark,81,75,18,45,26,7,252,
07c01e46-64d1-42a5-9780-997e6f7ed708,Clarke,83,73,9,2,7,44,218,
42ef44a5-5bfa-414d-9885-4938b3645315,Clata,99,93,35,93,29,21,370,
ec1cf8e5-6273-45e1-b56a-5a7d9aee3d0e,Clatie,0,100,49,21,99,15,284,
7b1f2a60-402d-4230-9a78-5525f248a66e,Claude,74,61,44,78,33,12,302,
95e1d5e4-c0c9-4e71-a145-b190850ff18c,Claudell,99,40,89,11,23,77,339,
8c0eeb71-919f-402a-8c3a-44dbe2c247c3,Claudie,36,25,48,53,11,35,208,
74f2ab1a-59fd-4581-b7ef-b59d28503141,Claudius,29,18,20,81,2,37,187,
36840f44-3101-4fad-8dbe-fee472383f48,Claudius,44,85,28,14,97,25,293,
3c655079-b015-4fcf-ba59-5d97305ddacb,Claudius,34,15,94,83,76,67,369,
974d0a44-e3df-4cdd-a05a-4b6ed05501ec,Claudius,49,38,28,5,7,20,147,
daf8aef8-c180-42a6-b845-64b3b91b40e9,Claudy,1,84,14,9,35,55,198,
0664e5e1-6d44-4fa3-8281-1487f32bde1f,Clayten,15,30,91,36,28,24,224,
658b97b2-ba5d-463e-8fbf-58fc0f1ea663,Clayton,36,33,71,18,32,69,259,
706a6e3c-c809-4d6f-83e6-b286183509e2,Clearence,40,83,61,91,100,37,412,
9d925f56-9a4c-4750-b12c-21299a64be95,Cleason,95,96,48,99,8,84,430,
e50e3fcc-91eb-48f5-924e-9fa7ec499c69,Clebert,43,89,20,70,14,22,258,
b73c140f-9934-47fb-bba7-fa6fa7b9db75,Cledith,24,5,72,76,15,11,203,
5f5b1313-c178-44cf-a23f-d3f5cde17e17,Clela,19,9,62,24,97,70,281,
e8183ba1-093e-41b5-98b8-8e1364ff0be9,Clelia,91,95,88,83,10,66,433,
cb995f36-f6ea-4449-bb96-adf9c8eb2ccf,Clemence,19,31,99,80,13,62,304,
fa5c6b26-8a68-406e-8600-b39df87a18bb,Clement,13,95,100,66,52,92,418,
e02d1ef7-93f1-4a90-ab3e-e7d979582cbb,Clementina,88,92,78,23,53,25,359,
153e9487-d343-4751-a680-903b0aa50936,Clements,70,89,32,19,1,25,236,
318c27cc-c060-48bf-b5ef-7972526e6239,Clemson,53,51,35,50,70,86,345,
cd839652-28d4-4c65-a958-4f0a521bd5d4,Clenard,18,48,8,16,56,0,146,
619169f6-0a65-439f-8622-36ca3386b6ed,Cleotilde,83,60,93,69,19,34,358,
b87eea7d-253f-429a-aaeb-9341893e9e2f,Cletis,31,73,67,47,11,53,282,
806350f5-bee2-421f-a33d-d70247794053,Cleto,77,1,55,88,59,47,327,
48ffb8a8-da0d-4a90-baf7-897a7e5afb95,Cleva,96,80,39,80,47,43,385,
1fca7a1c-ab51-4808-8c43-2ce54227357b,Cleve,42,100,34,96,48,38,358,
178d57f5-db42-468f-ba71-b151f3ad7c24,Cleve,99,35,72,29,71,46,352,
4ee224f3-3380-4795-b39a-710cd2bf1f6b,Cleven,60,98,37,75,27,64,361,
a985d4d3-2c28-4b37-a993-2ec7964d2f0a,Cliffton,97,44,0,31,51,11,234,
e6e7b52c-52e9-4aeb-8a65-9895472cdcf0,Clifton,57,41,87,28,75,68,356,
342a67bf-cc38-414e-8f9d-a04e3cfe8db7,Clifton,25,49,100,15,66,56,311,
e38ded30-a201-4039-8c6b-bd63585a2548,Clorinda,22,32,31,78,62,9,234,
5691481d-6edc-46dc-9d88-84306a86df9b,Cloteal,80,96,55,8,36,22,297,
3a9bbc95-161a-4305-a94c-d0bb9585fe39,Clova,12,41,28,35,62,21,199,
53c111f9-688e-44a5-a66b-524874469104,Clover,61,24,95,82,86,87,435,
a30bd56e-fc64-43a9-a9ff-353fb772caaf,Cloyce,95,53,52,92,95,67,454,
d95cfe3a-2f91-4e46-aa29-47ad27e107a8,Clyde,85,28,80,55,52,54,354,
cfe3eec0-d00e-4f61-80a6-15a73be1df5c,Clydell,10,72,14,64,15,38,213,
cb3e7f28-c5c5-4a55-bf88-6744da4debdd,Clydell,23,95,6,14,59,8,205,
91f1e993-2a03-4d83-a7bb-751a8662df0d,Clydette,89,97,15,97,3,23,324,
f72df424-3a97-483a-90ba-6582d84b5b90,Coda,10,43,3,96,84,64,300,
43d6f27c-7448-4afd-bb34-e7ff64513cb9,Codi,9,40,42,97,2,95,285,
3c8f3d7c-1a45-48c6-a763-7a38d3470cc2,Colbert,97,21,71,74,6,89,358,
d175a414-c0c8-4771-b2f7-d26ff6f93df0,Colbi,82,42,77,29,80,84,394,
3711d0e0-5a9b-411b-b7ca-ede0646b6b2b,Colbi,12,21,78,78,58,96,343,
ab90dc38-e5fd-425d-992d-d48e7b573656,Colby,11,62,83,15,79,33,283,
0f858804-798a-4e98-b0d8-55c63f568dd5,Cole,91,95,60,73,62,69,450,
9cbe8bbb-b003-4805-8992-6ca36b80dd6f,Colen,48,82,75,5,5,39,254,
2ad621b6-b5bf-43ff-88ed-b17e5fd5e106,Colen,72,70,36,47,12,16,253,
763f762e-0382-41d6-ab69-008be193e854,Coley,1,55,63,85,51,37,292,
66fa9e58-becc-4281-ad1d-733f8f92e76a,Colin,44,62,71,79,38,52,346,
5ebc53d9-3fe4-4165-bb58-0d424d2a159a,Collene,20,33,10,49,71,44,227,
66baf334-c42c-4085-b125-a9fba61a59b0,Collier,92,26,2,7,69,31,227,
b6aa85c1-f90b-4ee2-8b43-1c578d662abc,Collin,97,3,89,70,90,55,404,
58cb61f3-2267-411c-8da1-e9a0631f7856,Collyns,90,100,42,76,88,18,414,
8e0c62dc-e518-4d59-b4ef-9c2614ae875c,Colonel,49,42,13,77,81,99,361,
3415ab57-7356-4344-8e1f-7021baf507a6,Colonel,4,99,20,7,74,36,240,
6b6d965e-c48d-45f9-a83f-d16397795b82,Colston,28,59,89,35,55,42,308,
b78ef8c2-3da6-435f-90f5-27e621fdbc5e,Colston,22,10,38,77,85,45,277,
66606f6a-fe55-4b41-a9ac-40cbf3a2a8ea,Colten,6,2,49,29,33,0,119,
a0429f37-2c0b-4817-8274-adffeeb1ef93,Coltrane,24,15,33,0,57,80,209,
c2792480-b73e-4a36-bf23-943aebb7ed78,Columba,82,83,33,17,94,87,396,
485f284f-9f7f-459c-869c-96aa92c07014,Colvin,18,27,30,44,57,42,218,
f4fc91fb-e416-44e1-a07a-4df7f7737243,Comer,25,23,6,50,78,56,238,
3a90d97b-5366-414c-b253-61ce31c8692d,Comfort,44,13,87,20,85,7,256,
6d2c2a96-4a1e-4f1b-b891-1abdf9ef6bbb,Conall,22,50,64,86,20,19,261,
ed13cac2-4cae-4aaf-b365-4f0c525c9742,Concepcion,93,47,15,31,39,38,263,
1cb323ac-75dd-4159-b86b-b61d823b138f,Concetta,87,68,35,0,52,17,259,
e30040b1-6cc3-47ea-825f-a2bbc42fb933,Concetta,69,46,26,39,46,48,274,
10c1d2bf-f58b-4a4e-b892-ed904bbb35b0,Concetta,16,74,88,79,81,58,396,
e2601460-71a4-4a6a-84b5-9923e005758e,Conchetta,92,15,60,90,64,46,367,
4e33da4f-cdff-41a7-a237-2677f53e6b76,Conferina,89,91,36,53,19,14,302,
2c804f16-4446-4923-95c9-4f977e3d2589,Connell,39,97,36,65,8,92,337,
8ad0595f-dbae-4ec9-afdb-c3d82a09ccc9,Conni,77,39,54,34,67,56,327,
29b0700d-8b98-40ba-b55e-cb27a41c0f2c,Cono,27,63,42,92,45,43,312,
788bd201-e230-4914-a24a-00fc78354476,Conrad,34,13,85,66,39,98,335,
952239e2-f29a-45d9-a2ae-65ec65efd472,Constanc,88,81,87,21,93,36,406,
95a36e76-03a7-4b33-b43a-8e2c11367220,Constantina,71,26,78,54,43,58,330,
a7320948-db0f-4b01-9336-cdbb9ae28525,Constantine,66,77,96,75,83,43,440,
42a8adc6-d386-4861-9455-b90715280f8f,Constantine,20,71,57,94,72,63,377,
ff87b5ac-71a6-4956-aadf-6e2571a6a979,Constantino,72,96,62,53,26,20,329,
c6deddc5-7990-405a-8ab2-812168ddf0eb,Constantinos,85,15,18,64,55,84,321,
384cbc5d-c2e9-4a79-8ae6-61586aa2b659,Consuela,96,11,8,38,30,15,198,
91767404-73dc-46c0-9c0b-faef00de7238,Contrell,100,60,63,12,37,30,302,
68e1daf5-9912-4998-8b3b-be48c6e99b83,Conway,96,23,28,7,30,25,209,
5447ec46-2818-4663-8251-f5bde9553e73,Cookie,31,3,37,65,26,14,176,
a4c1faaf-e3a1-4d0b-a948-b5da184ee6c3,Cookie,37,73,96,43,64,82,395,
5897308e-a1b2-4d99-9531-7c0ac25780d5,Cooper,78,83,24,85,21,28,319,
eb246944-b1c0-47da-b0f9-7f01c1255a9e,Coraima,1,23,57,49,36,92,258,
d04213b0-cf94-4354-aee8-578f02ea1ee5,Coraima,20,67,5,30,20,62,204,
7b42daa8-0a90-4081-8227-acf82c984058,Coralyn,89,38,86,74,93,46,426,
8926793e-337f-434a-901b-72cad29463db,Corayma,89,15,5,59,48,3,219,
74da8f0d-a6b7-43e6-89e1-2bbfb44d9045,Corazon,7,66,30,93,30,92,318,
b5db22ea-60ba-4850-9a21-857af0514a59,Corby,86,90,0,66,57,91,390,
8f5dea76-e66d-4c0d-9797-8ed33fe69e21,Corbyn,68,58,28,95,27,49,325,
2fdcd0e0-8810-4a76-a1c2-fe7ab985cd41,Cordale,96,90,33,30,56,76,381,
58322d35-0b73-46e4-b638-987c25bbea4c,Cordarious,8,44,76,85,56,98,367,
6b060e2e-df15-4ba2-803c-f1ea7c8080c3,Cordarious,84,15,96,54,53,25,327,
79675643-ca2d-4a41-be48-ba79bd835c00,Cordarrius,82,29,3,62,90,30,296,
b0564743-4b2e-4484-b15e-c08367052aba,Cordarrius,80,41,87,51,7,34,300,
c5bd0c09-a1e2-49b5-8ee7-9d514e272112,Cordarryl,88,72,65,26,30,86,367,
00845ca3-39a2-4b71-93e0-73384897cf90,Cordella,35,86,91,10,95,69,386,
aea99bf1-126b-4416-8386-0eb20b36cbe9,Cordera,52,63,96,20,91,3,325,
e452fc74-a99d-46fe-88be-297ba9612472,Corderius,40,40,63,1,23,8,175,
2f252bb4-8f5f-45c6-8452-2944943724de,Corderius,57,81,16,85,80,70,389,
8b77eac5-581e-436b-a104-d18611c30cae,Corean,87,2,87,31,8,55,270,
2b79d3d2-ede9-4b62-b6d4-a06e2f83dcfa,Corena,90,28,57,96,64,98,433,
b484af77-706f-4e8b-8dd4-1fda3f078356,Corena,58,51,86,97,85,54,431,
201c26fc-cee2-4a98-b4ce-d417e0d73567,Corey,26,76,42,51,30,58,283,
f03dc4f2-1ff2-4d56-b904-3bcabd0584a9,Cori,34,11,9,70,28,97,249,
8f7bc8d3-8cc9-4220-808b-0d8c9d3dceb7,Corie,18,39,16,18,99,96,286,
750edcb0-701c-4dd3-8d53-53ef99d75bd3,Corin,57,13,41,40,86,95,332,
88275b76-9e1e-49fd-85c4-a87b3706960d,Corina,100,34,42,61,8,66,311,
05fee907-5045-4804-be6e-b8c445579ff1,Corine,46,71,45,13,41,46,262,
471bfdc4-4449-4aae-8e5e-65033110931d,Corita,19,66,50,34,21,48,238,
53cf576e-1e4a-448b-9a6f-dfbd62ab8dc4,Corita,16,59,15,94,92,75,351,
c12597d8-edd8-4468-b8e6-1c17b58d61f7,Corliss,47,94,69,56,54,13,333,
9bcacd8c-7dff-4f64-9b78-57ab87fe3b7d,Corliss,68,3,69,30,27,52,249,
4d11762b-38b4-47b9-ac6c-77c22bf1e180,Corneall,18,27,40,83,82,100,350,
e57f7f09-621d-4277-8e3b-5014f6f3e349,Corneisha,24,42,67,60,82,53,328,
e205adcd-7c8a-4007-8e48-c233894d867c,Cornie,9,37,56,8,77,51,238,
9f2b7f6d-7e42-4312-96f5-330f33be1e0b,Corrado,84,52,90,65,26,61,378,
61df6588-73a3-4f1d-babd-7e57637c30b6,Correna,8,69,66,63,98,47,351,
6c1a3138-d6c9-468c-b436-72861414fe84,Corri,43,88,90,67,5,18,311,
5caf5ef1-419b-4178-b49c-c834c6cf5d1c,Corrie,1,10,20,48,65,76,220,
5dc3eadf-0b27-4e2c-9198-2b116383e17e,Corrie,68,84,76,22,68,6,324,
bf29e245-8262-48df-a83e-a5619d7dff18,Corrine,43,34,7,54,63,57,258,
a892950f-a7ce-48c4-93c1-8aea4fb91b6d,Corrine,46,48,86,71,95,46,392,
db162e0b-093b-428f-ae0a-caeaac67a01d,Corrine,81,52,74,10,22,87,326,
9c790c9e-71db-481f-a84c-d033d9d021b5,Cortavious,3,79,49,33,65,14,243,
b43ee2a5-157f-45e8-9fe6-35943fd7e416,Cortlyn,56,66,51,60,84,90,407,
4eaa2579-1726-440c-af9e-29f95998e2e1,Cosme,62,58,36,92,6,9,263,
53f10ea5-3133-4edd-a6c7-0436a58dca75,Costas,50,63,54,30,43,20,260,
cb346bdd-30cb-479d-aab4-e7a1265a9ab0,Cote,85,76,95,31,50,73,410,
46167167-1aac-4be5-a9f4-687ee5111eca,Cotina,85,38,35,84,66,85,393,
39f8ec4c-e796-47ab-af95-a7895d6e2396,Cotina,75,72,82,67,86,18,400,
b38c88e1-d5c2-4b3d-b56a-7049b08f401b,Courtland,32,16,36,27,45,96,252,
dbcd81be-e2e0-4528-822f-9f41cef4d611,Coy,18,14,47,62,64,61,266,
c0f30af8-7bf7-4e2d-9a95-0ecb13410cf7,Coyt,74,49,15,60,55,27,280,
06ef59e4-cd2d-443d-bf08-fdd728bf4d20,Craig,79,26,71,51,51,80,358,
64f0b7f9-21cf-4a74-b12b-7f764116305f,Craven,4,33,2,92,83,26,240,
22af7db6-eeb2-4f6f-b125-dafd3bea46d9,Crawford,12,74,44,68,61,20,279,
72cfe4cd-ef4b-4967-8d54-fbccc36dc9d8,Creasie,30,92,78,89,39,60,388,
85e0c144-95f5-4cb9-8c6b-c587a8a97e70,Crestina,20,34,60,42,3,48,207,
9be66346-bf92-4b98-b146-175928790291,Crestina,24,26,7,36,39,28,160,
4b6996f5-d3be-4235-889f-ce2fda29f5f9,Crew,51,28,26,47,36,48,236,
320278a7-0a61-4078-9a25-1093826500ff,Crimson,86,44,65,36,59,68,358,
496d36b8-5655-4481-95db-95d141f59107,Crimson,10,19,39,34,8,64,174,
2f1997f2-283a-4c7b-9083-65519c0d4d97,Crisanta,0,63,49,33,39,76,260,
9a696c14-6c82-4645-991c-34a1990bf656,Crissy,78,86,38,45,97,43,387,
1abd5f18-4fe8-4dcf-a7c3-ab8c8b97241c,Cristela,85,88,6,58,8,39,284,
e6c69bdf-d1c1-47c8-bdeb-56ef0ac5ed8d,Cristen,26,76,87,77,75,71,412,
111d9f23-70c0-4ff7-8917-01f2b5cebe48,Cristen,84,72,9,82,95,46,388,
3194ae22-774a-43e5-b1b5-afe5c32e1478,Cristie,47,11,6,73,58,54,249,
20aec1af-2284-4d8a-bc31-e03eee358ec9,Cristina,14,36,65,14,76,32,237,
3faefb56-c624-4f0f-8788-71c0bdfaddbd,Cristino,92,27,41,68,11,7,246,
a32b688d-9580-4ea3-bf67-bb85def99fd8,Cristy,43,17,45,53,23,2,183,
2e3c093f-54d5-4046-8978-72c4176cfea9,Croix,100,3,25,48,74,99,349,
c62a7e3b-d697-44c8-ad7e-800ef4212713,Crosby,72,43,22,54,43,18,252,
8563faa8-a2da-4f0d-a098-aecaa3793dd4,Cru,91,100,75,47,12,47,372,
32eb4ee9-235d-4581-a697-0a0ae5addd07,Cruise,65,53,79,91,63,93,444,
38bbdd6e-878e-437f-9ee5-4719f6c12dd6,Crystalann,65,80,81,84,58,31,399,
88a742c2-4f19-4d6a-a5cf-24829063b606,Crystale,60,45,32,48,25,92,302,
1af278ec-733e-42c5-8990-476155432cf7,Crystel,32,7,60,5,55,98,257,
ed5c3d9b-6acd-459e-8a4a-2931c5bb9fae,Crystian,8,15,9,30,60,10,132,
c99d3594-06f6-4815-87f3-7a0c32d62982,Crystina,5,90,24,97,96,28,340,
577a3513-2c73-42b4-aecd-da79f0c43477,Cubia,11,9,17,57,37,0,131,
1ed9e7a2-a9de-4a2b-a5e7-9321efaec4dd,Cumi,10,62,8,6,27,76,189,
8e4a800d-0cdc-4bb3-8643-ad3ecfe9acc9,Cumi,49,96,60,10,97,68,380,
31329509-b7cd-4933-a174-8f0d51a93c8d,Cung,62,51,24,88,13,85,323,
4c64d464-beb3-42e4-a58c-6e1fed528ad7,Curlee,42,77,68,64,100,77,428,
edefde47-57ca-4776-8f24-923c4f850ff3,Curley,28,90,45,10,58,95,326,
45cf02c8-b258-4996-af88-52177c0a1ae3,Curlie,83,24,85,31,93,8,324,
6a0be125-e516-48d5-ae96-ac72ff99aa6c,Curlie,54,92,84,21,42,68,361,
ddfee5a5-b1ac-4a6d-a0e8-9ede8fe7f0a0,Curren,56,17,84,44,47,6,254,
0a9f481f-13bf-4f85-976b-0be7ba667b7d,Curren,71,54,69,78,15,85,372,
344ce4d2-c2e2-466b-99e1-80d941fa668e,Curry,86,40,59,85,17,51,338,
fdf13a28-0a0f-4c16-9d2e-945db183d9b1,Curtiss,34,80,100,47,68,37,366,
e3565f68-7d11-4cb3-a89f-3e880f8c4041,Curvin,52,47,100,0,8,27,234,
47c50a57-6dab-4ac5-b454-2ececd2adfa4,Cutberto,44,97,82,90,52,98,463,
d327333a-a110-40f9-9176-15722a4ea90b,Cutter,8,28,90,18,39,49,232,
ed7982d9-e2fb-4a1c-b662-f590ff0e9088,Cybil,52,63,4,87,64,77,347,
b244572f-7c43-4e5c-9639-77f4334f0ce8,Cyd,8,95,45,72,95,51,366,
1b2970c7-4390-42c9-a2df-fa44aa81b25a,Cylis,6,91,15,63,27,29,231,
adbde652-05af-4e33-925f-326541359b78,Cyncere,35,24,80,23,26,6,194,
7fd559ca-74b9-4909-be94-324abfe7b3f4,Cyndi,94,97,37,72,79,30,409,
0df560b8-0bce-4ec6-8ac6-241505415afc,Cyndle,85,99,70,78,13,66,411,
e3aab1ec-1a31-42b3-bd0b-29ee5ca68e48,Cynia,46,80,48,84,33,15,306,
71c2653f-2964-4274-90a8-1c4dcbfcd3c9,Cynthia,79,3,28,79,71,72,332,
aee764dc-b349-4bde-b9c7-877f5380d05e,Cynthya,40,20,85,50,54,58,307,
898fe500-15f9-4ecc-98c9-c122f24b7d77,Cynthya,87,17,44,52,54,69,323,
1ce6923d-822c-4876-9ef2-804f7721ac9f,Cyntrell,87,22,88,2,61,17,277,
71fd3984-5e5f-40aa-a7a4-c752b3a06800,Cyra,37,58,64,42,50,1,252,
2a9d5448-777a-4191-9a94-db6302287019,Cyrene,83,69,93,8,66,60,379,
27938b5b-6f38-4e50-b121-d1f4bc0da1a6,Cyrilla,52,15,36,60,21,75,259,
0e8d3c74-6c87-463b-81ed-d290f9fdaa65,Cyrilla,43,89,27,20,50,19,248,
21e748e4-4268-42cf-8c1e-647c0d411b73,Cyrus,83,56,0,62,60,95,356,
476b75b5-578b-49b7-97db-cdc403dc9f60,Cythia,35,92,42,37,75,88,369,
d7e56435-7c04-40ce-a51a-af61af02a4e4,Dabria,58,41,89,0,97,0,285,
7070512d-4c6e-471e-91d5-e5000b2c08a5,Dacey,89,56,9,45,54,61,314,
e2f6de32-72be-4312-95d5-30c7c31131db,Dacie,72,6,39,61,57,4,239,
b4907c11-77f2-4bb3-8992-8d8b1787cb43,Dadrian,95,40,27,16,94,22,294,
9b048975-ac67-4fbf-8431-f2aac746033a,Daejah,24,31,36,65,75,63,294,
3bfc7177-5eb8-4256-bc3b-e199dc092d66,Daejah,60,23,100,7,74,38,302,
b0ab866a-eba8-427a-b6b9-deb168101bc6,Daekwon,7,87,40,30,47,49,260,
1b88b458-e75c-4701-a227-6cb6a5d3ee95,Daelon,28,99,71,23,71,58,350,
adcece9b-4bce-4d38-8495-edc067e456f3,Daemon,53,70,64,70,91,31,379,
6eb04098-8ffe-4b44-967c-7abff6ed54bd,Daenerys,22,63,29,50,38,53,255,
f0cdba21-cc86-401e-997a-c91e1e72f8dd,Daevion,77,35,39,94,79,91,415,
2b9cd042-9169-4d64-a8b4-8ec25e5444c0,Dafney,12,81,84,34,94,93,398,
58af03fa-49fc-4881-be75-0e5cf20d2b3a,Dagoberto,94,40,56,72,2,81,345,
f8367798-5c39-4bbf-84e3-368130965b22,Daiden,16,89,77,50,16,30,278,
08809a22-2852-4c88-8ad0-09bd5c7cc4b5,Daiel,43,94,25,20,79,79,340,
65d88c92-c6f2-43b2-855f-4acadd810178,Daiel,2,89,21,53,74,61,300,
3d514bbd-062d-492f-bd74-e20aa5cffd37,Daijon,53,57,57,5,40,71,283,
7ba9bf51-19b0-4e47-862e-9f9e89d6e6f4,Daijon,44,46,30,13,42,88,263,
396eb0f9-b901-41be-bfca-9c2a79f6549b,Dail,65,3,100,31,12,95,306,
8fcc9d41-158a-4d0a-a7fc-b3e5a9930da4,Daila,76,23,87,88,55,82,411,
cbd7a252-591d-45b7-82b0-969327b8521e,Dailon,93,46,57,54,76,90,416,
cd12a0ae-80e7-45d0-b599-653405f21ed4,Dain,35,36,77,2,47,25,222,
820f5641-8a26-42ac-a392-e5ec92334d74,Daisey,3,17,21,5,84,37,167,
e6b64aa0-0eef-4fb2-9f6e-2d0cd1d6cdcd,Daisey,52,91,67,87,40,54,391,
db1e6caf-7297-49b7-87a3-31dbc1f1e160,Daisi,29,71,87,55,9,67,318,
73c5ff72-5b62-4392-9054-178df42d20eb,Daisie,46,23,31,91,28,38,257,
c9628b9c-290e-4859-919a-18ac022a7151,Daissy,91,67,42,78,59,92,429,
449b41b8-655c-41a4-8866-0c1c6532f0ff,Daisuke,17,49,40,82,92,10,290,
0ae1964c-4414-4722-aef9-992047ab5f4b,Daja,0,30,2,28,76,10,146,
ca643a67-9749-46aa-8ffa-90fe9b66fe7c,Daja,19,6,16,5,86,37,169,
7958395a-9c60-40ac-ab2f-73abe8c11e09,Dajae,21,21,8,99,1,35,185,
cc493aa3-428c-427d-95e7-49a0f66ecbd4,Dajah,96,90,75,30,66,61,418,
347f0678-b2ab-401b-95e7-3318c8025843,Dajana,56,16,91,85,93,16,357,
1207ff47-4ab8-4548-a599-32ebb2400824,Dajanae,55,23,47,81,3,5,214,
a05ffb19-6a97-472c-a8a2-7d6286ad7e38,Dajia,20,8,67,71,77,99,342,
f951f982-f495-46b9-b7e8-803a3c9da62f,Dakarai,11,41,4,96,54,75,281,
d681771e-6a31-4c27-b9f7-e0c787d2cc44,Dakayla,99,52,49,47,80,53,380,
3c04d311-eb20-41a3-b321-2673113a8c30,Dakeem,91,41,40,98,33,89,392,
0aeeb434-5309-4bc4-ac12-a48bab0d754f,Daksh,43,24,93,48,74,35,317,
5396d558-faf7-4556-a369-23f8470aec2d,Daksha,88,57,72,78,5,74,374,
75b95ddc-5349-499c-908b-9d80d9379b5e,Daksha,54,89,43,36,60,36,318,
5b67a951-cf11-4869-80ed-69ef97278ba8,Dalal,25,12,60,35,62,46,240,
c090eae1-61f3-4b53-b160-cddfea474c8b,Dalaney,8,87,30,31,13,44,213,
b006b3c5-717e-4b91-9517-f8ff6ff5fc49,Daleyza,64,81,47,34,62,32,320,
304dc149-7842-4812-ac8f-8232d4bffe81,Daleyza,55,83,35,59,7,50,289,
c35cea40-5e06-4cf7-8136-218b7b6b1fbf,Daliah,75,42,95,21,2,20,255,
eb28e771-ee78-4835-840a-ba7908b73fb7,Dallie,99,77,38,42,83,85,424,
fda0ba4c-6837-45a9-b7d1-f4339d98eb35,Dallin,68,78,97,41,49,36,369,
0a79da76-29c2-40d3-86e0-f167e5119b87,Dallon,91,88,82,27,92,87,467,
84681cc4-1ae3-4997-8172-f35c4bc030f4,Dallyn,99,19,52,37,95,4,306,
1e75a9c5-a001-4220-8ef2-eb49e3fe8de1,Dalonte,32,0,46,38,68,83,267,
47d68f8d-79e6-4b0f-947f-fee37705961c,Dalyn,85,3,56,58,92,95,389,
9ef1b1a5-a76e-468f-a433-b2329a9568e7,Damacio,97,87,84,79,1,29,377,
52cac9aa-6ad8-4542-b336-ac428ff9276c,Damany,45,33,8,41,99,26,252,
fed9993e-e0b3-46e3-badf-c2f645ce8212,Damar,6,73,9,49,77,26,240,
61754a14-cdf6-41a2-aa34-09afec475423,Damara,97,73,31,80,0,82,363,
52e65f69-87ab-44ed-aac7-f9867b8fd257,Damarco,94,89,68,75,96,64,486,
d7455d4d-4b33-4703-9dcd-411a2d4fdc9f,Damarcus,29,22,46,57,29,61,244,
63a2d735-1253-44e5-b8f9-46e4466b91a1,Damari,36,100,58,25,67,36,322,
dace23bc-7bff-4aa8-9e2f-43db2f6a2970,Damarian,61,96,91,85,89,25,447,
c79652d4-0c97-4e97-955f-3a4e0de199dd,Damaris,45,11,3,95,17,95,266,
fc88ea01-6f57-4146-a158-eea98d0410e9,Damarys,23,14,74,91,17,70,289,
ac34307b-7b78-42bd-a9af-bf70713b2e24,Damaso,87,66,9,45,76,62,345,
24156046-b940-4fe8-b6f7-f6e595f52506,Damaya,59,53,48,75,12,29,276,
fc923eaf-f91f-4c93-ba36-615a74a005a3,Damel,79,14,44,85,73,83,378,
302ed65e-667d-4992-ae7c-462dcf16aacc,Damel,15,0,20,53,33,43,164,
111aa8bf-7dda-40cc-b552-c95d091495e1,Damen,74,8,23,43,65,17,230,
111f4be7-38ec-40ed-94be-2fd44c330ec8,Damere,100,69,21,35,1,75,301,
f23f7eca-c837-49a0-bef5-781e614592f2,Damiah,99,56,53,35,38,44,325,
ee654e23-3808-4657-befb-3f82ac95cdf9,Damiana,70,85,49,66,33,3,306,
2c62250e-1f80-4f5b-b1ae-2ec760042aec,Damiano,16,20,92,66,96,66,356,
852b6b92-4af4-44e5-8266-b8b4c134e233,Damika,32,37,21,78,55,52,275,
b4dee522-6063-4c1b-a731-195bb42434b2,Damika,40,58,11,76,34,33,252,
ad36b235-11c0-45e0-98cb-46d17d044828,Damin,5,15,34,81,8,95,238,
bb81c9fb-5afe-496b-8886-e40ba73dcf03,Damoni,2,94,4,24,19,1,144,
5d2dc344-7916-4ef7-b6d4-9da64ab0aab0,Damya,10,84,22,37,77,18,248,
a8ad96ca-5008-425c-a043-4a58211030d8,Damya,94,80,31,65,91,74,435,
5bed7922-813d-46e9-8ec5-0aca812307e4,Damyan,30,42,24,1,10,10,117,
11337d1e-aa8b-4731-a22f-560cca36f90b,Danaisha,70,11,78,35,67,53,314,
cb69d3dc-ec2e-43e7-b8bc-7abdb98e4385,Danaja,86,36,7,8,78,8,223,
e6f22c60-e871-4ad2-aa3e-e562ef1b63af,Danasia,17,88,40,66,83,42,336,
a903b4d3-00f2-49a5-ae1b-f366f1b92262,Danaya,38,73,61,78,92,94,436,
8badb8af-b40e-419b-88a3-28c47ff9bcff,Danaya,100,31,76,41,12,79,339,
be56c3c4-42e7-4735-bb6f-33c4bce9fa7c,Danaysha,0,62,97,57,38,63,317,
3e416b13-b597-4f6e-bb1a-ac7c4b826ccb,Dandra,76,7,23,87,5,92,290,
8b9a6971-6d6b-4907-9e7d-24aa7fcbf3af,Dandrea,80,53,65,42,18,34,292,
958b2e15-462a-4c40-acb7-99685eb836bc,Daneil,38,5,86,52,47,53,281,
e64ee6db-d7e2-4370-9209-1ef70df81b70,Daneille,24,42,71,14,86,81,318,
2fadc036-3797-4384-9578-6d930dd5b199,Daneisha,88,88,10,34,84,28,332,
b1dfbd21-e573-45d9-b4bd-acd23661e16a,Danesha,43,92,42,97,86,0,360,
0a38bfc5-75c9-4395-a678-30193026e225,Dania,19,71,59,93,47,46,335,
838896db-aaca-4a23-80f7-8b06c5a8e99b,Dania,57,72,20,85,68,93,395,
b9ace3b9-7a60-4ac1-8540-68a1ac2c9df8,Daniele,50,87,28,57,33,10,265,
77ae9dea-aecc-4ede-a541-77653da35226,Danieljr,16,15,14,33,89,56,223,
29ac01c4-fce6-4f7b-ac83-ad58e1779e45,Daniesha,81,13,44,39,29,44,250,
29095012-9a0d-4ee5-bbe4-5e7305fbdd1b,Daniil,44,70,58,40,9,73,294,
590e90ed-1990-48fc-8f15-902d053d288d,Danish,96,28,76,3,39,2,244,
3c86eabc-4e9e-4dec-bb82-70082f51825b,Danitra,91,24,95,90,32,22,354,
b0ff640d-b7dd-484a-96e1-6e464de2cae3,Daniyah,8,98,22,98,1,97,324,
53f7d886-990b-4ada-9b33-3f548129257c,Dannae,16,30,30,7,30,18,131,
47e1bea3-9200-41dd-947d-47ec71f9428f,Dannae,69,62,74,100,88,11,404,
7f7b6728-8d43-4477-a40e-30b3fa5de60b,Dannell,67,10,11,98,62,56,304,
45ef95ae-d80d-43fa-a54f-4eaf7753341d,Dannell,19,71,36,81,4,40,251,
929bd6a4-79ca-41a4-ba53-c866882c63ac,Danney,4,69,73,85,87,8,326,
879ec503-eea0-4322-8a3f-7487a44e2b0d,Dannie,51,40,30,27,50,30,228,
d53554c4-8aaf-4bc8-a8ee-c6ae6fdcbd91,Danniel,76,91,76,19,32,38,332,
0240da07-a83f-4a00-a888-563026f7a636,Danniela,99,52,4,18,27,20,220,
535baeb7-b9b2-4056-9464-cc85e10dac6a,Dannielle,61,72,74,27,81,1,316,
a35ee459-0245-4679-bbf2-b77c4612f252,Dannika,25,15,100,22,66,10,238,
9588461f-73d7-45b3-8d43-3323ccdb3512,Dantavious,55,49,73,97,33,64,371,
0f744ed0-163f-4b00-aec9-4b261daa8d32,Danuta,80,21,31,93,23,14,262,
6ee62b44-c99f-4710-a596-4681644d1a3a,Danute,45,90,53,61,58,74,381,
8db5a0dc-53d3-4c10-b1e2-ddeef9edc116,Danute,45,48,69,18,22,19,221,
2aa8c626-7d64-48d1-849c-3891fb65bef1,Dany,53,32,28,84,59,80,336,
e110c6d4-265b-46d3-baf5-ed4158107893,Danya,73,49,80,7,8,56,273,
a3414393-9635-4eb1-8236-650656b72d83,Danyal,42,18,49,12,71,29,221,
ffc48ec8-5d4f-4687-880e-8bd946e90f77,Danyale,43,89,99,62,39,59,391,
fe5c93c4-0430-4e7a-9b65-53688aa3b243,Danyell,73,30,26,98,13,82,322,
d41075c5-e904-4ee3-b8c8-48726bf6daa0,Danyella,75,3,87,8,14,86,273,
204eff8c-99a2-44e8-bbee-3e2dd8d687cf,Daoud,91,39,12,23,7,21,193,
49cabf12-af50-4bb8-a3c1-f6dbdf5b524a,Daoud,19,14,56,31,90,61,271,
e8ba2300-345f-4602-ba7f-572a2c32f64a,Daphane,0,98,48,28,5,96,275,
325fe39a-0b93-40f9-8725-3be05d35d962,Daphanie,31,56,98,99,83,56,423,
9f1b2ee3-85a6-4dda-9234-c50a0432d760,Daphanie,55,12,7,9,75,12,170,
269dd390-df2c-49e5-997e-2bc36e3718f6,Daphine,66,32,70,62,81,38,349,
966d5dc2-6cfb-4b67-a73b-4decefadaed9,Daphne,84,88,74,94,8,89,437,
0a93e186-0548-4550-b8bf-363d90a61007,Daquan,5,53,68,87,79,70,362,
33fe587b-8174-47db-9e6e-d02e6f85b66b,Daquann,39,70,6,12,49,79,255,
b52f74fc-0042-4446-915a-f396d3c2433f,Daquavious,41,91,49,57,14,5,257,
40a60d61-41d4-42e9-8ffb-9ece22592bfe,Dara,88,27,8,14,7,95,239,
f5b34747-3ce0-4a0f-90e4-2d2a10c490d9,Dara,29,66,15,68,68,75,321,
4f12e2d6-17bb-4922-bab3-7a6c870cff21,Darby,84,58,29,76,93,48,388,
06ec3698-e528-4346-b9a9-b00362299d7a,Darcel,37,32,94,86,78,15,342,
733baf2d-0563-4ea7-8215-de47ad2f3a1f,Dardan,58,37,4,43,70,81,293,
169d516c-a351-4cf2-8d1a-5c568d2be2bf,Darel,70,16,78,47,22,13,246,
2c3a10d5-645b-4719-89a0-55b4829dff46,Darel,28,2,94,73,74,13,284,
71f25bc6-6ba0-4ade-a339-e8aa24b833fa,Daria,48,50,58,98,50,20,324,
12227994-63f1-4355-874c-272e443c6f59,Dariah,47,81,6,95,82,51,362,
687cf456-184a-4b66-bdaf-7f2b8e6b5ad7,Daric,57,46,40,7,60,31,241,
fa4ce06b-71cd-490b-83b3-35407915ddab,Dariel,27,6,33,57,82,93,298,
6a62f735-fade-4e07-bbcd-36c9efcb9803,Dariela,17,63,81,4,90,17,272,
b6ebe321-59d6-43ba-add1-a7d4c7c763f1,Dariela,20,74,50,75,5,70,294,
bfcd60a6-ff58-4dae-a0ae-7519a7507653,Darik,52,77,72,12,19,32,264,
f848ee00-bded-4ded-a910-8506b5741594,Darin,39,93,75,93,38,47,385,
233521bb-87e4-4dbe-a52d-0762039dd8eb,Darina,70,83,47,68,84,45,397,
d0d35d6f-d75e-4a69-973d-d3f2a2001ade,Dario,60,88,99,40,74,45,406,
81674502-2236-4a26-882a-f934d18ba4c3,Darionna,78,82,55,47,74,74,410,
e1755a22-9092-41b0-8fbe-9ddc1895ff6e,Daris,28,9,75,56,66,40,274,
f03078f9-99ec-45bf-b544-218b420fa372,Daritza,100,21,2,47,92,11,273,
e9e4bc60-17a2-4563-8d01-4ca8fae7fa10,Daritza,42,33,13,22,72,60,242,
8f625e33-6611-4adf-9f74-63e749e621e5,Dariyah,72,22,38,30,83,79,324,
89dbea17-2c70-47eb-8ef1-1321bc100db6,Dariyah,25,68,45,22,16,99,275,
c2d89c53-04eb-4a72-92c5-bf410c9b9da7,Darlin,73,82,16,42,58,43,314,
5d5d3244-054a-4743-9476-b64440dbf86a,Darlyne,62,31,75,96,80,33,377,
492d0f4a-5bd4-4d39-9370-65193b9c3d84,Darnell,24,86,33,16,72,48,279,
6be4b12f-a4c9-48b4-a7b4-10aa1925f45a,Darnetta,39,65,98,97,58,75,432,
0a48439c-5dab-402a-9378-5a77091dabde,Darold,50,71,55,25,61,50,312,
2c365705-5def-4fba-afb1-1249e15cb78b,Darolyn,45,15,78,6,53,38,235,
0e6e618f-09e1-4535-a2c6-2084cf84dc0d,Darrah,62,32,44,90,28,91,347,
e2359ace-435e-42d0-8e93-20715c2fda90,Darrel,2,76,31,23,57,59,248,
9c85f872-6e76-4c12-80f5-a8dbb4b7e157,Darrin,25,4,5,84,29,64,211,
5c4822dd-00e3-4053-a6f6-6d9a80b915e9,Darrin,88,10,94,47,82,98,419,
67535e3f-8e1c-446e-b66b-654efc4b0b66,Darrious,95,17,71,99,27,69,378,
7cc946cc-c2bc-4153-be83-1981050148ee,Darrious,87,90,27,80,76,70,430,
cd599180-377d-4a04-922c-1083da10f756,Darrold,25,13,26,64,29,64,221,
595653d9-6810-4aa7-b594-9d9c3b6d489a,Darrold,83,44,56,54,13,40,290,
89c8e88d-07eb-4098-ab46-ed30243798c6,Dartha,57,62,73,50,64,36,342,
5109e68a-2e4d-4343-be04-ef90ceaf2efe,Darthy,5,42,25,59,66,37,234,
64781d8f-9a1a-405a-92fb-24222370a245,Darvin,14,40,48,12,32,22,168,
456c8ec0-f998-4f34-80cc-315988e723ce,Daryan,34,72,19,89,39,88,341,
a13b6120-0d40-4dfb-ae33-9480191e7e31,Daryle,65,65,9,13,13,23,188,
b6563ee3-4608-4fa1-83b0-1ced1ada950d,Dash,58,19,24,86,12,52,251,
3b06edeb-95d8-4c68-8dbd-a441b02349b0,Dasha,45,47,62,85,24,49,312,
3fc7bdce-beff-4701-a0d3-2590c2f606a5,Dashanique,97,19,63,15,52,20,266,
43b5176d-1cee-4cc5-bf45-2adf3341c406,Dashaun,89,19,77,26,85,80,376,
e87e549d-fa17-4aa4-977b-4ee57853c3e3,Dasie,34,10,3,43,19,3,112,
0bc68ee1-3481-404e-b38e-4adaaef18e65,Dason,37,4,23,30,22,37,153,
7e8b04cb-a0f1-4635-88a5-6f0fdb3bfd40,Dat,61,2,19,64,21,7,174,
a6f86618-273a-4e70-b31f-2f82822af996,Dathan,48,31,62,14,81,13,249,
2f7840be-ce61-4ff8-ab78-a444a7589595,Daun,39,33,58,40,22,16,208,
0f72a271-a176-4500-bcdb-0470d0ef6813,Davia,35,42,96,32,56,4,265,
092d9f8a-d332-4839-8963-4ac175b9220f,Daviana,59,27,35,79,96,32,328,
f5e7be00-eba1-49ba-a519-32a71bc09ca8,David,16,55,3,39,46,67,226,
8b634e1f-702d-4fb6-acd4-47aceaa2ea1e,David,10,38,73,79,92,25,317,
49670aab-20b1-456c-8680-c2ab0e61e9a4,Davide,24,70,66,97,20,34,311,
a99c1cde-e492-4b5b-bd64-6061dcd223cc,Davie,1,48,89,94,74,83,389,
8fe7a655-3423-4c36-8a0c-da153e431ec9,Davier,87,70,73,76,57,55,418,
9f6cf2c1-06fd-411a-a171-b46b842cc09f,Davion,0,8,73,3,67,39,190,
c8f6d601-64e6-49ef-bc71-5525db7d0ed0,Daviona,23,17,86,32,14,33,205,
6ec4d03f-3ad1-4b07-ab41-36742f58f3e4,Davione,13,100,0,27,46,78,264,
fd319968-ca13-4887-adcc-bc52d5244fac,Davis,54,16,62,65,72,42,311,
e7bed15e-5f96-4c63-9bc9-77c5dae5ff0b,Davisha,57,41,97,22,99,80,396,
d5130d05-923f-40d5-bdba-67b596a6abd7,Davona,28,50,60,6,22,60,226,
df083835-6114-447f-8c6a-40e28313f7d4,Davone,0,28,25,17,99,61,230,
b378f590-5351-4fb7-b53e-97e1130f424f,Davonn,57,39,29,13,48,0,186,
844ea76a-8c37-43db-9dae-634608912a11,Davonta,93,9,4,40,59,4,209,
3252a3cf-772a-4828-9c4a-c946884147e2,Davontae,38,58,58,36,54,65,309,
937ec66b-1480-4b68-862b-70b24414a0db,Dawana,57,59,79,85,48,84,412,
2571488b-6aee-48a7-b7de-dda988156035,Dawnell,41,61,57,60,24,33,276,
1fcbbd28-fd79-4a47-b225-c8d9c167328c,Dawon,51,38,46,68,89,55,347,
4ad558bf-a317-4c55-ba8c-28c3c3a0903f,Dawood,90,76,57,75,88,0,386,
03e58eaa-8494-44b5-8ab3-b44700a96084,Daxton,36,69,42,18,81,20,266,
de7a7c27-635f-45f5-b2c2-4b0242110e27,Dayan,45,78,61,7,20,46,257,
6ee9f1dc-09d4-4ce9-affc-1c97530f38cf,Dayanara,55,98,77,36,73,63,402,
4e791a9a-b108-4304-80bb-7cae1b9579c0,Dayani,49,15,21,80,40,87,292,
57cf7e1b-ae29-4887-ab2e-f3d3d7a57644,Dayani,2,70,7,26,87,96,288,
d9e46884-59f7-47f9-b71a-ed1fd51b7bba,Dayani,65,26,52,36,24,40,243,
caadb484-6f68-46d5-8de0-6961dbac3f4e,Dayanne,86,57,8,72,74,74,371,
5d5bc722-c68e-4243-a98d-3723f229f5f2,Dayleen,61,9,35,60,52,68,285,
570f2a86-1408-437b-a280-2d66fe4e3fd0,Dayna,4,69,17,69,50,57,266,
3576097a-334f-4af9-862c-a2af9211036f,Dayron,2,55,35,29,27,88,236,
2fe778a5-cfa2-456c-8a38-9342a8a6565f,Dayshaun,38,85,23,76,49,1,272,
19d4ebce-6fd5-4877-8330-89449a2c95b1,Dayshaun,72,50,96,96,66,20,400,
c3cdc746-9055-41c3-94e2-4a29a231d7ee,Dazhane,88,45,66,6,70,90,365,
52a370f6-f543-4e51-a795-5ad1875e9a05,Deacon,100,46,43,95,91,62,437,
39c548f2-502f-4c5e-9ab4-d63e2578fbfb,Deadrick,77,68,88,92,19,5,349,
89452cba-95b3-4240-aa90-c4b9b3c48c06,Deaira,7,59,12,5,46,26,155,
b5b2f262-8d2e-4499-ab3e-3ac75e689003,Deamonte,82,10,62,63,64,70,351,
22f747b0-135d-4564-845b-afbe8dd31f13,Dean,76,29,36,7,83,57,288,
d4dd9927-a550-45d0-867a-6b8633e71ab5,Deandre,18,4,99,71,75,71,338,
f908cfcb-27a9-4e2d-a339-c4faf8154bad,Deandrea,22,1,1,33,49,37,143,
b889b48b-dd0d-48c4-89a8-02a3740a019a,Deandrea,16,45,92,91,67,65,376,
32d0842d-781b-4d6e-b3a8-d6b41ae1fbbf,Deandria,60,24,26,87,78,3,278,
7a9bff27-c89b-4813-9c99-ce541a62d4de,Deangelo,62,49,93,42,80,59,385,
c48722f0-d2e6-42a8-87fa-c11b159ff692,Deante,63,95,90,42,3,49,342,
a1f40dcf-5f09-424a-b77d-127e7a3cc174,Deanthony,89,55,24,37,32,96,333,
02575c8a-c717-4f52-9a71-9b5f5c5516ad,Deanthony,84,18,67,28,57,9,263,
0f612afd-fab8-45c4-8ec5-d60071d2f73a,Deashia,3,36,10,41,54,36,180,
a7073bcc-5c41-4600-9f43-abc15bc9b635,Deatra,15,3,53,48,13,6,138,
dbf5d427-72f1-41ff-b94a-99ca1e17b255,Deatrice,27,16,31,14,6,2,96,
25016398-a3e0-4b4e-b80e-90594feb2769,Debany,28,95,18,4,9,66,220,
a6bfaa9b-459b-4516-a4b0-b2543507bd8c,Debora,22,55,22,22,15,52,188,
b6395958-76fd-4c01-b8b0-0a984b9f2b98,Deborra,17,65,92,69,47,23,313,
6771a93e-ae37-43a1-9119-def7df182b64,Debraann,99,31,72,0,50,30,282,
06409775-da1f-4da1-bddf-97dc2fcb355c,Debralee,20,81,14,93,77,14,299,
5e1cbfc8-96e8-45b3-b637-5d959039a283,Declan,75,82,60,20,90,44,371,
d894a16b-c801-4149-b25e-1e1dabf3d177,Decorian,36,31,86,45,41,9,248,
4f5302bc-0404-4495-a4a8-0c48c7edb17e,Dede,96,20,47,58,60,69,350,
7e1ad526-ea9c-4d44-a6b2-d85265e03068,Dedra,77,95,49,6,63,40,330,
12a2545d-0462-457f-adb3-8b3fbc47d405,Dedric,93,82,97,27,69,27,395,
d8ff6e4a-b832-4eee-afc5-3a89fda28442,Deeana,35,18,71,47,24,76,271,
2c45cd0f-703f-46db-b81b-bb73055cfa36,Deeana,15,69,3,98,31,67,283,
66162205-affd-458c-923c-e2c3aae10a71,Deeanne,93,84,7,52,42,70,348,
8d16ddc5-cb66-4071-9ccd-0aa7a4f8fe53,Deeanne,58,13,57,87,19,62,296,
8d18ea9a-bc53-4329-bc8e-2754b80cec9c,Deedra,10,61,8,86,38,33,236,
0eddec5d-249b-4c7f-82c2-0df424ab43bf,Deegan,0,16,10,50,12,86,174,
0ec21c12-8b53-4b34-811b-81093cdad750,Deema,27,69,29,56,51,19,251,
6c62b2bb-4102-43ed-aa19-593cc24b8108,Deetya,53,22,100,83,14,4,276,
410b3c8a-7e46-4bc7-8b9e-01d30947514a,Deija,3,35,9,97,35,27,206,
c9b2c165-9775-4a50-9bc0-ff35bf325266,Deija,64,47,70,95,27,23,326,
3815cd7e-2d74-4110-b516-4c61c7c2a69b,Deion,6,19,48,97,74,69,313,
a162bcdc-537a-4825-8cac-34edf95aaa39,Deionte,66,4,28,76,51,88,313,
c4abfab8-e580-40f6-82e5-51c683493e98,Deissy,25,38,72,83,62,18,298,
f2c11791-c225-4cf7-a18b-6518873ed2ed,Deisy,83,38,61,27,48,66,323,
9f29c13c-7b5f-43b9-a97c-a22f62d735ea,Dejanae,68,23,46,88,18,62,305,
5317c013-c01f-4830-b840-0e9192186bcf,Dejanee,48,34,67,8,22,85,264,
56d2a48d-97aa-4ca3-8a67-ae99c08a931a,Dejia,24,46,75,100,56,45,346,
4586a043-4c25-458b-8999-c71094b79f7e,Dejohn,90,88,98,62,11,0,349,
39e89379-06c1-4685-88b4-a100554bfe45,Dejour,2,79,0,94,97,80,352,
bea116ef-7a64-4167-a1ac-8eafdcd62849,Deke,14,99,22,98,58,98,389,
4350bfc7-0628-4e0a-9f3f-11e6a1a8503a,Dekota,15,67,75,90,35,25,307,
2cda11d0-f719-429b-ac22-ff842674227e,Delaine,40,61,72,54,33,33,293,
85c26826-24e3-4505-96a8-1e7e9bc01f71,Delana,14,98,89,53,47,20,321,
28e23aee-d98d-401b-b573-a468e1f5a7a6,Delaney,98,2,32,11,62,71,276,
0da2e79e-95c8-4bb6-86f9-18450be253cd,Delanie,82,16,2,50,27,61,238,
747a2b3a-a987-43ce-b72e-90b3fe407b2b,Delano,20,93,61,28,74,69,345,
f5ff6caf-3b9f-43d0-9f97-72def0f977ad,Delfa,12,90,41,90,16,54,303,
0e3249da-49c4-4332-9a24-80bc0cac3fbb,Delfin,17,96,99,6,14,43,275,
a71f64ee-f1b6-4fc6-b102-49448bfce751,Delia,67,43,28,43,46,32,259,
286a94bb-bb0e-43ed-bd19-f9423910c28d,Deliah,38,99,85,5,14,62,303,
a5435919-f3b7-4af0-a90c-47f12f00f9c2,Delila,37,25,81,83,29,78,333,
8fc1aadf-24f5-4660-82a6-33d778e5fb31,Delinah,71,87,5,80,83,71,397,
90a38434-6adb-4b28-b4a2-521f8252b586,Delise,28,51,40,73,13,78,283,
260a5d72-7329-46b5-b326-07ba818ee7cc,Delisha,15,11,71,91,45,0,233,
385b774b-44d0-4385-9b92-e7609dea3975,Dell,55,78,56,96,13,89,387,
338925ff-5d8b-4683-9880-060e41702d56,Dell,44,83,28,75,28,98,356,
e67f6b31-4fb0-4733-800a-c19a511ad952,Dellanira,75,1,57,95,7,48,283,
c1507023-0acc-43ef-8d9e-c33bbd96702d,Dellie,21,90,64,24,75,23,297,
4faaf04a-cfc4-48d1-b51c-c16758e74219,Delmar,54,19,1,37,24,65,200,
4a067900-65ad-4837-af21-8054608fdfb5,Delmont,98,19,52,23,56,64,312,
79009d5f-4e0a-40ac-9f67-553b1f392a00,Deloise,16,49,47,42,44,62,260,
2a98f159-052c-46dc-b564-a3fcdf64cfaf,Delon,8,98,45,100,49,27,327,
880658b6-110c-44f5-b1ea-72cbf5d2a21a,Delon,47,80,84,45,4,94,354,
0179477a-9354-410a-8f81-42a014593e1e,Delonta,39,2,25,71,52,9,198,
4d492ea5-1f39-42ff-9e83-67991b7bc857,Delontae,32,31,37,86,30,93,309,
00abe9b6-8697-48fd-9c8c-4db08448a027,Delonte,30,18,79,29,59,30,245,
227c962f-a59b-4e4e-a75e-721d82ed92c2,Deloria,62,25,82,87,19,26,301,
3785fc7c-f224-4efd-8ab1-0040008a02e0,Delrose,45,24,59,15,49,30,222,
3708de34-a0e4-4fe2-bbe1-ad0491a25661,Delsa,82,14,3,69,39,93,300,
e13f4001-ea5d-4297-9ce0-31a01c6e2d79,Delta,93,77,71,64,80,9,394,
4c4a40b6-6af6-4f21-9eed-000e8b4fccce,Delvin,22,98,74,90,34,11,329,
d79107e2-b35e-4183-8535-a9afa3ce8e36,Delvon,1,7,25,91,42,55,221,
2cd974b5-14f3-4266-b3af-306d5951d660,Delvonte,86,35,53,7,50,30,261,
09c42ec7-13b1-461f-8a9b-52664a925069,Delwyn,36,69,26,18,23,51,223,
576a803b-25cb-4a9e-adae-76159eabc327,Demani,93,10,94,16,22,6,241,
fb59d529-a63a-4a17-8a35-039966024875,Demarcus,61,41,73,92,43,89,399,
1d4c482b-b496-48a9-8b3c-87303aae3294,Demari,61,80,46,46,80,97,410,
144f12da-88de-4bd5-b3ae-8bfd8953935f,Demaria,54,100,81,31,96,5,367,
5512656c-9797-4765-83a0-336b21cd5bb7,Demarion,97,63,33,49,34,18,294,
5045c73f-33cf-42e6-b46c-39148828c15a,Demarko,14,77,95,90,52,100,428,
d6e67f6a-8467-408d-9cf1-faa1f6de72dd,Demarques,44,45,15,82,27,32,245,
632af762-4a00-40c9-8677-2d52e3edc50c,Demarquez,96,3,81,28,7,82,297,
dae8038b-be4d-4db4-81c2-a85c7647e7c2,Demarrio,87,6,80,46,92,17,328,
81283d73-07a5-403f-b245-c8038b820af0,Demarrio,16,66,17,40,10,77,226,
51b48360-09ba-4b36-a470-dcf44b0a4035,Demetric,22,54,55,17,30,49,227,
6b557b0b-0a52-418b-bab8-bfdb3730e4f3,Demetrica,72,35,13,28,96,80,324,
d8cc8fff-ebc2-4827-8776-76956da2005a,Demetrick,66,73,47,7,64,68,325,
5100adac-2d0a-4cd8-8e97-863f2e11ef32,Demetrios,77,79,1,31,78,42,308,
6f7d62d5-63d4-4df9-89f0-0b2faec72924,Demetriu,24,2,46,77,52,44,245,
e76385a1-c2ed-4df1-aad2-dc67f3ea54d4,Demetrius,89,75,87,13,48,37,349,
24f35f61-3ec9-4161-a92b-a770f121fa4b,Demetruis,85,30,43,60,20,6,244,
1095ab9f-94c8-4888-ab1c-f5a9e4323a98,Demitra,40,66,72,30,53,61,322,
77f64ffe-c38c-4256-bf94-ebb27f88824a,Demitri,32,66,83,15,88,23,307,
8b878ae8-4d33-43eb-803e-fdf942ecb987,Demond,12,76,91,95,97,10,381,
537437f6-596a-4ebc-a43b-e9bcd82ee5d3,Demondre,66,69,36,64,92,10,337,
475042a0-300e-4e47-b097-f3228e6df092,Demone,33,4,89,15,15,4,160,
a0daa77a-30b1-4646-b544-a162a958f350,Demoni,35,40,48,36,54,5,218,
19b62db6-9c1e-4aaf-a345-338538b22c3e,Demont,74,74,10,70,25,91,344,
7a7d9372-e210-4c29-8113-fb8e8e1d157b,Demonta,39,79,76,18,37,55,304,
cab586a6-71f2-4435-b484-1a036dcda3ae,Demontray,1,52,62,84,87,71,357,
71a49a78-bae0-4d22-a552-5e24ca021be1,Demontray,8,65,28,91,50,40,282,
22b899fc-7a16-467f-87ef-4d50557575fd,Dena,71,72,2,27,100,65,337,
e435503d-5c2f-460e-bcc7-85c64203d02e,Dena,93,96,11,84,0,35,319,
53505626-78a0-4096-8ccd-3562aafa066a,Denard,33,60,10,74,27,59,263,
8fe11add-f68e-4bb0-a12e-18ca806a0793,Denean,20,31,7,29,71,33,191,
fc1dc4e1-bb86-4729-b86f-63abfd8eda26,Deneane,70,27,96,69,85,53,400,
d711df8e-441b-4ae8-add0-60b6445ec848,Denecia,12,86,15,50,39,80,282,
fe8a908d-a1c5-4b9d-a369-6f395c9e2e15,Deneen,30,26,10,100,1,89,256,
d8348adb-9a4b-475a-bca7-2f37783c52ca,Deneene,5,51,75,56,4,3,194,
68f34c6d-b6b7-4322-93b8-1d0707328042,Denell,58,14,18,33,47,16,186,
b7d32828-0a49-4b9e-aa40-972e6f96aaf4,Denene,0,8,48,68,69,78,271,
678fcb09-df24-4427-8d94-8e91746b98fb,Denene,78,79,24,37,69,73,360,
1f2d5bb1-77a1-49c3-906a-5220c3d8b09a,Denetria,70,88,14,42,14,90,318,
0b43225c-f993-4d22-a51e-f73908614e47,Denia,44,16,70,42,56,38,266,
1dedb676-fddd-4e1d-bf24-65f9a0d94b3d,Denia,81,15,18,8,94,6,222,
ad0948e5-1a8b-4bdd-a530-758a542ad79d,Deniece,36,76,51,28,59,82,332,
9f29c7f3-28d8-4603-b3ce-750793283087,Denim,4,33,13,18,31,51,150,
2d2dc465-ae40-41da-ae01-314f9495d0d4,Denisse,36,4,60,62,49,67,278,
a10a4f6c-4b5d-48f1-bb81-7b78b8fafc73,Deniya,58,34,75,74,68,68,377,
cf41f7eb-765e-4e29-a792-65e1298fa9e1,Dennice,63,7,70,3,20,79,242,
cf24e255-56a2-4214-8cb0-a1e0e57c8c50,Dennie,16,92,31,61,67,95,362,
6971b001-2cc9-47ed-bfa5-7fc04f3ffd28,Denorris,36,81,97,2,62,20,298,
ea90a308-899b-4835-b957-0d9383f8ae44,Denorris,54,8,94,26,98,6,286,
4bdb2077-8c87-422a-bc3c-94b986dbf69f,Denton,25,17,47,82,34,89,294,
ce2f7223-ec0d-4152-8afe-a3d696cf980b,Denyce,74,17,35,9,89,97,321,
7e75f025-b13e-46fd-b275-ec2c75e7420a,Denyse,94,32,70,71,1,49,317,
0a14ea6c-1d24-4a42-844b-22686d2dbabb,Deo,61,13,88,88,62,50,362,
49c6d42b-a113-4885-b1ff-ac233d940355,Deola,11,70,87,36,40,53,297,
793d471a-e438-4d23-9ebb-f4cf06ea8af4,Deondra,38,21,13,46,55,38,211,
0aca6e5e-e0b6-44b3-8dd1-8e2a7012f41e,Deonne,72,38,33,89,41,90,363,
70050f3c-f892-45df-a775-fb0d09f74470,Deontavious,7,95,3,58,25,95,283,
f28d4b34-aa5b-4312-a250-e032e3ecadf5,Dequan,19,55,25,6,96,16,217,
d7a8fad8-49ea-4934-9aa4-537a752d9e7e,Dera,57,0,53,42,72,71,295,
e82624e3-794e-4fa7-bc24-434dac99b98b,Dereon,57,96,48,50,76,67,394,
0fd61bb2-a001-4741-84d0-d47d314b2fdb,Dereon,1,97,90,80,6,6,280,
6ec7f952-1db2-420d-9e67-b8492c510916,Derica,54,32,75,37,75,16,289,
621e8588-152a-4a45-a9ad-ebfd7d2ec407,Derica,32,49,53,12,58,64,268,
1e86ec47-1a96-484c-b328-b6b936537770,Derick,84,85,48,95,79,40,431,
e48b749e-cd9c-4365-8d72-203840943af3,Derico,25,10,87,49,45,77,293,
5a366cbb-96c9-4c0c-a632-aa9b7afeaf71,Derika,88,37,35,74,100,91,425,
59629e35-1ef2-4f05-b22d-cbb56ce9a96c,Derinda,31,54,87,6,16,42,236,
cd2d6837-e5fd-4541-a9ff-4f5de8d4414e,Derk,61,13,32,94,0,40,240,
f53e8109-ddf2-463b-964e-d62de3fa58dd,Derly,29,34,25,72,27,24,211,
44e554f2-b746-4311-8c71-a7e297928016,Deronda,41,11,96,3,21,38,210,
7433b23a-b4d1-4f63-9180-b7f18d03e9f7,Derrel,0,3,85,32,55,86,261,
b0a67a6f-1536-4a8c-8975-f31b4d71d8b5,Derrell,97,58,21,34,25,12,247,
bf0c4ced-1a0f-43a2-a0f8-c6dd513ae545,Derrianna,79,61,12,81,35,4,272,
bd58bb47-adc3-43ae-af34-857c86a133e0,Derrianna,59,84,10,37,40,0,230,
75c453e5-9ed3-48ea-9d86-3891fa38813e,Derrica,26,64,81,64,19,22,276,
23417735-d689-4be6-92c2-51ce9a422467,Derrike,6,22,30,37,26,94,215,
b007c4d3-24ee-4108-9f67-a6c82b6d19df,Derrion,43,19,1,16,9,18,106,
42275113-a387-4d39-96d8-8f01552e0f29,Derrisha,97,57,16,7,22,1,200,
18d10082-ef2b-4ec4-8943-1531295ab2d7,Derward,82,94,31,67,80,55,409,
fc0cfa22-0caf-4113-a7ed-db65b86c1556,Derwin,56,10,58,20,100,74,318,
5c0e59f6-9a3c-43ac-ab4a-6dcfdd1dc615,Deryk,73,4,80,31,4,44,236,
d7b8d8a9-4d91-458f-a150-99071a53ccf6,Desere,3,2,41,47,81,74,248,
56827693-705e-4e74-aba4-141c73173b15,Deserie,1,99,15,36,17,45,213,
bb39b166-a79c-4983-ba2f-fca15adbc9b7,Deserie,22,45,9,60,73,8,217,
a96e6e1f-653b-4e4e-933b-380508a37d93,Deshanti,42,89,1,18,88,77,315,
de102a8b-7b43-4448-8d60-10dafd04096e,Deshanti,11,89,17,27,88,51,283,
abdcb3e5-4ec2-4950-9ae5-374ce31f552b,Deshonda,7,67,54,36,39,59,262,
0f223041-a860-4da3-8087-e1a6244e5b5b,Desi,27,53,88,1,75,85,329,
a8678719-6a69-466b-8963-c436fe77b606,Desirae,54,64,93,72,40,26,349,
f78092a8-5427-4f49-9946-4da9cbc1afd1,Desiray,63,14,40,29,19,86,251,
adf4b192-1aae-4790-80ca-f6b0caf7a0a3,Desirea,15,93,48,66,20,51,293,
8b31e3e2-7a7c-4498-a78f-c7afe3e4d8f8,Desmond,96,19,73,31,40,33,292,
7dd2388f-f8b2-4c0f-8187-80675bf527a4,Desmund,13,71,80,27,77,49,317,
6cbac4e7-5459-4aa4-bb37-86f8a62171bb,Dessa,98,47,24,44,54,68,335,
232eb3c6-3f6d-4af9-ad6e-a1062f483199,Destenie,16,49,87,49,36,58,295,
8aaaea17-2554-468b-afe8-023983944de0,Destine,3,10,81,64,19,25,202,
c5a83e0a-b70d-4ce8-afcb-a57f025d4326,Destine,77,22,0,38,33,4,174,
028783c8-9c75-40de-b912-9d9b63c8436e,Destinie,39,23,77,52,78,6,275,
1c9f1b12-c7af-4435-a9b2-a6b1c5650439,Destry,22,21,78,86,71,21,299,
41fbd58a-b92c-4edf-a05b-2642afeb7df6,Detria,74,29,86,76,73,24,362,
f78cf91e-d4dc-4087-8af6-365d94c1d380,Detroit,0,78,99,62,74,17,330,
f0396703-6b0f-436b-9b22-0d0554b6afbf,Detroit,18,100,67,26,69,76,356,
79775aa4-3e92-4e3e-b888-8e1a5a8bce8b,Detroit,88,48,55,62,57,27,337,
099ce73c-47ab-4405-b943-e91439372ac7,Deundre,89,10,13,4,70,25,211,
b9479fff-da2d-432b-bb17-40f71e8e250f,Devanta,35,25,88,57,40,33,278,
627ca106-bd34-46ec-9a0d-d452f9878067,Devany,72,54,52,72,52,69,371,
d8653188-b4fe-453d-a679-f55223433918,Devany,66,23,11,78,66,8,252,
fbfecfb7-2442-4681-8ca9-1e778f0c7354,Devany,69,42,9,100,9,52,281,
d76e14f8-db1e-4cff-b657-c1e9c6c75731,Devell,76,23,66,16,91,49,321,
7e4fdc53-a912-4741-9729-9db32d870d28,Devendra,68,87,15,35,99,9,313,
c8069e08-3451-4faa-9b75-509442904f04,Deveon,16,18,28,19,26,1,108,
9fcbc320-fdbc-4879-9128-e2c860c1dd71,Devera,18,64,68,97,12,28,287,
15507f4c-232f-4663-9a1b-13b6fbf9e1f3,Devin,77,22,25,48,88,59,319,
630461a3-165e-4297-ae8f-2700a20cf818,Devine,25,44,68,12,47,69,265,
5484e9ec-1907-453d-9d64-09f11f901734,Deviny,84,78,78,43,80,7,370,
2ddc0fa6-f43a-4252-a738-5da14d82f5b4,Devoiry,31,83,89,70,60,40,373,
8545af91-cc84-47fa-b204-a0a4b662baf0,Devoiry,41,62,71,100,8,43,325,
51e1ca02-c668-4e46-b59f-f11007e49a47,Devona,44,7,80,5,79,52,267,
ad7eb174-9ff5-4628-8aa2-d22a8898f6f4,Devonda,11,8,91,87,9,21,227,
708cea75-fcf5-49d6-99d1-c1c18068d491,Devonte,41,83,58,67,70,42,361,
09e8cab8-3ecb-4fa8-8811-2bc33703c5db,Devora,93,54,89,4,57,35,332,
78b24648-c162-4049-ac6f-1125f9406c65,Devron,85,71,62,70,81,28,397,
6653fa09-ccab-4cb1-8f56-7cd10308e4b6,Devyne,87,60,61,35,75,8,326,
7b232e97-04bb-4b63-8ae0-593e87f8251a,Dewey,18,31,80,31,17,56,233,
665ee4f8-7edb-4ec8-8839-7a4dfd276006,Dewie,9,75,54,66,86,61,351,
8f2435bf-d5c0-4cf0-b768-1071a3504c67,Dewin,32,0,45,74,6,93,250,
f357c472-e5eb-471e-b94c-b0434cc2a8ed,Deyanara,33,84,72,38,73,48,348,
58d1da71-37cd-47ff-b426-1b1bc4fc11fc,Deyanira,93,14,14,34,5,82,242,
bac94d22-e7b5-4173-92b3-1c6572d13ea1,Dezarae,77,42,45,88,4,35,291,
eb01f34b-f733-4eac-9b7c-d212b226828b,Deziah,97,97,99,25,30,83,431,
f0e22ece-e729-4c2a-805f-f4536d1642d4,Dezire,50,18,48,64,64,47,291,
4b923e0a-c351-436d-b149-d4a2f9b8148c,Dezire,64,84,52,61,14,58,333,
f1dfdcc9-b6fc-4c2f-8077-21be306ab5bc,Dezmon,44,92,63,30,77,62,368,
1a15749f-d645-4317-ba32-90f636ee655b,Dhamar,98,100,99,91,90,18,496,
900e315c-986f-446f-9950-4d18dccd75bc,Dhamar,82,26,78,98,6,83,373,
ae46580f-6d86-4a2e-a3b8-8a1bee43ab09,Dhilan,0,24,29,96,44,80,273,
be4fa4f7-5f03-4257-901d-ff6b9cfb2e6f,Dia,65,98,67,57,6,31,324,
e4ee8452-f11d-409d-b596-eea0ae6a9907,Diamantina,23,16,30,90,42,82,283,
060a72c2-d707-49d3-995a-7e1a234e8b53,Diamantina,65,14,99,71,20,90,359,
b4bea667-debe-4cc0-a8cb-62c126d8d56e,Diamond,42,86,3,2,14,16,163,
7c2c8bec-57b1-46f3-8928-dd1bfaa2aab1,Dian,55,37,97,99,53,39,380,
27218c2d-f36c-44a3-9fd3-fcefb2b84095,Dian,12,100,40,2,46,62,262,
7ddaad35-d540-4931-b0ac-15c6c4600228,Diandra,47,29,87,68,31,89,351,
3e694794-9e1f-4a5c-92e6-e01c41b2e5b3,Diandra,69,19,12,45,24,40,209,
878e4642-e466-4aca-bb44-2679048510a4,Diandre,43,91,92,49,71,19,365,
a0dcf3bd-63da-4612-b3a2-7f9cf73184fa,Dianely,29,56,28,57,9,53,232,
1ba30e22-ba69-4daf-a41a-2e35661579d4,Dianey,73,94,67,2,14,70,320,
7b481d47-d4c7-428f-b2d4-bfcf94420078,Diania,97,48,34,38,77,74,368,
104d4a3b-bfe9-4213-869a-94d74237b643,Diann,56,88,39,51,34,13,281,
53d6747c-554b-46c4-a250-f3cd287e6dcd,Dianne,68,2,16,75,33,80,274,
22c2b71a-ef91-4a60-b75e-986fa1b84bdd,Dianne,59,14,94,37,35,62,301,
37de767d-ba31-4104-aa7b-7a54ca996208,Diarra,86,2,8,56,91,94,337,
f7db6402-2b4d-4446-be0b-eaf1dac86a02,Diarra,31,27,28,97,89,0,272,
a99c9dd5-a702-4d30-8485-102d74db0272,Diavian,23,54,69,10,26,39,221,
e03a1e67-162d-49ad-8302-16ab9ac9e7ef,Dickey,20,65,2,40,46,63,236,
50ebc8fb-94c8-414b-8ea5-b33cb6697357,Dickie,26,34,27,12,15,23,137,
1e126558-0ae4-47cf-9e17-167dc18fe1c3,Diego,72,99,32,69,23,25,320,
5d62c5d1-5dce-4730-9b16-4586bb5319f2,Dierdre,73,27,20,65,10,21,216,
aa00a0c5-e210-4cf0-baf3-2457c03ca65f,Dierre,77,25,9,39,53,50,253,
391b2260-20e2-40f1-b7b4-2bacba1a947d,Dierre,87,33,40,62,58,36,316,
a882b33f-f574-48fe-a862-3f6fccdd5010,Dierre,91,72,57,11,97,23,351,
031412f1-bb02-41fc-bec0-e0c163082503,Dierre,100,62,75,76,64,72,449,
798c7a04-f0d5-4ac1-811c-1e321a3f0c4c,Dietra,53,17,16,65,32,40,223,
a8c178e2-a309-4e16-a562-b921a5749722,Dietrich,12,89,16,64,35,42,258,
311c9437-5f2c-49cc-951f-d6dcabe1d963,Digna,32,43,47,84,33,64,303,
592836c3-5c6e-4ef1-9b4d-0af77276ccf9,Dilan,35,36,59,35,56,9,230,
91c4c93b-83a9-4c0f-a56a-78f2aec86792,Dilia,94,72,44,63,51,41,365,
31350871-7970-40ba-9656-4066eff2a902,Dillin,96,53,13,41,0,18,221,
48f5e155-3008-49a0-b192-1e64563d4298,Dilon,96,68,42,24,90,68,388,
06f5ea81-e91c-41d9-81c3-f30f20d8455c,Dilon,15,60,43,1,98,33,250,
9510df0b-f691-42a7-b06e-b48921646e0d,Dimas,11,94,50,51,63,16,285,
25dea1cd-52d0-4aac-aa1e-48b9298dbd42,Dimitri,19,90,72,4,21,31,237,
ada85fff-545a-4f59-a3c7-90b488465315,Dimitria,97,97,70,10,28,62,364,
50418fe8-ad1a-422a-a499-dd785771e2ed,Dimitria,52,41,47,38,59,99,336,
92095e12-1028-4462-b93b-762e372c2f82,Dinamarie,68,89,43,59,18,22,299,
738aaa75-8b02-4e85-bb93-de82d621a1e9,Dinamarie,47,86,25,66,51,64,339,
822796c4-4586-42ba-92bd-e3c8ca1d298b,Dione,53,54,34,71,78,30,320,
8443d514-bec2-4919-be25-b6007c0c04b4,Dionicio,95,55,32,13,27,66,288,
b6ee1b51-c897-4d1f-957b-f02f81fcee5d,Dionicio,54,59,34,77,91,62,377,
6f40a84d-d0de-46a1-b5de-1f42325401f9,Dionne,56,48,18,15,11,63,211,
8a358983-b3cd-4179-bdaa-184df8b891ca,Disa,22,47,81,31,11,70,262,
da808f94-1e93-4695-b8ac-767e39195ec7,Dishawn,79,4,34,91,37,33,278,
43b23040-dd86-48a5-aa2f-081049526609,Dishon,46,46,93,76,38,23,322,
8cd7c065-0606-40f9-bacd-5e128a7fee35,Dishon,42,15,36,67,50,10,220,
acf2d6df-ebbf-4895-9e3b-c5db3dc49e30,Divine,75,38,68,39,56,70,346,
cf15cf4f-f89b-4fb2-a925-ade07407a01e,Divine,60,33,26,15,74,4,212,
f14bb951-da31-4bcc-b6e2-0f6c8d052a34,Dixon,81,31,1,27,67,33,240,
f804d675-ac67-4432-adc7-79c997aa2fd6,Dixon,99,63,77,24,2,93,358,
7b2c75b1-4d68-4c52-a1fe-fc89a7ce0849,Django,34,60,46,98,88,3,329,
30606385-be7e-40ca-87a6-f2636d611b51,Djavan,21,67,70,82,60,38,338,
52d999ed-ce15-4f6c-9888-d7937bbd3631,Djavan,57,32,57,37,75,68,326,
4057b143-f064-488a-af74-c451f039fb22,Djavan,6,51,64,7,87,80,295,
e5339061-8eea-41cf-bb70-a8a93bc0e226,Djavan,55,25,44,20,100,91,335,
badb1b87-4d25-4910-9560-3a4ea7284c94,Djavan,41,39,61,19,15,13,188,
9c741973-ed0f-4922-8921-de01eccfe23f,Djuan,72,92,46,91,51,30,382,
dd488c14-4913-4e8e-8097-29d18c5300dd,Djuan,93,96,41,38,18,70,356,
b9ac81f8-bbf4-4a79-91ff-680142e21b92,Djuan,69,95,81,32,79,2,358,
e6daf94c-b2f2-4c97-b0e7-12a35c28b47c,Dmarcus,18,55,15,74,33,1,196,
c895b249-05d3-4f4b-82b4-bd6846f24843,Dmario,4,13,40,14,88,24,183,
cc44220c-fbfd-45e2-bf11-064fff3242f1,Dmarion,92,11,84,78,14,94,373,
b8f3135a-43f8-4806-8501-98212525658c,Dmitri,4,66,68,79,52,3,272,
7e76196f-003d-4ff1-8145-4431d4a5dc5b,Dmitriy,97,53,52,29,0,41,272,
0b8a0579-a06e-4619-829b-f8a632d99fd7,Dmitriy,49,64,75,35,9,29,261,
ce5835b4-6220-44e1-b513-5df5b16959c6,Dmitriy,22,53,94,97,58,83,407,
322aaaba-d1ac-46d8-b568-f4c7a4a00f2e,Doc,44,43,58,15,58,71,289,
43e96789-469d-463e-89f1-90971f9f4d19,Docia,88,91,45,19,56,13,312,
60649e5f-073e-41b8-a159-da63fc6990c3,Doctor,36,4,97,28,4,14,183,
e9d65c0f-909e-4b16-b953-b8b2a6b6a052,Dodd,37,55,10,48,20,81,251,
7a298a00-4fd1-423f-8f08-f76e97c0de6c,Dodi,11,39,74,6,56,57,243,
83bd5d82-416d-4f52-99fa-d5595b667f82,Dody,78,9,0,69,28,78,262,
376fb3d6-c246-464e-b0dd-13f3689a20ba,Doil,87,53,87,13,27,90,357,
476685e7-0ed4-40f6-bcee-7d8bd9e7d709,Dolorez,14,25,68,30,72,11,220,
3a2e0983-09b6-4b9e-b51e-f6873dc98945,Dolorez,34,0,96,33,47,36,246,
6b4a5353-3062-42e9-9d83-bceb68411dfe,Dolph,93,36,44,71,80,53,377,
d4d242d4-2ed1-4eed-a95f-a0fda733dff9,Dolphus,87,79,41,35,75,26,343,
111ed9ca-9b3b-4464-ac6b-7063973077d9,Dom,53,90,36,14,26,100,319,
32c554e5-6938-40ca-b555-933292f5973b,Domanic,71,84,24,18,83,75,355,
13feea50-c06f-4eb5-8996-08f4b55a8161,Domenick,65,24,34,54,27,78,282,
266fc195-13f4-4550-abe8-17cb159b3fd9,Domenico,28,23,65,95,4,96,311,
23d23237-3c8a-45f0-b653-10748afa8a0f,Domer,52,55,60,56,8,12,243,
aa8f6904-dd6e-4008-a1d0-2d6f4c6cd0d7,Dominador,96,63,78,57,89,33,416,
39e14195-6b5b-41b0-890a-93a581cccf4a,Domingos,20,3,53,18,31,53,178,
85d4021a-7cee-462c-92fb-5e6ab670d8b3,Dominik,32,82,31,83,96,24,348,
983d3d1b-5e70-496c-a128-16c87f3bdd4e,Dominiqua,80,96,65,29,3,45,318,
1f95dd08-06b0-4d40-b996-e2170e64fb9a,Dominyk,43,64,23,44,17,66,257,
a207ea36-c199-479a-b546-ba6ef7bc0075,Domonick,56,69,90,77,33,98,423,
a746e306-7349-4f74-a325-34edd685e313,Donalee,47,52,33,77,76,19,304,
9be0cfca-2bd4-4236-bfc8-2d889fe6baed,Donalee,68,32,67,6,30,52,255,
cfa55c48-aa07-46a1-8506-46ca21ce89d2,Donasia,34,56,45,76,8,49,268,
58444cc9-54e9-4e3a-90d3-4428a0dd7516,Donatella,24,47,97,37,98,72,375,
acbceded-325d-4536-9cf6-5ed6bb9208dd,Dondre,38,3,23,98,95,28,285,
d251a278-64f9-4f9a-9233-9f8be195dbfd,Dong,59,73,95,25,13,62,327,
16faaaf5-deea-47ce-a1f8-03bdc7b3ba9d,Doni,48,20,80,43,71,19,281,
9f021c2e-4465-46ad-8cf3-0ca953c6856c,Donia,23,42,16,91,98,62,332,
b283f639-5499-4518-8afa-04fc782ec197,Donica,80,40,59,96,55,52,382,
c0624d02-9698-4a1a-81a4-f45bfe0d837d,Donisha,9,84,26,88,35,57,299,
99ef3040-4cd5-448f-b146-0fb40840787b,Donnajean,9,91,5,89,100,37,331,
601466be-029b-4b5c-8b24-36d8b1695003,Donnald,63,43,61,96,11,3,277,
a4483e80-c1f0-43e0-bdaa-a290ec36a67d,Donnalee,0,14,89,39,14,31,187,
d043b97f-9b3b-4408-a8f1-d485e10acde2,Donnisha,85,58,84,44,16,52,339,
1e1c7e3b-038f-41b7-9d7c-251fc08d9239,Donoven,64,34,91,95,43,81,408,
699d1baf-a5b6-4ae4-89e7-9c137a788cac,Donovon,59,53,88,34,66,50,350,
0b1d3f83-fb95-4511-8f32-51cc0fd135f3,Dontarius,75,37,90,28,5,12,247,
c6181772-0979-44fb-9eb1-f100828d8da2,Donterrius,83,42,89,75,14,38,341,
75ca219b-7293-4c03-8ba2-5382135b2e1a,Donyae,99,59,28,80,38,89,393,
a4b61c5d-6f67-449f-b07e-161fbaf85853,Donyale,23,98,48,96,93,51,409,
db0fc88b-4a4d-4ca8-9794-f56a1a0e63bd,Dora,61,92,9,84,67,39,352,
d9132667-9cf0-402f-8db3-7b702d83653f,Dorace,50,46,8,30,74,51,259,
5aad5993-57ee-4278-974f-b9ef6aeeda1e,Dorance,19,98,16,32,62,38,265,
4a01088c-93d1-4f3f-9341-c9e3067762d7,Dorathea,49,6,93,45,35,78,306,
7e47d012-6ba2-4428-b513-12534443d77c,Dorathea,73,55,52,48,97,50,375,
8c976bbd-7998-4034-a54f-a1a58a444b24,Dorcas,45,79,48,48,65,20,305,
f08ca71e-1fce-4752-a372-a43aac43c2e9,Dorcas,11,96,50,67,23,51,298,
629f3647-384f-41c5-b779-c388cd124abb,Doree,70,8,40,84,94,5,301,
20f229d8-a164-465a-9d85-f336d4559a98,Doreen,83,12,20,49,30,64,258,
213b29d8-0583-4b9d-bdee-743bd1aa9fd6,Dorenda,84,38,33,0,82,17,254,
65f4c9b5-1b80-41bc-bc59-5f718626fa11,Dorenda,0,27,40,76,0,5,148,
316ef922-6894-4928-891b-7e996c3ba6d9,Doretta,34,3,10,49,80,37,213,
ce3b90c4-cd61-4fc3-881f-24fdc1909f1a,Dorianne,92,19,65,26,62,76,340,
9c8adff8-a413-40cc-a62f-184c1834c452,Dorice,53,70,12,89,80,29,333,
52141218-5405-405b-ba0f-f378d98737d6,Dorine,46,63,36,61,27,38,271,
7eff47b7-03d5-49fc-889a-f01eaded0ff4,Dorine,60,63,99,40,44,6,312,
686dc11d-5bac-49ca-8934-10ba165ed44a,Dorise,29,15,45,45,10,98,242,
5be9e545-982b-4215-b73f-fb409bb9b600,Dorman,38,55,5,61,66,59,284,
2fb9387b-56ed-4ed0-ab64-205db487e965,Doron,50,68,68,42,82,53,363,
3f73ba92-9306-41c4-8d7c-70d288cc8c8b,Dorrance,78,39,60,81,35,84,377,
32785197-d402-4932-9835-51dbfea2082d,Dorrie,65,24,97,49,10,38,283,
01282fa4-f1cf-4237-af9f-4e99e5008e16,Dorsel,2,100,35,25,78,99,339,
df7ae14c-2f3a-4c02-8736-8a5fbcf4e2db,Dorthy,82,63,59,86,98,53,441,
0e7421af-6f2f-45ae-b2bb-8139b2ac5011,Doshia,67,77,82,5,64,47,342,
61808fcb-a427-4c94-9266-2fa6258bfc42,Douglass,56,78,67,8,39,70,318,
283c9f05-11ac-4047-89af-05613bb67f27,Dov,65,59,3,81,62,71,341,
93f52361-2e69-42b3-b432-75d623d417e2,Dovid,82,48,3,62,36,16,247,
e8ded5d6-c49d-4fac-8a38-c2e613704c29,Doyce,13,19,18,37,37,93,217,
d3dca339-0c3a-4183-963a-bb0b2fbb0b6e,Dquan,18,18,66,30,37,62,231,
4d8d0acf-dbfb-4c69-9408-0bcc33d49a89,Dragan,42,91,39,94,80,50,396,
b13c2449-1c90-42d8-86d1-e84d76a64e17,Dragon,53,47,62,94,35,74,365,
56391558-2546-4e0f-a9b2-43902fc98f05,Drake,60,8,67,2,85,100,322,
0309ad32-9b30-416f-a1e4-6f979bbf3518,Drayton,12,71,88,13,29,81,294,
1443d7f2-262f-45c2-a12c-23a7e07acea7,Dre,83,33,41,67,58,37,319,
fac0efc7-13f4-48e8-8663-fe76d4414d76,Dreama,83,15,86,96,81,57,418,
9a679c17-89aa-46a5-96a1-4c5c233de815,Dreanna,14,44,53,28,63,81,283,
b0503ded-6dfa-4e42-8d0c-9dd223349865,Drelon,11,50,26,100,54,13,254,
8455c33f-8751-467d-83ae-31dd40ea3fba,Dresden,13,58,88,86,15,93,353,
873e7877-a00d-4010-9358-4aaea1df7e01,Dresden,29,82,35,18,17,63,244,
0b43a2aa-b3b2-49c4-88cc-e42d0f8ca691,Drexel,33,89,38,100,47,31,338,
e49b3b2a-3393-49f4-86d0-22bf96e56076,Dru,76,60,66,77,60,74,413,
254fd441-5309-45ae-8a18-e029d7a61e64,Druscilla,68,67,99,50,94,9,387,
f03293b2-7eeb-485c-a879-52874cdf781e,Duaa,85,34,75,83,70,92,439,
ecb26a89-1859-46c4-831a-b52660d69a1b,Duard,13,1,55,61,6,81,217,
bf5772ca-0f29-4f91-bd40-f822320102bf,Duffy,68,52,70,44,96,48,378,
6439c8fd-d3c9-49a4-a287-9b9c0c0bfa51,Duffy,59,25,39,84,57,69,333,
455e9ad9-fcf2-43bf-a04c-d822bc783829,Duilio,58,59,20,57,69,2,265,
35ab4977-e3ee-4a46-a5b6-58af904daf7f,Duke,61,94,59,53,48,91,406,
15da38bc-2c3e-4c0c-a0f1-5cc8f57715b4,Dunte,31,25,21,70,64,77,288,
e0900cf2-c6bf-45b7-ab42-ff7e062e756d,Duong,91,79,43,20,57,14,304,
67176f5c-936c-4cda-8be8-bd8761a133cb,Durand,90,24,89,76,91,68,438,
d4c172fe-aa26-4924-9718-ad48d386ed8b,Durell,22,27,30,33,34,53,199,
df71a00c-fded-4590-96f6-22f1acf5bc86,Durward,15,73,92,44,61,81,366,
abaed0f6-2139-4dac-ae9e-b4bb4b326a37,Dusten,72,15,84,3,62,21,257,
2f52585e-1d5d-435c-95ac-bb43f53dbf3a,Dusten,89,48,91,96,73,95,492,
57fdd91e-5e9f-48c0-b9c4-5a7fb29a98ae,Dusty,100,85,81,70,85,51,472,
e351738d-92ee-4e66-b607-ad74b9aa75c5,Duvan,26,92,28,53,7,84,290,
b5273a60-edd4-47fa-b532-2426ef35719e,Duvan,92,46,52,87,89,65,431,
88be992a-7627-4aa4-8fa1-922be054de9f,Duwayne,37,26,89,83,57,96,388,
db4a0f9d-a819-44ce-9fa3-e3cde90b28a6,Dwain,28,29,46,81,82,50,316,
58c1ff1f-8671-4c7f-852d-9d8282c9c0fe,Dwane,26,61,40,55,90,25,297,
8d80fec2-3dc3-4366-bc8e-7093a521346a,Dwyane,8,73,63,85,21,71,321,
a05eb5d2-a3a5-4798-9f0d-0160ecd5d4fd,Dyana,2,8,65,10,5,6,96,
c003507c-8970-4fa1-b149-e4b1564082eb,Dyanara,9,23,55,72,66,87,312,
ce5b8188-6d68-409e-b54d-44ad8593f11e,Dyani,28,4,55,55,12,28,182,
bd03b23f-b147-42e5-81ba-ba3dbecdd518,Dyanna,72,74,2,96,47,90,381,
b3c180d0-0169-4615-bd2a-1fe5f1fc32c3,Dyllan,50,82,39,81,75,96,423,
faa336ef-dc77-47cf-a353-f5940ed9be22,Dymere,72,57,3,12,44,5,193,
d538038b-8a9c-47ed-9507-5f4f1266f8ba,Dymere,18,61,48,17,99,39,282,
e2f653e8-18e7-4dcd-b43a-6544630cdc8c,Dymon,49,67,15,67,0,9,207,
4e8b6dfa-11e8-4e11-96a5-7364b1c6832c,Dynasia,71,35,71,72,56,97,402,
9cead38f-3861-4cc1-af98-87d7360adc85,Dyrell,85,52,36,50,5,42,270,
5dbec5bc-4c8f-443e-8639-56ab83b28dda,Dyrell,53,91,76,22,76,67,385,
64921ff3-e652-4658-b9b4-d91d8ff07a96,Dyron,88,50,100,91,77,91,497,
83c629c1-4138-4ac0-b01a-6836f28b1152,Earl,4,64,14,9,5,64,160,
6c256263-e1b1-469c-8ff9-9f62e52f7bd6,Earle,71,13,2,4,40,42,172,
9d4dae23-3138-4bcb-99e5-7a083fea4161,Earlis,34,33,47,38,78,2,232,
eda359a9-1919-4aef-96a4-d2c1ca0678aa,Earlisha,64,26,65,27,42,39,263,
02b88205-d391-4ac0-a7a9-67bdeb4822b6,Earlisha,15,68,78,42,63,80,346,
e178b35d-8be4-4cab-9a93-eb0827246b3a,Earnesteen,11,59,46,77,66,6,265,
0a7fbcf3-6a81-4a6f-ac8d-64b52ed37858,Earsie,16,5,57,78,61,49,266,
b2502b1b-a3f4-400d-8e0e-1adbc9c14865,Earthalee,86,45,50,66,62,43,352,
737e400f-9e33-423e-aee6-933b8b41990c,Earvin,20,15,38,6,14,58,151,
fd25279c-5196-4099-b727-fdfa1dd40fee,Easten,62,1,54,61,53,23,254,
27b73743-33d5-424c-a233-c7977e53ce4a,Easton,71,33,97,87,28,100,416,
9d2e79e8-9b2b-452a-8913-b569c9fb468e,Easton,6,85,51,21,50,69,282,
208a1db3-edcc-4779-b936-e28b999b5416,Easton,23,100,52,6,97,7,285,
bf5fac66-e301-40a0-ba01-6bb6d8913add,Eastyn,67,43,84,1,64,56,315,
9dfbeab5-76ed-465c-a1e7-69b35fcd48e9,Ebelin,64,23,70,41,33,40,271,
9337dd45-de83-41a7-8605-9cc9d90d3b7f,Eben,80,91,29,76,44,45,365,
9dfc5f0f-40f5-4999-b75a-6b19f857619a,Eber,94,87,46,80,25,39,371,
ba9c5d6c-0cbd-4974-9635-658adfee1882,Eber,50,48,12,91,87,39,327,
d91df70c-1c4b-4c29-9332-3e176e79f15e,Ebone,33,79,65,98,24,38,337,
8e6817cc-8e3c-4356-9073-39dad15c1b1c,Ebonique,31,30,40,48,25,82,256,
ee281d8b-9085-4170-8511-c352a3cf3950,Ebrahim,75,10,96,5,11,98,295,
bedf5919-d03c-4abf-8270-85003f5f7111,Ector,57,58,42,35,12,37,241,
419d0207-f640-4fd6-a621-b60fdf7149af,Edahi,20,18,33,40,80,87,278,
795321b3-5255-4782-91aa-b487a2629949,Eddye,55,59,42,56,52,66,330,
35be1267-8381-4066-88c3-acb1aa3ac06e,Eddye,30,6,34,89,25,94,278,
b9cd90ef-a559-47ed-a23e-3f38644c9a0a,Edelmiro,1,32,43,10,69,72,227,
c09f31cf-5f96-4126-b5a2-adfcce1078a1,Edelyn,1,74,38,56,16,78,263,
7e6031a8-2e1b-4651-9c9d-a51f136ae350,Edgar,14,89,15,40,59,18,235,
13d3be79-5f25-4130-8369-fb593dd69984,Edie,14,68,42,77,20,44,265,
e9af74c1-dbe2-4f91-90d7-8c962f723fdd,Ediel,67,100,66,89,18,81,421,
8c30a7df-65d0-43a9-99d2-525d0fbeca3e,Edilberto,86,71,17,12,0,30,216,
4bbc3085-a207-44e2-b0bf-695dd269f188,Edilberto,80,1,41,42,7,34,205,
553bcefe-85a5-41a3-bf40-ede074197359,Edilia,77,99,93,10,27,62,368,
ef96765d-51cc-4201-8294-610b17c33cea,Edmon,50,43,13,32,4,67,209,
32359179-f7b4-4961-bd1d-1de0e6dccf85,Edna,53,11,11,21,87,2,185,
0dd7ca96-e8ac-44e9-a699-c3fd0e9e5f03,Edolia,22,52,76,46,13,46,255,
f56194ba-8670-491a-85d5-cdb862d6354e,Edrik,57,95,73,77,61,49,412,
e0ed3791-6595-4348-b692-3e84704ecfe3,Edsel,29,83,99,23,96,53,383,
7720e465-ef54-498a-8c4d-fb6a5997ed39,Eduard,58,93,39,88,46,85,409,
f466cad3-7560-409c-a8fc-f9f244abaf86,Edurdo,38,0,89,9,90,2,228,
33c23326-0cf2-42ed-b85c-9f59af25a645,Eduvina,26,100,35,12,67,15,255,
c43f0e8e-5434-45e0-9b8c-cbe6a4cc9f73,Edvin,27,12,63,40,37,1,180,
a2b0d003-da28-467f-99d3-0e010bb03382,Edvin,67,30,55,1,81,74,308,
3fd61fe5-97d2-4643-8b20-486aa0e33a93,Edward,7,0,45,28,51,16,147,
d0bbde40-8932-4e98-85ab-ab3c18b25ffd,Eesha,24,96,1,17,57,83,278,
007064e0-48d8-4404-aa66-656c8ecefe29,Efrain,15,10,37,27,52,96,237,
54730711-2ee0-4a40-829b-29ab36787a30,Efrayim,56,35,95,31,30,60,307,
3709b1b9-de26-4f4f-8d0a-dd9aa22eef0c,Efrayim,15,71,64,5,49,66,270,
d1651d7c-c31d-482a-b657-f249634494f5,Egan,8,56,43,39,70,91,307,
8d18c7fe-08c0-4ed8-bd5a-89f672ae0322,Egbert,61,18,48,97,97,100,421,
d8fa664b-172c-470a-84f8-8371001b3453,Egypt,70,83,67,50,20,100,390,
50eeda23-edf9-471c-8b7a-c5e843d2140e,Eh,56,10,34,37,21,9,167,
68763a7e-0fea-4ef2-9b88-476ca1085d59,Eh,73,87,8,83,99,15,365,
8781c6cc-bc70-4700-813b-9cd7377833cb,Ehab,78,99,28,76,15,76,372,
fa75874c-ca09-4872-b7ca-d57c4ca5b36f,Ehab,93,29,41,93,26,85,367,
2966aa29-bff3-4787-b581-13b7d98b3274,Eian,22,73,87,59,74,69,384,
17675d19-d0eb-469e-b04c-75630d2651fb,Eila,72,64,51,59,82,82,410,
40865bd6-87f8-4641-88ab-e17fd82f9a80,Eiliyah,10,57,51,70,90,21,299,
af3f4b37-11b9-4f11-b870-4b0edbbce871,Eiliyah,73,33,94,89,29,33,351,
beb6e9d8-cb68-4294-8dd1-f6132c1e149f,Eimy,77,10,29,83,54,55,308,
737ce87a-2b0c-406d-a1cd-613231685626,Einar,17,98,77,79,71,36,378,
8b24caf3-6374-4946-bfde-a421951def78,Eisley,9,50,39,26,71,58,253,
2d8d115e-c784-487c-9337-e4835e7c65b1,Eisley,14,74,80,15,95,63,341,
aee65315-8e57-459c-b2be-9c71d677dacc,Ekta,17,44,53,61,84,73,332,
a2156cac-8594-4840-a7e0-312c226a7be9,El,52,65,33,1,54,59,264,
4e870374-d856-4545-bb1d-c3fd6a3a9eae,Ela,71,50,0,82,15,93,311,
c46f91d1-9527-4d7d-a117-70a6c54cafc3,Elaina,6,76,45,70,81,75,353,
95ad28a9-8315-4161-ac1b-402b8def2137,Elaine,84,84,4,29,71,35,307,
88daa8ce-2d4f-452b-9743-049e7aec94d7,Elani,31,50,37,14,52,98,282,
381908fa-2283-4a3e-84b0-cdeb05887ead,Elanna,21,69,23,48,48,3,212,
3dbb0459-a733-4c59-a98d-0aff20837cd0,Elba,55,84,34,17,99,66,355,
58118117-7de5-4bfc-b708-4be2826f19f3,Elba,3,88,3,20,21,91,226,
7457f798-a987-4532-8dcd-a8eb55402597,Elber,30,69,53,68,90,32,342,
e93aade0-09fe-4b3c-9e63-8f59fe9c0eb1,Elbert,44,5,52,22,31,63,217,
17ea983e-9227-45c1-9ec3-bcda9356a6e9,Elbira,80,57,20,20,26,16,219,
ec4df3de-1eb6-43fe-8636-dd7e21d030f7,Eldora,9,100,94,31,94,100,428,
f60d70c5-6a06-4b1f-b63c-40c50653d08c,Eldrick,74,55,69,30,91,75,394,
49fa8917-c806-49d3-841a-c891a7ebe831,Eldridge,67,12,88,17,73,51,308,
f34afdfa-08c0-4e8c-a75c-640f23b68bb8,Eleanna,29,31,87,7,5,46,205,
a2f699d0-89b3-4d14-bcb6-b77a4f2fb7ae,Eleanna,73,5,80,56,10,51,275,
4135211f-4e24-4070-a1d5-6877bbc3a65c,Eleanor,9,97,38,8,16,62,230,
12327c8d-f779-433f-92a0-54fb4dcad3f0,Eleanore,94,64,78,80,72,74,462,
488b10b7-7bc3-4a37-b535-5e7fd0f8bca7,Elease,88,40,47,88,68,64,395,
e160df36-f29c-49b3-82de-f8373792146e,Elease,84,87,66,10,42,21,310,
5f33417e-d18c-41f3-a2a6-5110e13c26ab,Electa,13,69,93,34,55,76,340,
063c1ca1-7d67-4ab0-b859-3c9a9c2146f4,Electa,50,62,80,57,32,89,370,
89e6e718-f022-4dce-b0eb-9b4bf1bf019f,Electra,49,79,85,83,10,93,399,
f5bf4c95-3576-4a93-a315-642091f5b150,Electra,29,21,98,70,82,87,387,
d5715a91-e633-4828-b335-aea84bc52c57,Elektra,9,8,42,87,78,79,303,
be7651e1-7b87-4ea2-a389-9f3ad0b17a44,Elena,35,19,17,78,82,73,304,
bec050d0-d0f6-4d28-9f3b-37ffb3994b3d,Eleno,34,96,96,9,79,73,387,
5b2a9b05-bfca-43f1-b7d2-677129ceff00,Elenore,95,31,50,4,33,36,249,
080e6b3f-e19a-4e14-a105-487b47cb072a,Eleonora,19,78,88,68,20,39,312,
7ab56c18-0ac0-4609-8c92-74571c664f39,Eleora,60,41,11,24,19,63,218,
e473c101-a9fc-4099-acb9-c0bbf8686d4d,Elfreda,16,30,82,54,85,5,272,
e6486e61-24d5-4354-95dd-8f968f86e1f1,Elga,17,95,72,12,71,89,356,
3d0b5a14-0bda-44fd-87d0-4ffa2220ca23,Elhadji,18,88,49,37,42,6,240,
ba1e714a-910c-459e-bc15-8272ecd5c5fa,Elianah,2,45,97,69,1,10,224,
e3f05f84-3438-41e5-be98-ea5b6b8351e2,Eliany,32,97,93,87,27,15,351,
116639f9-2e03-4c82-a128-4e62e10d2d5d,Elide,42,60,33,93,87,49,364,
a1146cd0-a1b7-4820-8c93-c406ee663e1c,Elideth,100,43,40,35,31,3,252,
d39e5624-ffba-48b0-9555-fea947972680,Eliel,77,21,45,54,34,25,256,
1eefbbfb-9ff8-4060-9ed3-f60ecab7ec70,Eliezer,21,5,56,15,22,57,176,
d4da0dda-069d-4887-9075-0855cd6b2f0d,Eliga,12,85,45,69,97,39,347,
ebcba3cc-55f3-4dbc-aeae-682254a15082,Elihu,45,12,69,88,43,58,315,
d1a5b1a7-e54b-42b1-8f40-98e89659cda9,Elijah,71,46,39,35,35,76,302,
a8530a4e-bf03-4617-b731-fea62b543263,Elijha,5,27,48,30,77,47,234,
a18051f3-5e20-420f-87a3-30707a8889cc,Elina,55,82,3,23,60,64,287,
e6ee3dd5-f1b3-44cb-ab34-c57ed42365d2,Elina,92,6,0,65,100,61,324,
3c54642b-ede1-433f-8206-76a491e98d47,Eliot,97,24,96,8,47,66,338,
a1a621dd-5b62-4926-b9a8-fb06165cb3db,Eliott,98,29,97,33,96,14,367,
ebb547e6-f2fe-4123-87d6-360807c924cb,Eliott,87,22,16,46,62,79,312,
22cf2ba0-be48-4d38-8d7a-f415b48108b1,Elisabet,27,65,61,95,8,34,290,
8b19cd9e-a412-4619-b8e7-1ccbac50db60,Eliset,49,6,31,13,98,95,292,
7905d7b4-6b8c-4929-a6f8-2bf53a285d06,Elita,21,85,44,89,99,44,382,
8a7fe9fd-bbdc-49a7-bd3e-50d8d669272c,Eliud,41,5,23,81,49,2,201,
4ae6fe68-e984-4e27-9865-24c8a67b27a9,Eliyahu,76,79,88,4,66,86,399,
b9799224-0495-4628-a6b6-142a77571cbb,Eliyohu,0,58,92,84,100,16,350,
266e5679-7a63-4b33-9978-00bcb0fbd143,Elizabe,2,19,58,15,98,91,283,
33f11098-699f-4036-a57d-f410e9700311,Elizabella,98,68,76,92,57,19,410,
6d92d46d-a6a5-4623-aa3b-d8101e2c05b5,Elizabella,55,87,98,45,16,73,374,
4f8e0871-a0b9-454f-b629-0fd3ba7537b7,Elizabeth,83,47,80,87,62,88,447,
db4c1b6b-341e-4e90-96df-022de948d911,Elizaveta,44,95,77,1,100,49,366,
dbdc5df0-6218-411a-bfeb-257171ed6791,Elize,73,43,26,50,73,15,280,
d0ce8e0c-be3f-438d-910b-1bec90467947,Elize,97,85,93,88,63,23,449,
736bc938-85b4-4e24-b9e1-b9b606470ea6,Elize,24,12,79,8,15,60,198,
c087a1dc-701f-4afe-8975-0c9ee9311dd6,Elka,84,81,39,23,83,45,355,
cade8330-30f6-4bb3-bc52-3b5ba2fae570,Elke,86,96,10,19,97,80,388,
605db0e2-44f9-4ec8-83eb-814a5c0a60fa,Ella,44,13,10,70,7,3,147,
30a6d25d-b272-41f3-92ff-f6567ae68b82,Ellagrace,83,61,75,67,6,28,320,
80ad9ee6-b9da-421d-a908-6549e323720f,Ellah,70,6,62,22,49,46,255,
ae06f427-0218-4c66-a73f-fd5de8f29080,Ellar,21,55,29,100,84,65,354,
1687c729-de74-48a8-bd94-5da582f3660e,Ellaree,3,10,10,73,52,47,195,
c7ed7071-93e8-4fe9-9c02-484d5b84ad2f,Elleana,90,72,94,13,75,91,435,
90981d44-fb2d-4b57-9307-73512df21e5b,Elleen,60,6,25,21,71,37,220,
e13e732e-d03f-42b1-9fcc-6378f635035b,Elleen,40,41,15,4,57,12,169,
3d0bd4c4-431f-446f-bcdb-94bacf2c2578,Elleen,1,16,5,72,41,10,145,
e804657d-dd16-4c6c-b45e-c3c9be425616,Ellerie,74,91,21,61,10,44,301,
547c81c5-0c95-43ef-8389-df05a880dfe2,Ellerie,41,42,61,79,91,29,343,
7ba33edb-8df6-470d-9de6-a74b114ef965,Elli,46,49,90,57,15,21,278,
b6bf85cf-c989-4ff3-8a41-dcb69223a9d6,Ellia,27,74,83,37,20,3,244,
c05a1235-6ee4-47b3-9472-5f78a3afbd90,Elliana,56,43,7,8,77,10,201,
d8b83b51-4e55-4c8d-a652-9b73b8a6dfee,Ellice,93,54,61,9,35,74,326,
d2c8c946-1443-4aef-bc08-9438886b8758,Ellieana,70,93,83,4,3,5,258,
b508a2a5-d7ec-47e8-a33d-1651f3c4679e,Ellijah,51,95,8,51,99,2,306,
67fe2efd-67f0-4400-a768-ea5265c34ef2,Elliott,6,0,52,53,83,40,234,
c5fbc45a-39e3-4e75-9b56-2bfdfc5d51ae,Elliotte,46,74,0,95,85,73,373,
58232edd-b2c2-46bc-a469-e53b298d59b1,Ellis,52,29,70,38,0,63,252,
4b26a0f9-4ded-4573-bef9-45357ef02ec1,Ellise,98,58,82,87,40,8,373,
0387a6ae-bce9-4749-80ba-ba0d5aad1500,Ellissa,0,93,8,34,99,100,334,
770912c0-3dac-4ab8-9b03-7b5cb2a1e46a,Ellissa,18,87,53,80,7,44,289,
4e632e8e-950e-4b84-b25e-e40a774689b5,Ellisyn,58,97,9,11,53,13,241,
5db6ccfe-b15b-43fd-b3cc-09400853e200,Ellora,69,100,92,60,37,25,383,
f8276b74-608b-4bec-bf93-eeb8e4c268b0,Elloree,13,29,98,86,98,95,419,
499bd6b9-7e60-423c-b14d-f57d7a489943,Ellouise,74,68,82,78,73,15,390,
bf390646-d7d8-4911-bb90-f0b9c06c814d,Ellouise,4,32,100,15,40,76,267,
df0a4f9d-a5ff-4802-a967-54de8f510a24,Ellyn,71,99,80,10,34,96,390,
d289dac4-dffb-4f37-b251-af3240f1c243,Ellyse,63,89,7,12,98,11,280,
fc12e418-87c1-454b-8e87-51efffe3e29f,Ellyson,26,38,89,22,62,11,248,
31e656d1-c438-42b7-ad73-bb50b957d5db,Ellyssa,70,36,73,13,40,1,233,
d0d830bb-89c8-4a75-b6d6-d5c244d4be30,Elmira,76,67,90,64,69,91,457,
4163963d-2b6c-40de-9f89-f9d0a6973209,Elmore,58,19,4,54,90,9,234,
cb274511-507e-4d6d-84ce-0d15254d6773,Elmyra,21,99,16,40,71,43,290,
a660a63e-061a-4869-a4c9-b8fe8f12e117,Elnore,22,10,28,45,21,91,217,
476667ad-4e80-4d5f-89ab-2270358055e1,Elo,27,22,27,18,40,97,231,
42fa6c9d-3c42-4920-be61-55261999fea1,Eloise,67,0,38,76,56,23,260,
f0a06c83-cba4-499d-9ede-d1623ecb4f50,Elon,20,30,7,28,85,80,250,
d61c06ba-6d5e-4e9f-81ba-cd3233c3bc8b,Elonda,65,57,60,14,66,94,356,
1c09fd33-cee0-4f7a-82ac-1e7c91ad3e80,Elonda,68,11,62,23,57,8,229,
74186697-0223-4e44-9064-dfaff15fb206,Elpidia,70,26,19,86,67,81,349,
b39326d6-4cfb-4f2f-98fc-3fac1b1e16c5,Elsa,33,16,70,22,37,72,250,
0b71e208-8865-4dae-85ed-738c69d3ca01,Elsbeth,48,8,11,15,52,82,216,
72a91266-459a-4feb-920f-92c57936ec9c,Else,14,73,29,35,7,40,198,
4528be70-410a-46c6-a583-801a95ef73c2,Elsie,31,42,22,87,24,75,281,
6ea0c42c-e2e0-43a9-9ba3-5dd8e319bc3a,Elson,48,45,35,94,57,26,305,
adaf95d6-fe8a-4c46-ae3f-fff4a939fae6,Elster,18,0,56,22,88,82,266,
155870c0-6e83-4144-8691-578cf1f8906e,Elster,89,2,33,75,28,27,254,
dbbe93c9-1cdd-470e-86b0-698a6b938460,Elsy,65,95,49,83,58,54,404,
0df0602c-881e-4c94-830d-ab58a069c48b,Eluteria,69,96,95,4,54,83,401,
293f2406-902f-4288-bdf9-78e36ccf7114,Elver,10,50,29,1,73,27,190,
e491b39e-582c-4cb8-962d-0a1e68b039ac,Elves,16,40,3,28,22,82,191,
43387c14-fda5-4e79-9dde-eaf19288363c,Elvire,75,57,14,87,35,11,279,
ffeb3097-29e8-454e-812a-6dfd1830944c,Elvis,90,17,70,29,21,38,265,
a83be0b4-659f-4afb-8203-d712f4420220,Elwillie,88,51,89,56,51,90,425,
e6962f1b-9fa5-46fc-ad9d-b8e1b851bdc9,Elwin,78,74,27,10,42,6,237,
f1078bbe-a4e8-4bd2-91ee-74e1e12763d8,Elworth,40,83,81,36,61,6,307,
4e11bec0-8158-4408-9634-9350f8bc3975,Elyan,15,83,46,35,14,62,255,
77fdb2eb-267c-472c-a49d-be9926a02339,Elyanna,2,48,87,98,0,88,323,
ad356287-057b-429b-aac6-80456d5169ff,Elyanna,45,35,36,7,82,7,212,
afd8ec4e-87fc-4e74-b2e3-3070d48214d7,Elyas,91,18,83,86,92,15,385,
24bcbc4b-b625-459a-89fe-625792b12e50,Elyjah,96,85,50,50,84,9,374,
884d9e39-a456-4176-a102-92758bfc27cf,Elyn,48,89,99,28,31,1,296,
08d0a6a1-9678-4d10-9db7-7208b7b691fe,Elynn,2,78,78,75,0,65,298,
fb5e5135-6ee9-4f0d-a915-0adec36b74af,Elynor,89,91,11,10,98,27,326,
da34b222-136c-4feb-8411-b5e540993f1b,Elyza,36,65,85,54,96,67,403,
2d1e4dc6-d30b-48bc-a538-8648893eda99,Elyzabeth,21,74,77,3,1,72,248,
f56ac7bd-047e-471a-b02e-b4a60a8a85aa,Elza,33,39,17,70,5,83,247,
83125640-498f-4728-9261-d0b29592f0bc,Emaan,44,92,62,92,48,93,431,
a50eef2f-3669-4b66-9a06-6e2ebd09f0f9,Emalee,8,52,95,74,46,70,345,
cc2ef261-24c2-4900-b24e-18bd3b2a4ca9,Emanuela,37,100,71,81,8,50,347,
43226d0e-b21c-43f9-b0a7-7f8e34b0a5d0,Emanuelly,92,66,16,68,34,11,287,
d71611fd-41b9-4542-99f5-48031ffa2db2,Emarie,63,98,92,11,23,100,387,
0d91c4da-8121-4d86-b031-72ed6950e533,Emaya,24,73,61,60,50,17,285,
9a29d72e-21d3-4cf6-a580-3520165efedb,Emberly,55,75,83,56,54,43,366,
53e1b613-986a-41e1-a26c-d78f16719800,Emberlyn,62,93,47,80,24,72,378,
ae502c9a-235d-4401-b9c1-206a7ce4ae87,Emberlyn,74,89,65,49,70,9,356,
0ed4e95f-909a-4b93-920f-6f27e36e4dd5,Embry,13,93,9,70,68,95,348,
e3e82498-bd16-40bc-9ec5-a45b5f21f141,Emeal,89,71,0,34,57,91,342,
46e1e364-f533-474e-83c0-7d3bd8bb4432,Emelda,63,25,15,13,45,72,233,
e8168adc-6649-4955-aeef-b37aea51e9eb,Emidio,99,46,54,93,44,88,424,
0bcee879-2889-4574-a44f-0298d5c56894,Emilee,87,89,65,91,88,35,455,
03b1f215-c0b7-4d8b-95db-2949c529425e,Emileigh,93,14,99,59,96,44,405,
443014e6-2b9e-486a-97bd-4487da409d89,Emiley,27,60,37,3,70,46,243,
abf284c3-b1c3-4161-9c53-9b1962d5da1f,Emiliana,23,78,19,23,42,85,270,
47df3b67-f4ef-4032-bbfa-cec989b1eca8,Emiliano,6,77,94,81,85,46,389,
014689f5-52cf-4367-ac33-83f1453d8796,Emilija,58,48,15,97,45,51,314,
35235d16-d704-4a49-af71-5efb437e6475,Emilio,25,44,14,23,79,42,227,
39f661e9-1db0-47bc-895b-85e61585f540,Emillee,45,85,76,68,99,24,397,
586390da-2af6-412b-8ab7-fda9777b377a,Emilyann,15,83,53,70,83,26,330,
cde803d6-c15f-41a3-8034-f83cd4cc087a,Emilynn,13,67,77,24,68,17,266,
c2c82ab7-e08b-467e-98d7-545b4bd7f3ea,Emilynn,27,0,49,71,87,91,325,
13da2981-8a16-4e2c-a91c-e4c13a8712e8,Emin,97,96,87,41,19,2,342,
9d5349f8-32a8-4191-a5ea-0796a9663138,Emin,35,33,4,2,79,5,158,
c77c7d3e-b232-4f10-ac87-38e2e3c443e6,Emina,38,37,18,48,61,2,204,
c8ab4964-fd49-4538-8a39-c35a62743ecd,Emira,24,51,14,93,76,53,311,
c1a35b3a-669b-40ad-94ef-ac170f58f42d,Emireth,42,85,99,37,21,24,308,
35cf818c-a020-4e97-891a-d7ca5d43f8b4,Emiterio,0,35,13,14,15,99,176,
377efd14-01ef-4335-a858-567f81973474,Emiyah,87,27,66,1,78,90,349,
6cb2c436-20ae-4f40-b066-97883762d094,Emiyah,60,85,28,86,61,74,394,
2499234c-9901-4ef2-874e-dc75eedf0286,Emmagrace,79,57,82,44,83,2,347,
5a9745a5-e858-464f-a4e9-5c7d30dc5c4d,Emmagrace,75,17,90,5,1,50,238,
4f835e19-d147-48b7-81c4-c763a05d9007,Emmah,5,58,1,93,69,94,320,
c23eb35b-67ab-4cdb-8a33-be853ad08356,Emmaleigh,26,4,42,69,77,60,278,
75d1aede-e229-46ea-9f0d-6ccf59e405e0,Emmaleigh,54,81,83,69,53,81,421,
ded6ef60-e5b1-4884-8f09-0c3874fdd158,Emmarose,9,36,40,70,88,54,297,
60762e5c-be5d-4b0c-a69c-c3f1049345fb,Emmert,23,16,95,93,15,98,340,
8dc8fd7f-a360-4627-b338-248684020c12,Emmett,43,91,79,94,4,35,346,
f391cf42-464b-4786-8996-c9c46efc7b9b,Emmit,93,54,50,66,94,45,402,
08c5e464-4ea9-4820-9769-7b1b175b44f8,Emmit,96,84,80,71,42,88,461,
0fcda9e2-97ca-4683-ade7-d5c5dd51b7a1,Emory,70,84,45,34,84,37,354,
099a7d9f-015e-4d7c-b86b-f5823d14a642,Emory,75,81,78,83,11,62,390,
7add7d9f-6cc7-4b9e-a5eb-aeae61b65b2d,Empress,63,20,53,98,67,35,336,
e8e5e065-d483-4551-b6d8-62352c56e032,Emre,41,69,78,13,50,54,305,
244e06ba-3fa2-4630-8dd7-4d0c85590560,Emrie,48,55,76,80,53,45,357,
a7f344eb-7b9c-4792-b693-8426256e294c,Emrys,70,18,25,69,56,39,277,
fa3158c8-bbf5-44e0-bcac-ff5c4da9c622,Ena,69,85,51,94,3,21,323,
119abbb3-82c8-4380-ad1a-929f37f9606a,Ena,3,81,11,9,57,40,201,
7824aa16-059c-4e90-bf37-bcae4a0a31aa,Ena,13,81,54,3,53,18,222,
ab5ae3bf-1879-4a41-b105-83891104a44d,Enchantra,24,35,48,7,70,81,265,
a3a83be2-2a03-4016-9362-c9d9647f1b2b,Endora,35,68,53,73,51,10,290,
5545eaa0-9b73-4866-913a-4c61134904ef,Endrit,10,18,69,3,100,49,249,
4dce648e-d229-426a-8b69-985e8642b1b5,Eneas,72,48,20,2,12,15,169,
fe4bb56c-4038-4278-bbc8-37a67841ef36,Eniola,97,63,17,28,81,33,319,
268011a7-5ab8-497d-a110-df90e26d4f0a,Eniyah,31,30,16,22,10,16,125,
c63a2b1f-9bc5-4c5e-a497-df46de323d80,Eniyah,0,91,94,56,48,72,361,
128d04e3-4643-4c1e-a7f6-47fc43f51a46,Enmanuel,59,98,91,34,88,10,380,
55bf7fab-c6ff-4e58-af1f-be011b97bf1d,Enrico,33,12,94,9,26,39,213,
a7dea8b2-77dc-4d4f-8dfd-e99b79d57128,Enya,17,25,43,81,97,77,340,
6dc732d2-6838-4480-b92c-8c7413ecd3ed,Enza,71,30,51,56,56,55,319,
3d9ee339-56de-48b8-9e18-39259c7f7fce,Eowyn,62,12,45,84,92,100,395,
77fc5d4f-6d6f-4939-b9b3-dd905699dab5,Eowyn,56,46,13,4,3,96,218,
9651cc3d-2f4a-41f4-8b32-2387f4cf47a3,Eowyn,39,22,63,81,67,90,362,
3b6cc8af-8108-46dc-8d3a-c7154b866264,Ephram,100,87,53,88,31,0,359,
65ac5347-35a0-4e3e-9c38-37bd7f302a41,Ephriam,88,68,41,8,19,31,255,
42ea1398-44d8-460a-a532-a99e6458e4c4,Ephriam,100,63,63,21,84,57,388,
14f78156-7db1-47e3-80e9-da8f96c14d93,Epifania,100,65,87,60,63,30,405,
5f9ee00c-a9e5-4c2a-b9ba-f7a9bb807bdd,Epiphany,71,80,58,17,2,51,279,
3a2aa34f-88ad-4111-80a5-a9a630e85e25,Eran,88,91,91,12,21,25,328,
d88bb1bc-3cf3-4068-abe3-ee4af1a08284,Erandy,23,63,5,19,52,85,247,
a253e1fb-93c2-4ff4-8879-6942099c8c36,Erastus,45,21,65,17,59,14,221,
24ca1033-ea7a-4b11-b9ff-4dfa8fb86b8f,Erbie,20,19,47,78,44,87,295,
f9bf2257-0b89-4c4f-98f9-4ded53f69634,Erby,56,75,0,8,8,47,194,
cc516905-e119-4366-af26-a49753592cf4,Ercilia,91,71,33,16,88,23,322,
eb2b1cad-1a11-4992-8fb6-95d4dcb1a1b8,Erek,39,41,11,79,18,47,235,
20870b35-6b0a-4f3c-999e-0766336f092b,Eren,19,53,74,15,71,15,247,
855ad833-dd07-4ee0-b012-780f151e8837,Erendida,17,24,80,79,2,37,239,
958e7d3d-047c-442c-b239-c362701d529b,Eri,38,51,96,12,39,100,336,
cc7673d1-be7d-441f-b8fc-bc057bab3f7e,Eria,87,27,18,12,6,9,159,
ce81cd9d-4404-48fa-ae2a-b1c662ee9fb9,Erial,7,70,4,81,90,67,319,
c5074042-fe22-4605-8461-da0631d87021,Erial,38,76,79,63,71,41,368,
6672862b-da5c-4346-a187-4d7599800922,Eriberto,70,66,49,31,22,79,317,
ee6b94e6-0863-4146-a5a6-ec32dbe99414,Erica,36,31,30,77,67,8,249,
d1ca2c96-2175-430c-ade0-56a368559c5f,Ericia,4,8,72,0,63,45,192,
2c985d19-93ba-4360-8523-b630335edb8e,Erie,94,24,24,8,5,75,230,
91e7abf4-060d-4f48-84ae-d2049fb8220a,Erikka,55,88,18,37,42,88,328,
551ae33c-7fac-409a-86a0-45ae961879dc,Eriko,84,3,49,35,78,83,332,
ff31cc88-eb0c-44c9-9732-de3fa9b0e521,Erina,12,89,58,47,9,0,215,
ed6b768d-a2a9-4d3f-a35a-3acc592d459d,Erineo,14,51,13,78,7,73,236,
27ed0fbc-8f38-496e-9354-89dc71605feb,Erinn,39,5,34,81,98,7,264,
c1aec220-c9ee-411b-80ab-decd08889869,Erion,44,36,81,18,99,31,309,
bcf68b77-f41d-4dcc-9cff-f68685d90ace,Erionna,71,10,41,12,81,100,315,
4ce4d522-2977-47d0-b16f-3c88b64ffb7b,Erionna,48,40,65,71,51,74,349,
819e7fa3-2146-40f0-a1d3-e4cef46b516a,Eris,79,43,24,81,46,84,357,
4234d596-29f9-47cc-a40d-7d6e2118fb0e,Eris,9,91,47,31,43,27,248,
cee0fbf1-78ce-4ea9-86b6-07a9df1a6adc,Erle,99,23,57,85,22,90,376,
7e0b498b-8b36-421e-a56f-a9b6bf1ee0d1,Erle,77,13,75,15,62,45,287,
88dc545e-5530-4287-9531-21a3d975e895,Erlinda,77,20,33,12,94,40,276,
9e58018d-a536-43ae-bb01-733442066906,Erling,90,75,3,15,35,22,240,
7f96d939-d0f5-4b0b-998a-d1a0a6bf2479,Erling,11,63,39,20,98,78,309,
d2e28b8f-5228-4b07-a1cf-a3a7c532878e,Erma,32,18,50,85,82,46,313,
ddc92958-addb-45bc-9623-8cf101b53c28,Ermal,44,50,56,43,1,85,279,
6df9c047-775e-4d77-9ab0-2e56f7486dda,Ermal,94,78,32,36,40,29,309,
37172f2d-66f6-40f6-ba8e-df58dd4c9692,Ermal,20,88,90,87,23,87,395,
8fbc554d-bd49-4b38-ae2f-cf1717942ce8,Erminda,3,73,88,37,0,41,242,
90a7421c-f7d8-4ddf-a3b0-ad3712176105,Erminda,9,32,69,13,56,48,227,
26eeb1ce-df03-4fc5-97d5-fa1ef5cb185b,Erminda,8,55,58,100,0,27,248,
59f76616-ccc8-473e-8ac3-764a1dfef1be,Erminio,58,80,4,54,16,14,226,
225e07b0-ca00-4887-840f-26fe40c36637,Ernestina,18,61,16,86,85,37,303,
def19f01-4b29-48cd-acf3-b69f19380f11,Ernestina,86,27,64,54,93,46,370,
594bd9fe-4f90-4d28-8e8e-b28a15eb2636,Ernestine,76,27,79,15,79,93,369,
2a5ceb73-d9b3-41b4-9263-b78abb3e84ff,Ernst,47,35,44,95,78,27,326,
9daf8b18-a01f-488a-a1d3-48cded9171ae,Erol,14,75,76,25,74,78,342,
25faaace-3da6-4a00-9124-0e2fd0f65744,Erubiel,25,84,78,9,4,68,268,
11c2172d-fe6e-4406-9836-8d4884753f0b,Ervin,39,53,8,64,22,58,244,
c1ddd48f-e73a-4f63-a08c-523d1c7aa79f,Erwin,38,51,73,67,41,78,348,
eb74f454-40ac-4a63-bf65-2973646adce9,Eryn,35,18,10,51,92,94,300,
c0c76b80-dd3c-4f72-b9db-3db2ad27e959,Erynn,80,20,77,4,12,41,234,
3a07f70e-125f-4acf-b3c0-8be8918a5dbe,Esa,53,39,24,82,52,11,261,
ea1ec868-3039-4914-95e2-a36ff187252d,Esau,65,69,59,53,57,3,306,
71157693-7b64-4ac1-8cdb-a203ae68d076,Esau,80,43,17,79,62,51,332,
9b31a6a1-489f-491d-88c7-4180c823de98,Esaul,99,93,86,71,66,83,498,
0f559a22-5d6b-47db-9bef-ec94acd5d9ac,Esaul,37,97,38,6,28,37,243,
27a6e600-ec04-4a2e-b418-2c3e09c47f9f,Esaw,18,73,0,10,77,58,236,
376c2877-4d71-4e8c-afe1-7c85d4177357,Eschol,74,68,45,4,49,36,276,
11685434-aad9-4d13-ae91-0672255064ca,Esequiel,92,40,40,72,84,54,382,
3f21629b-e2ac-4850-8899-0f608d2dcc28,Esgar,10,17,15,50,4,58,154,
5a7a6ea3-e555-4be5-87b4-8022dcb9246e,Esgar,49,5,69,48,4,22,197,
c4957242-9433-4c12-9017-deabb23fe79b,Esha,94,54,30,10,62,89,339,
cd113f8e-2025-408f-a8d3-362f7dc59dee,Eshaal,53,26,10,16,97,48,250,
54fd6793-65df-471e-991f-6f2df0b6dc28,Eshaan,74,56,51,22,36,35,274,
eb72c292-18b7-4754-a5a7-aa2ab149b3e9,Eshaan,5,85,43,91,89,92,405,
edc9fa70-d32b-4434-b5ed-cc0b1e623b10,Esiquio,31,5,61,96,10,11,214,
4530ae99-0fa0-41dd-8e5b-ce5b29ae413e,Esma,94,5,81,9,6,74,269,
806869b5-5755-49ed-a23c-f0fcdae4f983,Esmae,87,39,70,40,29,12,277,
08cac777-1704-49a8-bec6-66affff15325,Esmae,67,85,96,77,58,88,471,
c815a2a0-2ef1-422d-b7d7-6faeb5dd0623,Esme,65,92,40,94,7,52,350,
80dccecb-45f5-4551-ab7c-b4489a21eda5,Esmee,56,36,87,48,61,39,327,
0aa2c340-d90d-4334-8a7f-639eee7b8249,Esmeralda,42,98,36,22,97,96,391,
0e46cbc4-6478-4cc3-bb18-9963261af627,Esmerelda,93,23,67,90,20,80,373,
62bd8e01-6488-4429-83a0-6cfef84908eb,Esmirna,6,48,47,83,86,50,320,
77401127-b4de-46cb-b0bd-4910b0456e8e,Espiridion,74,98,71,48,99,77,467,
151e020f-dedb-485a-92eb-484c3435b9eb,Espiridion,99,80,87,100,1,76,443,
35bb9b98-f2c0-4fd2-83df-eff1dc49a6e8,Essfa,42,92,61,34,43,76,348,
6ad61d51-bcb7-49ed-8548-cf646bcbd273,Estanislado,84,48,79,46,89,80,426,
682d04c2-5dea-4a1b-9fcf-a94c5a41eb0c,Estefania,85,37,100,35,46,80,383,
5d8185f6-9073-4112-a7cb-207dc7fa1897,Estefanie,50,34,38,73,24,65,284,
2df82138-c7f1-42ae-b0da-02c4a19ac85f,Estefanie,59,67,82,28,82,61,379,
3d797aea-0f0d-42f2-89ec-9a0322d63017,Estefany,94,50,2,51,46,56,299,
c80d51ec-36ab-4c76-96c7-ca5fedd5cf82,Estefany,11,74,66,36,99,72,358,
4864a1fc-cabe-41bd-ad52-8b834ca8ac33,Estefany,53,24,88,48,44,16,273,
7865e2fa-7308-4f40-a26f-5e7db03db2e9,Esteffany,15,80,0,34,62,72,263,
130aafa0-e632-4588-88ae-e6d94cdad9c5,Estela,51,76,66,77,57,52,379,
1e0607b5-acf6-4b4b-b682-58fc2c070bf7,Estell,85,82,59,55,6,76,363,
0dede491-b189-4928-87e0-1c000bc12050,Estell,10,59,65,65,67,73,339,
bfefcff4-1232-490c-856f-8ab5374024d4,Estephanie,98,28,100,2,81,4,313,
c2a19ab7-48e3-436f-ba60-359397bdbf0b,Estes,61,13,58,13,35,9,189,
6aa20448-b70d-4109-991b-7ed82fbe07c9,Estes,25,11,67,52,86,27,268,
f791effb-77eb-4384-90fb-7ef2de9722b4,Esthefany,88,55,48,17,27,39,274,
e31c59d5-e851-4093-a2e1-18c04486e184,Esthefany,61,41,88,0,26,94,310,
be082634-8795-436f-b80d-69ceda194c82,Esthefany,21,80,17,15,22,59,214,
ba9d24e7-7946-4df2-bb9a-d4e3b65319a2,Estie,54,28,16,97,27,37,259,
a6c096d1-7e7f-44a5-8e02-aca946c43eb5,Estil,17,13,34,46,12,54,176,
e399afba-41c2-4a97-8b15-5b63ff3aa0a2,Estoria,20,14,33,41,86,51,245,
5a76737c-b546-4633-8c42-607ff0b8e1f5,Estoria,43,32,62,100,25,88,350,
0db7cdc8-26df-44a6-87c0-ed9f41a34b5d,Estuardo,91,83,42,30,56,83,385,
19dd4fc1-5a09-425d-ac39-5f70a79e6c34,Estus,63,73,55,51,57,82,381,
e144b2cf-2bcb-40b9-b1c3-432cce2c0260,Estus,16,59,27,49,99,17,267,
70e74586-ebf9-4bf8-8769-cfa015fdb949,Esty,41,16,49,74,49,49,278,
0283cb77-5920-4d35-ac11-69bdb96fc41f,Esvin,91,16,91,11,90,18,317,
22a62cc0-9988-4fa6-b51d-c5f8a831b78e,Etan,12,55,36,52,42,80,277,
d5a37975-68ac-494d-b7d5-98e3972f92fe,Etha,33,6,99,28,96,27,289,
99a03570-7166-4e42-8916-5ccf38be2388,Ethanjoseph,13,31,90,83,0,39,256,
bde377e9-0265-4f4d-bcd7-99efb1182ce1,Ethanmatthew,65,69,44,55,63,12,308,
5480e43a-9e28-4429-9def-2c01139f67ca,Ethel,43,45,27,94,89,61,359,
aa5c99ae-3a41-4991-9945-2a6e9efffcae,Ethel,99,20,80,88,85,77,449,
1b2e6534-f111-4626-b058-63491b7c7df8,Ethelrine,45,33,55,61,15,54,263,
2e03772f-6650-4c4e-9170-145654af5391,Ethen,10,93,4,67,8,17,199,
02dc8148-5690-4c30-932d-36fbfef4c586,Ethon,33,84,40,72,37,33,299,
2afcb10a-5f1c-43e1-83a7-fdd2e9e698e5,Ethyle,70,43,4,55,71,51,294,
44896851-b7e1-4ef0-96e5-1fc93f25827e,Ethyle,6,66,100,24,4,96,296,
fe6580f1-c08d-4475-916d-247c5667ddd4,Etienne,27,57,92,45,85,8,314,
ea16b8e3-9b85-40dd-bb86-d549ea948199,Etienne,19,40,1,4,2,97,163,
6470b5c3-5687-4231-bf74-4b092f185139,Etienne,20,16,12,58,57,30,193,
86deb957-5e2b-48a7-bada-e5145e94973c,Etna,87,13,55,55,79,56,345,
534c781b-fe98-4bff-ae7c-cc14a7fdc518,Etoile,55,62,80,45,37,2,281,
ef3a5257-cc31-4d42-8ea5-c1cce0c4dd37,Ettie,100,44,48,55,39,16,302,
3a7c05a7-85ba-4c4d-8ac5-84120e7f180a,Etty,1,97,94,9,78,42,321,
55dc47d7-13ab-4b23-be81-e7498b8059d4,Euan,11,24,63,71,47,8,224,
60140b8b-2067-4068-b787-c68a5b575965,Euan,25,50,27,67,35,81,285,
1df62e5d-f2ec-45fc-b858-0fb95c576e49,Euell,12,18,14,70,18,74,206,
049e0dce-1b20-4a7d-b622-54ac2ff3f4e9,Eugene,48,27,59,87,15,5,241,
9ff2e2e6-df85-4b50-ab6e-ac8df75ac289,Eugenia,35,82,90,2,82,16,307,
1dc11263-312c-4514-b9f9-5818ff44bc3c,Eugina,19,43,46,68,57,20,253,
8a019af8-83af-487e-b4cf-7ba9b016eaa9,Eulalia,77,58,89,13,83,68,388,
6144f06b-c866-4ab0-a8de-009f123fe547,Eulalio,66,12,58,33,78,34,281,
b52b0f4e-d680-4ec2-b76e-cd47363bdc29,Eulojio,61,59,97,57,27,11,312,
a26b83da-681d-4218-a14c-b9b220a26c19,Eulojio,77,10,33,39,35,9,203,
22554ae7-ae94-4581-a58b-b6cdd91f7492,Euphemia,21,24,6,14,59,1,125,
4ffb70e8-ebc5-4cdd-b405-3f71eb760fd8,Eura,0,32,100,30,57,10,229,
4e9138b6-74c8-4982-88e7-ef5ac97f6644,Eusebia,17,41,100,48,23,99,328,
b4a9924c-d93a-4008-b83f-f9a163ef9323,Eusebia,35,59,99,23,55,51,322,
e450a6e6-7677-4749-a33c-d61b4a8932fe,Eustace,92,10,77,13,44,7,243,
1b429656-c79b-408a-b3d7-0a2101461400,Eustolia,82,88,63,14,0,7,254,
5a9fa016-83ce-400e-a856-1fe4f88c89ce,Eustolio,41,64,62,13,33,38,251,
3b3ad9fa-5bcb-4b3c-9d0a-0ac0bcb256b3,Eustolio,99,89,49,63,59,71,430,
8fc97f96-09d4-4ddd-8b07-87bab71aa652,Eutimio,7,83,45,50,99,77,361,
f54f0d94-11f3-4abe-b492-1d0203c87bc6,Eutiquio,45,58,62,87,42,65,359,
9cab3637-b712-4dd0-a8c5-041043ba569d,Evah,6,15,81,100,42,11,255,
5f634b0c-256e-4fa1-ae79-a98882d5ec09,Evalyn,96,95,38,42,22,67,360,
3beeea16-7415-419c-8e1f-2f3ff17fa2c8,Evamarie,44,25,40,4,12,26,151,
2f859d57-8e17-4114-9ea8-50f32690ad1c,Evangelia,9,33,5,16,95,49,207,
632f14bc-f56f-4c0b-ae4d-7d057bd45e4f,Evanjelina,44,83,68,11,60,39,305,
4130a6a6-1dcd-4c61-8efb-141af8425707,Evans,28,63,4,30,64,73,262,
8cb25b85-6af0-4566-a933-d0d11d3c8aab,Evany,9,60,97,49,24,32,271,
a89cb5ed-db38-4e3f-9721-f9ce668fe7b5,Eve,27,38,92,14,39,48,258,
1b4cbdaa-f816-4fd6-9353-1469c18a76df,Evelene,50,100,6,93,11,27,287,
4a391925-83fc-4380-b069-6f51cf3c37ef,Evelin,75,5,79,22,26,1,208,
295acefc-086c-4956-80b7-7c4cf5682810,Evelio,47,77,75,59,31,79,368,
ba40540b-57de-40e3-88fa-04fd10f98998,Evelynn,82,56,30,99,0,79,346,
965b675d-662b-4477-8cc0-e43ab6709b0b,Evelynne,23,5,43,1,23,25,120,
1c807ea0-f89e-4503-b236-b5e98d7aac29,Even,2,70,39,53,95,7,266,
a49a4deb-a35d-452b-8425-b696a31adb3f,Even,93,81,26,8,84,27,319,
9673d2c0-651e-49c3-83ea-99878f56565b,Evens,96,41,49,68,35,60,349,
059f1200-1ef8-4bd8-abe3-5a9a03c10f45,Everest,20,4,24,62,11,85,206,
3be45ca8-e96e-40b4-be2f-d8ea2f9fa059,Everleigh,16,44,21,85,29,96,291,
3ae7145c-5f70-469c-85be-fdb9d1e60ba5,Everleigh,13,58,42,97,13,75,298,
2137a6f1-dd2d-4fab-9559-76f9d64ff7ec,Everlyn,54,3,47,39,80,36,259,
ccc2dba5-1c76-44fa-942f-06f2be9ea84e,Everlynn,19,91,21,17,21,67,236,
38cfb3ef-f063-4ecd-8a45-f6619f7d4af0,Everton,45,25,28,64,11,38,211,
a489360c-b58b-4320-8748-ecb53b040e12,Evett,37,27,99,70,58,4,295,
32b37124-d160-48c0-bcc1-29fa68e37df5,Eviana,5,39,15,96,97,55,307,
8a84ec35-91fe-4607-8c8f-93b7d7c3e30a,Evin,43,45,61,21,18,71,259,
cad9ab3f-7de5-45ec-aecd-5a532ed47965,Evita,21,28,46,19,32,76,222,
0bff68f7-5091-420c-aa3c-2b0ace06d8f7,Evlyn,4,55,20,23,95,63,260,
ecfd73c7-c9f9-4411-bf2c-911b85fed695,Evone,76,52,5,90,59,61,343,
af879b79-89cc-47a2-8a3c-473a1ffed072,Evony,26,4,14,92,17,24,177,
e90a0673-bce8-456e-9cf8-63031f3f73f0,Ewan,37,69,67,72,12,28,285,
4d46b1e7-aec6-435a-be4b-f73e042c9256,Ewelina,11,34,55,60,54,93,307,
330fc503-8a32-4499-82fd-b0c081982e34,Excell,21,86,43,4,13,96,263,
cb42cd74-b3fc-4ca1-a56f-9ec15385a027,Eyan,24,2,32,97,50,91,296,
01946a66-d132-4e26-aa60-f79855e09873,Ezelle,20,72,77,35,74,26,304,
4d351f75-b508-4f43-b4cd-e06e3f78fbd1,Ezmeralda,4,90,55,68,84,67,368,
4d680005-84cc-44c5-8e99-d9069dd23a90,Ezmeralda,57,26,32,40,21,84,260,
e0b51094-72fb-4f5b-827b-02640155bd8b,Ezora,22,22,81,51,8,23,207,
86bd4675-897d-41ca-a936-04970a801ccf,Ezzard,91,70,31,64,47,67,370,
9c98b227-9a54-4aab-ba4d-d99350fbf052,Fabiana,79,90,86,69,69,56,449,
b3beb274-2cdb-4efc-b81d-0ecc700ab35e,Fabiana,27,96,30,95,77,95,420,
623d8515-d632-419d-8b4a-c5e7a5a12da7,Fabricio,36,52,19,8,77,34,226,
f84b892a-1335-4469-ab43-a53b0982e3cd,Fabricio,27,3,56,25,10,91,212,
b4556404-3763-4292-bb53-be1ca1b8dd8e,Faduma,92,25,37,79,97,55,385,
59241fd6-e05d-4c6e-be1d-016f226b914e,Fadumo,41,9,84,5,62,67,268,
98a1ce92-af88-4d0a-80bd-59c2896f3303,Fahima,91,90,90,48,27,22,368,
425762b8-0724-4575-9493-12adfb8796ee,Faige,58,38,1,22,82,94,295,
aaab5102-06af-4f59-9274-04316c95984f,Faith,70,72,28,85,63,85,403,
979abe29-d4f7-4139-8019-e55962b7b946,Faithlynn,42,40,37,23,51,98,291,
a08b874d-937d-429b-8375-d8b2cc2d4da9,Faizah,84,94,30,11,2,88,309,
ea063991-6c0e-4138-acbe-977ac36df581,Falicia,6,72,0,45,4,20,147,
99ba841b-d53e-4893-ac70-6a4766e47bab,Falynn,52,62,74,60,60,25,333,
664379c8-062a-4aea-93eb-8cec453357c7,Famous,2,81,92,62,22,19,278,
8bd93870-d339-4966-a48c-2814476ebed4,Fanny,85,45,29,22,81,24,286,
798e1b4e-400e-4cfb-92a7-5a4bb54dfe3c,Fantasia,34,54,33,23,54,93,291,
9590b93a-c198-4f7a-8766-81cc5e00aedb,Fantasia,68,91,16,15,27,78,295,
983ddc12-dbdc-47ce-aab1-750da1273458,Fara,83,80,6,28,33,9,239,
ca1d49f5-c69a-452d-8223-0afb3f97aa48,Fara,84,50,88,18,14,85,339,
018cb014-4bde-46e4-bfee-6a8534d92bc5,Faraz,44,66,92,27,18,70,317,
6d31ddcc-3315-4fdb-b4f4-e866c9d5a194,Fard,49,16,32,80,99,90,366,
2d5c8dc5-4524-4df7-a311-f1fb79864d8a,Fardeen,49,5,22,54,13,94,237,
dbebef74-e06b-4451-9e8d-906ea55965ce,Fardeen,36,35,77,48,93,13,302,
eb69c539-9204-4e69-a655-197e1602fdf4,Farhad,100,35,56,41,57,83,372,
00ccdf28-1ba7-4012-80b7-45b0dc0f75c3,Farhad,51,52,21,67,86,32,309,
ce7e456b-5196-4aa4-aadb-dcff3164ec93,Farhan,48,21,23,88,73,1,254,
355db839-62c6-4a0b-8052-973e613042e8,Farhan,29,74,40,79,50,27,299,
73c89b30-77b9-4cc8-8e00-ed24481e4ee2,Farid,20,63,94,54,95,18,344,
e0fa14dd-8976-4bcf-883b-0c557a10d0dc,Fariha,38,41,32,86,97,9,303,
4e014f2e-c16e-44a3-a9ae-9b4411e3eb07,Faris,81,98,59,22,19,95,374,
d267c5db-737b-410c-bb91-9c0d1aba9dbe,Faron,45,90,95,50,36,11,327,
35d7924e-40ff-441e-aa1f-319574e90bfa,Farren,58,9,82,8,68,73,298,
eec4037d-bfcf-418b-8fe8-07bd5333cf1b,Farron,9,60,61,26,57,5,218,
9f0c6420-efd9-4f5d-8c55-61f1ad6eb7d9,Farzana,8,65,27,85,34,21,240,
157e4562-c744-404f-a1a8-0462c6e39d6a,Farzana,61,78,6,38,50,16,249,
82bedc86-80d3-4bc1-9a0e-43764486c1a0,Farzeen,4,81,81,44,42,57,309,
d11a82cc-2ec4-4972-8aaa-9622206b2ddf,Farzeen,85,31,74,52,79,43,364,
8d173a1c-b65b-4c5e-b476-dcabf4dd86f5,Farzeen,98,91,76,57,77,10,409,
73696414-c9ea-41ab-bde6-9bff665ebd93,Fatima,50,66,14,59,69,97,355,
d296a5fd-afc1-4921-9d90-2872503dd290,Fatma,21,30,82,96,1,92,322,
e069641f-dc3b-4b4d-b243-4daa41f4c91e,Fatmata,89,48,94,63,32,31,357,
45237659-05d1-440a-b923-e7804d445047,Favour,30,49,63,14,2,35,193,
47b360a2-4063-424a-8119-3e0273c4a331,Favour,11,41,9,3,76,9,149,
c8bf6a11-4b01-4a07-9910-d74a51da2056,Fawn,81,6,66,15,98,47,313,
b77227c9-3a96-4b4e-a15a-497b7b28cc4c,Fawn,15,75,93,51,32,57,323,
4dac72a4-672c-4adb-b164-e7aa68004b55,Fay,69,93,74,49,5,6,296,
53c15c62-02b6-410d-9e51-21adacf1562e,Fayette,85,81,51,49,19,69,354,
36331152-7f42-43ff-a27b-6cbb862898fa,Faynell,14,90,98,81,55,83,421,
79e98cab-c8bf-4df1-99b1-54e698a61ec8,Fayrene,74,59,41,79,27,78,358,
b9502168-e2dc-4507-8023-d7142abfcc83,Faythe,62,78,12,88,90,21,351,
c64088cc-f60b-4f00-b7e9-f9a585458a68,Fedelina,30,82,5,91,53,100,361,
b5ff0b43-c5db-493e-bca4-56e34df0f71c,Federica,26,23,14,55,56,19,193,
68a72b5e-4c51-48f1-abab-ee8ea71f621e,Feliciano,85,39,22,3,73,88,310,
b6b96d7f-c4be-4805-af9c-12203b67f27c,Felicidad,18,61,13,1,76,5,174,
ba4a19c9-441b-496f-b05f-84293677d303,Felicidad,57,22,78,89,35,80,361,
a5d37e16-a7d4-4321-9ebe-63dc74d9ebd1,Felicitas,69,16,63,86,65,65,364,
2ed66fa1-cb89-41aa-a644-41ae5512b896,Felisitas,48,39,38,28,75,63,291,
1423ea99-5c6e-4465-9c07-d8aa8bb505f6,Felisitas,81,45,18,4,65,86,299,
4ff5e569-a27b-48b1-8bd4-17c6b892d584,Felix,36,79,58,46,14,42,275,
f0669bdc-8254-4cb1-91b0-9c70b5cb2ff0,Female,34,5,3,23,5,47,117,
99555dce-6e3e-4016-8b7a-a9cf16327a8c,Fender,40,44,37,30,31,72,254,
f94fdb49-4885-4caa-85ae-a8b57229e53a,Fenix,18,23,84,40,54,14,233,
e6430713-ed9c-410d-9f82-5bd381850873,Ferdinando,61,36,16,28,22,14,177,
4da562ee-3cc9-4d48-b3d0-e37377ac79e8,Fermina,94,92,52,62,19,92,411,
574f30c3-8328-4d00-b9b5-4d7cfb5a81a5,Fermina,90,95,52,69,32,48,386,
61b40836-cd32-4444-a471-b04ccfa3c096,Fern,41,0,15,50,90,50,246,
f6ddcaf7-2b63-4348-b4ab-197484a227f3,Fernand,43,18,37,99,0,24,221,
bfd0cac8-a981-423a-a7b6-fc5c8c4b1458,Fernande,82,14,24,78,46,48,292,
4fef9a6d-6e61-46b8-bda8-44abdcdd9109,Fernando,98,89,12,23,37,39,298,
ace2a762-188c-4cf9-a682-0faee18abde6,Fernando,29,3,61,69,85,52,299,
8497a6c4-acfa-4844-8a87-6c20ac9c1835,Fernell,11,100,54,90,95,24,374,
e573faa9-d130-4511-82c3-b06b80ba111a,Fidensio,44,78,20,76,51,39,308,
01a3d6bc-c404-444a-9554-a5378c10fdf9,Filiberto,16,4,18,33,87,60,218,
4e25771d-0938-4c0f-8a61-9e326cad12ac,Filimon,47,22,56,54,68,49,296,
224fcb25-2b36-4db2-81f2-aea77e90442c,Filippa,12,10,33,58,34,74,221,
ec3113a2-0b49-4543-a93f-7759f96db193,Filippo,88,2,65,78,57,66,356,
c04d675c-67eb-40c1-aaf5-abbd802ce285,Filomena,0,65,90,40,35,78,308,
b7f8c3b8-b9ec-43bc-a195-20f6d539f12e,Filomeno,16,98,75,64,94,73,420,
265274d7-66c7-4f48-b0c3-061e441aff75,Finis,0,50,81,91,35,14,271,
282b4f81-43eb-4191-9a81-9fd5c7dc9486,Finlee,42,16,61,19,27,53,218,
bf135e69-389f-4fe5-bbac-9e402d73e2b5,Finn,54,38,41,56,84,27,300,
49d0f1e5-ade4-487b-9860-549b2a9c1034,Finnegan,15,8,67,42,12,53,197,
afa2e346-90ac-4abe-b91a-2fb30373dc5c,Fiona,66,60,63,56,87,79,411,
0fa88b6c-8bcb-4cd5-b4b5-b15b0e362cfd,Fiorella,53,38,18,86,4,36,235,
e1b49cfa-30e4-4acc-bb61-5a9eeed6eb23,Firman,22,70,43,9,26,87,257,
596174d9-a459-4d8e-8849-ca0f255cf86a,Firman,89,18,86,88,59,92,432,
80ba81b0-4a3d-4df4-a139-219cbeed3b5b,Fischer,60,19,35,75,73,93,355,
b03809f0-a6d5-43db-8870-ec7ad38c1cc6,Fishel,24,91,46,39,2,13,215,
9a1e37cc-6701-4af9-affe-68d1a15e6e2c,Fitzgerald,66,29,33,41,47,43,259,
126a25bc-4d5f-40cb-ad64-4f04af3b7ca9,Fitzhugh,51,83,28,0,63,74,299,
7b02c6fa-5af8-4953-b39f-930f87c801b5,Flake,26,2,42,3,69,1,143,
c3405d83-dcab-454a-9c2b-dd040e961c35,Flavio,74,42,68,23,14,90,311,
0d16c99b-65ab-4547-a7d7-8e02d7d6aa42,Flay,37,61,69,38,76,11,292,
fef2ebfb-42e2-403b-a576-777c5f435403,Flint,14,67,24,62,6,73,246,
1283da99-2407-45c5-bb45-8685f099117f,Florencia,89,54,10,88,94,61,396,
d544c79a-f8b0-4675-898e-a5525138a438,Florencio,20,2,84,83,0,81,270,
63a675b8-1d5d-458e-899e-1e38008c3668,Florencio,11,10,26,18,99,43,207,
86d5d150-f51f-433c-8083-3a0271a0656e,Florestine,10,74,62,27,39,82,294,
be1939e5-077a-4c64-a164-5a8df1ddb336,Florian,61,0,74,29,72,8,244,
4670deff-fe9c-4cd5-ac82-e233fc6233a8,Floribel,5,82,51,49,46,88,321,
0393e00c-3130-4a65-9e4b-11c17bec5802,Floriene,8,2,93,77,82,70,332,
cd0f6765-efd5-48e0-8262-46c4b7ac121d,Florinda,99,88,33,3,56,34,313,
f65d1cad-03f9-43e8-8cb1-23e6e4e46153,Flory,68,17,49,36,77,74,321,
43fea14f-badd-410d-a892-3ecfc7181535,Flournoy,63,34,65,64,84,13,323,
56b158ed-a810-48e2-b13e-ed02e8df6c45,Flournoy,24,76,87,86,39,17,329,
08351bef-38ba-4bd6-b2b3-80d81010a25d,Fonda,71,41,73,76,44,45,350,
90b57a7d-147d-4139-9684-cb454f697dc1,Fonnie,15,23,60,27,68,52,245,
dea49eee-39bf-4a0e-bc85-1d27e59014d2,Forestine,31,26,12,69,45,7,190,
96a5d6c0-1568-4f8c-912c-f97eb0a8a919,Fortuna,55,16,97,92,36,98,394,
dfac915e-e406-402a-9e0e-288ed71f4718,Fortuna,72,63,35,23,82,78,353,
bb70bca5-276a-40ee-bde8-8cac81e262d7,Fortune,23,66,27,26,15,54,211,
dcbef110-115f-4833-a553-509df56a692c,Fotini,4,92,36,93,94,81,400,
8e7c8080-46d3-4be3-9fa7-6a8ae0464816,Fouad,20,82,98,56,59,34,349,
4d2b8d86-130c-408c-91a6-e81f6ec2b85d,France,33,11,43,43,84,49,263,
b72e6d59-141f-4ee7-aec1-bfa0a9cbeb02,Frances,85,27,50,57,99,79,397,
7e27a76d-4156-4a65-a6a5-08e95d064a34,Francesc,45,74,26,86,75,2,308,
97ce80e8-c973-4fc6-81a9-9c85dfaae2dc,Franchelle,24,79,28,8,84,47,270,
57921772-9244-4970-a26d-e49f7365dd07,Francheska,99,3,85,76,84,0,347,
f6719f75-3eef-4e55-a423-655f057b7d9e,Francille,64,72,91,50,83,3,363,
52a4c2c7-0546-40f7-bf70-fb44dc12c55f,Francine,68,76,14,37,93,45,333,
69c97f9f-239c-473a-a2bf-bbf6e28edaf4,Francisca,45,69,34,2,62,40,252,
a9aa92e1-01fa-4458-9ef2-2ba71fde76fa,Franciszek,76,70,82,52,33,98,411,
f381a53b-4a05-4e7f-99d7-fa66803a4a47,Francois,88,25,1,13,80,15,222,
43a36dd4-1347-497c-bf81-327ef44b97b1,Frank,41,82,87,37,87,0,334,
51d4bd18-71b1-4b85-b81c-b9c7dd4933dd,Frankie,34,100,28,86,26,64,338,
7b862368-9dc4-4bd8-af90-d9c20b2b9b7d,Frankie,99,9,61,35,12,42,258,
1ea4d931-6888-4599-82be-a692d733289c,Franklyn,74,43,37,42,91,21,308,
46bf38cc-ac81-4524-8baf-6949d622cecf,Franko,44,91,15,84,17,100,351,
e2253b85-aafc-4c10-b493-e486e8dffa50,Franko,23,92,44,48,1,80,288,
195c811c-af13-44fd-a219-298077918cf0,Franne,92,27,81,62,68,52,382,
26bb78a0-2760-437d-9fe5-9776bc6881eb,Fransheska,82,52,70,65,69,90,428,
0ab9408d-a9c2-4b43-b7fa-f4f8b1b460d1,Fransisca,9,8,62,61,46,50,236,
f56c36f7-8b24-455c-9153-81d995e98255,Fransisco,18,88,18,57,93,62,336,
88efd92d-505c-4aab-b457-ba409947e889,Fred,99,78,93,16,15,81,382,
55de1679-0dfc-426e-b936-8a9df1d00dee,Freda,81,54,2,99,77,78,391,
15a251a0-d25c-4d63-8dc7-67a8e0db9d1f,Freda,12,97,65,1,63,21,259,
41a45d9b-6f0d-4aa0-b1d3-d72c13c8b0b7,Freddie,68,4,69,81,31,17,270,
dd316e48-ace6-4aa6-9097-89a067a85364,Frederi,31,47,32,54,6,14,184,
c171d951-400b-4dc9-9336-10bdd3d27cff,Frederica,57,32,12,3,18,85,207,
c3fc065c-e7f1-453a-88ac-2c4acaca0872,Frederico,13,64,6,88,18,12,201,
1c729b83-9594-4863-b17a-8dc9df3dcf68,Fredia,84,60,78,100,29,62,413,
926661c7-7145-4be4-97c8-593c1b30428f,Fredia,72,7,59,32,30,92,292,
ec2702ae-846b-4e7e-9f9b-46369b22c028,Fredis,63,28,26,3,92,89,301,
b1c3e210-14be-4ed3-93c5-061abb8baa3a,Fredric,39,28,87,73,43,59,329,
431f2426-585d-4a90-8c01-ecc3c7354a8e,Fredricka,55,14,4,78,96,87,334,
ad76e332-bee3-4e6c-8eff-c48659627407,Fredrik,46,24,100,74,51,97,392,
3e6935df-b79b-4463-8e12-cef01f5f99c3,Freeda,74,55,39,29,95,28,320,
8390b960-3b96-46a7-ac2a-68561adae5c4,Freeda,33,87,61,46,65,90,382,
a851484d-b8a6-4dc9-a3fc-00230f8187b5,Freidy,21,27,54,50,77,60,289,
0916234d-dacf-4cf0-8628-81694dd681f1,Fremont,45,98,94,29,13,75,354,
49989451-70e2-48fc-8ed0-e5ac7bf866c6,French,38,18,88,97,17,100,358,
303645fe-ec0b-47a2-bba9-c222d74532be,Frieda,91,12,61,54,62,15,295,
efb4ebc4-09fc-45ff-953f-3f91312b1786,Fritz,83,93,63,96,5,99,439,
6cf84ad6-aff7-4844-aff4-5b31125ebdd2,Fritzi,49,99,24,52,44,65,333,
8107a06f-c88e-42ba-b2dd-ee5536f25c5c,Fruma,48,5,51,20,26,75,225,
05817621-abbd-4da0-875a-e013df6c88ae,Frutoso,72,5,60,83,90,69,379,
16c6401e-204a-4c8d-a5c5-5503166d4375,Fuad,53,34,66,75,18,12,258,
b3acf073-1875-4f4d-8c4b-15b22e2e5ec4,Fujie,100,35,29,62,11,96,333,
14f6c783-db57-4a53-8087-da2f3692e4fa,Fujiko,92,61,89,74,51,95,462,
bf852fbc-2d38-4681-8dfa-4d2c88e2bce9,Fujiko,10,10,56,74,77,66,293,
f45fde36-aec4-4027-a0ff-7b9e4b882c69,Fukuichi,99,13,43,26,95,13,289,
8c4d02ef-3592-4af3-b1ea-9206e805307a,Fukuichi,24,99,20,29,82,32,286,
2e638fa5-f3df-47ca-b49d-fbcf6dad3168,Fumi,64,56,96,63,63,66,408,
7bf479de-f15c-4b05-a8fb-905c80bbefcc,Fumie,34,95,60,92,4,92,377,
f37b67e8-6146-4dd5-a8a7-cdbba20b856b,Fumiko,96,61,26,36,13,56,288,
488b3b47-2f3b-4002-8e10-a2115f11bf82,Fumiye,28,29,48,73,90,41,309,
7d2e66b5-e1ef-4420-a5c1-1a00d47c6cba,Fumiye,14,72,69,81,17,37,290,
ebfe963e-34d5-41f5-9ea7-0670a2b0dbb5,Furnell,8,11,41,66,0,26,152,
13346a4d-f0d7-4924-abc2-91436491fd26,Fusaye,55,100,69,73,77,3,377,
04b34be2-6c0b-4d52-9067-afebdee2a242,Fynlee,56,98,81,34,77,40,386,
6c3bcc96-aa62-4863-9f4d-33e607729363,Fynn,88,87,65,11,35,82,368,
28adf66e-56c2-4a7e-bb25-805ff5f6994e,Gaberiel,82,34,59,41,6,82,304,
8bea427d-1b24-4e9c-bb9c-15ce4020e423,Gabino,21,45,75,0,5,20,166,
ec2ccbb7-27cc-41c3-99d1-c43b92d1316a,Gabino,46,80,73,24,76,8,307,
5367ad0b-f979-4603-b7df-f2ad805994c4,Gable,12,32,15,12,5,75,151,
0edb3a4b-443a-4303-b0a7-09edfc36d23a,Gabor,60,65,77,62,44,28,336,
37a6bd4e-6223-48a2-95e8-56461563b62e,Gabor,62,29,63,55,54,94,357,
ef17733f-0414-4d87-a9bb-b086e3c5e0cc,Gabrial,26,74,7,91,69,12,279,
d038fc10-d202-4c12-9eb1-a425b9db5a2d,Gabryela,48,4,27,2,86,17,184,
f06cf52b-946c-4f5d-a01a-1813ff7e97f5,Gabryela,61,84,1,88,74,7,315,
d5465611-48b0-4fde-a776-d37246640afa,Gabryella,34,27,39,25,28,76,229,
8e6c9e48-a2c8-4ef4-9044-d43f6eb9549e,Gaelle,94,82,36,13,27,84,336,
f9ceeeab-6ce8-42b7-8c5c-468cd03c9b55,Gaige,9,25,65,72,56,79,306,
e0faf4c0-2007-4c35-b189-5e476133a4a0,Gaither,80,90,1,23,60,87,341,
822bf835-28bc-45aa-b0db-84efef72dc40,Galdino,15,2,43,14,92,5,171,
ae44c1e4-c99a-4ac7-9ec1-18a72c528eef,Gali,66,14,6,25,71,77,259,
c20a8255-0380-4037-aea6-694a58e6c120,Gali,90,77,53,99,5,15,339,
45680dde-868f-4b0b-adb5-39ec5e0d7d39,Galiana,30,6,59,88,3,62,248,
409faaff-d824-47d7-ab9e-87d7c2d27aab,Galvin,56,39,44,87,62,55,343,
88f359c5-e56c-405c-a91b-29278a6c40d6,Gamal,48,27,72,9,49,43,248,
b15b62c1-1672-47b0-8ccd-4cd5b44ca02d,Gamal,4,29,22,36,82,50,223,
84032d8f-774e-49d4-9a46-b89c1ca4b84c,Gamaliel,94,54,43,38,52,11,292,
c62080ea-46e5-43dc-aea0-faec9750f4bd,Ganesh,2,58,92,47,3,67,269,
1a900cc2-b6da-4d51-8637-c9b5dfe814e1,Garcia,9,31,45,50,77,10,222,
6e754e41-e19e-440e-82e0-f8a9e2aef46a,Garet,85,4,2,100,47,14,252,
b94eb56b-26a2-4960-96a8-947d95c619cc,Garnett,46,67,53,53,36,49,304,
7fac2a4d-87bd-4e65-954e-b2b499488ac4,Garnett,21,46,85,54,38,16,260,
692ea9e2-4b3c-4b0c-9497-a538b7ae97a5,Garnetta,39,37,5,27,18,18,144,
d430ccfa-4538-44f0-b66c-ea38bf8d2552,Garrin,75,82,92,25,18,18,310,
163e4043-94eb-40f5-b70b-da987eb0e112,Garrison,26,4,2,100,72,41,245,
ad96a7b7-da27-4793-817a-2de6cdca7766,Garry,19,13,67,56,40,23,218,
c3c51877-e84d-438e-b5a5-23c4cc7bb607,Gaspar,100,2,18,22,19,45,206,
fa3c2246-8662-4a50-be1f-ffa46e60fabc,Gasper,95,95,46,100,63,56,455,
37028f8b-2970-4fac-9207-95448b248e93,Gatha,96,11,94,71,33,46,351,
f823fa34-fbd5-48eb-bd60-150d39d94375,Gathel,33,47,67,98,49,49,343,
abc697de-85a3-462c-a960-5c4d908fed47,Gaudalupe,22,64,31,71,71,10,269,
9cf672f0-7d26-45ff-9ba2-24b3ffcd7f91,Gaudencio,78,36,36,24,32,32,238,
7405e489-2b63-40bd-a07d-37daa59b1024,Gavan,24,85,23,79,20,39,270,
43e147cf-4b32-4ae2-b670-b6f0945e0b0f,Gavon,47,72,70,94,42,93,418,
81c5085e-0c04-46d0-b378-91c883af3931,Gavriela,59,54,31,65,87,47,343,
b4f1020e-534f-48b9-9afc-ee412a840a99,Gavriella,61,97,12,1,29,85,285,
b7442db0-0c42-484d-ba4b-a1c8b599859c,Gayathri,33,44,82,43,97,42,341,
39afa0b2-3f5e-434b-9791-151042d0d769,Gayatri,23,35,85,26,53,71,293,
a1615144-0af4-4353-a426-02e651c1d348,Gayla,87,84,63,42,1,33,310,
0a488fe6-6fe9-44e9-8e40-8258827eb65a,Gayla,70,16,94,78,69,64,391,
791351b9-0a49-470e-b51d-afd63582f1da,Gaylia,67,64,57,69,26,42,325,
433cbe80-99b5-4b4f-b928-e1c0661288ec,Gaylon,27,92,67,68,59,66,379,
bef1f68f-3b52-4568-bca8-8d79e84d3a65,Gaynelle,42,95,81,15,80,21,334,
11f09c40-21ee-406e-bdfe-cfef34b47e46,Ge,0,67,23,54,84,7,235,
3d48af77-5834-4d3f-bf9f-45349640db5d,Gean,43,71,8,66,34,44,266,
5b85f6c0-ac53-4917-ac97-574e3992a354,Geanna,72,12,61,17,18,67,247,
d6d368a6-cbce-44aa-940b-2394fd9a5402,Geannie,51,49,95,5,38,98,336,
2bce3028-ff77-4182-9be5-0f930ca5c8f9,Geary,65,10,34,31,40,6,186,
65717ae2-e14e-425e-ac62-399d79500b0d,Gecenia,99,18,94,61,30,85,387,
f0a923c6-4959-4b8a-8e1e-88233daa2af5,Gedalia,63,47,39,71,73,89,382,
988fb8a1-e0a8-4316-b445-22356127e4d0,Gedalya,31,72,68,70,82,4,327,
750f897a-0794-4d45-98d4-ab010e44730a,Geena,1,65,20,57,46,80,269,
5180796b-70d8-4b4f-9475-3c7f554690c5,Gene,77,50,24,60,98,37,346,
7d606af3-ff2e-4dea-84c6-c3b45160bcc1,Genell,89,84,0,96,43,79,391,
4b230252-82a4-4586-b904-21237a181532,Genella,30,62,50,49,4,58,253,
39b464ed-7580-4096-a27d-b7954fb9ca3e,Genesys,61,39,7,81,11,26,225,
3857a397-5912-4be3-84d3-562ab49f08fd,Genevia,19,81,76,49,81,50,356,
8f64d2bb-6c6c-479a-9d6d-c04c666fc436,Genevieve,13,43,27,65,1,42,191,
968eaebf-611e-4a7a-bd9d-2e15efd209d5,Geni,30,39,42,40,97,91,339,
cb357a76-c438-4c14-ba04-a6150a57a366,Genice,65,68,84,86,100,22,425,
04f7e3ba-8924-4f31-b1ef-cc33198b0152,Genice,43,37,31,72,96,29,308,
39bd6d62-e8a9-4921-b249-a94509b2386b,Genie,93,20,78,70,36,52,349,
c5df831b-8f50-48cb-821c-8ad865bb3100,Genie,72,98,75,27,69,35,376,
92b3ea79-0300-46f7-943b-207fba7c21b2,Geniel,70,67,100,63,30,52,382,
3018f97b-8358-44ee-b472-554cbdd64e2d,Geniel,41,81,66,76,31,48,343,
f686a125-f3c2-431f-808f-2c076d6a9ae9,Gennell,13,17,1,74,24,37,166,
51237c09-5dc6-419d-a599-8ef8c5734cef,Gennifer,20,93,3,32,6,56,210,
bf41e0e0-0ab1-4ecf-acba-0d35e571dbd2,Genny,43,40,70,91,13,71,328,
c0bb2f50-3b4b-482e-a2f7-9bf35a1b906d,Genny,58,8,73,81,90,1,311,
b05c1f0f-57c9-45f7-99e0-f12a5dff4340,Genova,61,73,56,40,20,30,280,
30c5684f-b9bd-44ce-9542-d9218d06cfb1,Genoveva,43,45,72,36,3,33,232,
6173734a-d9e8-458a-a090-33e40daa091c,Geo,100,6,74,12,90,22,304,
51077c54-50da-4b7e-9c71-1b0eca97e964,Geoff,25,77,33,5,35,38,213,
1582bafb-a798-4fd3-944d-bb30f5d20fcf,Geordy,68,53,78,47,69,7,322,
35052324-3f54-4e65-b347-614cb567ceff,George,25,24,48,28,29,99,253,
f8350027-0d56-4921-acd4-523755ca835f,Georgeann,31,83,65,91,47,19,336,
d29231e0-4228-41b3-83b1-960d6224d6b6,Georgene,25,2,52,78,95,22,274,
b9d448f7-90de-4c01-b5be-77a4942669d5,Georgia,47,79,33,17,66,75,317,
63a9cf36-ae23-4645-afc4-01428477aa87,Georgia,98,60,7,3,11,100,279,
e43e322b-cf1b-4c1d-8ff4-0a43fae2fdc7,Georgianna,49,21,91,86,62,79,388,
b16cdec5-e875-416d-a3fd-5a5c667e7a2c,Georgie,14,82,89,74,6,73,338,
530948f9-ba11-4b31-b4a2-aa5424dd3cfd,Georgine,24,16,93,82,38,24,277,
3300d59c-3f57-4d3a-9863-6c4ce5da7cbd,Georgios,46,45,44,40,82,2,259,
8093acac-e0ee-4dfa-a9c0-f7546901943b,Geovani,90,27,71,4,62,78,332,
06986fa9-b5fd-4070-a57e-bec752f14763,Geovany,9,100,49,0,27,3,188,
d5cade1e-3a7e-4b91-a0e2-32507e5d2676,Geovany,35,2,38,95,87,2,259,
73a24e99-916c-4a7b-be46-1735db2f8ab7,Gerado,77,75,98,66,32,26,374,
41e104db-fd2f-43d0-a52f-89817d949be6,Gerald,75,92,24,89,16,0,296,
6c8cbdfc-330b-42c6-838c-70ae1c1ad2b3,Geraldine,82,5,92,50,12,75,316,
b7014809-ce14-4aaa-8847-0884aaffbd5c,Gerard,46,43,8,70,28,94,289,
428265dc-d206-43b4-9eca-e7d695a6661c,Gerardine,88,80,53,96,94,15,426,
41dceed4-48aa-43fa-8854-3cd1ca9268a2,Gerasimos,87,55,28,74,7,57,308,
e93a7163-a7f3-4a81-a33c-91a76ebb7932,Gerda,76,45,23,19,83,56,302,
0985abff-77d8-4175-8518-4454d17af5ac,Geremiah,79,61,31,7,45,83,306,
47521fee-80ff-4dbd-9ca5-53b3d2860b4c,Geremy,33,22,38,73,36,17,219,
a2dd9d62-5010-4ce2-9883-5b2ba0a11156,Geri,79,57,60,44,45,35,320,
2441cb4f-8219-465c-b559-72fa57d49a32,Gerilyn,55,89,35,1,33,81,294,
f47aa76e-18d2-46fc-abc0-d623f6c4f2cc,Gerldine,86,9,84,66,56,15,316,
7318c7b8-bdc7-4c28-a4cd-30d708879ed4,Germain,58,35,57,20,95,7,272,
6335a0d4-403f-4f72-8362-1903948c0680,Geroge,77,85,72,52,84,92,462,
6394d912-8b9f-403b-8c70-1cdbb345ab10,Gerren,47,76,63,8,38,1,233,
8347aa71-241b-4cc4-b498-07a7c05c82fb,Gerri,11,17,60,84,15,46,233,
63b10545-0ce0-4a16-8bc2-5a7b52dee44f,Gerrit,30,37,56,92,56,60,331,
810db431-a62a-453a-8a6b-0e7327b26f29,Gerrit,53,26,98,41,80,99,397,
aa5daea5-7bd3-48fc-9b94-c3ab94f6f1b4,Geryl,24,19,100,70,71,87,371,
4a333a83-e7e1-4290-a43e-d4243e14bbc5,Gesenia,22,80,42,95,14,44,297,
7c8cc03d-e63e-4a2c-ad13-dd64abcf61b2,Gessica,11,43,41,99,70,7,271,
ecd7dd0e-82c3-469f-8d5c-b848d08cd207,Getzel,22,55,29,18,55,82,261,
15a27aa9-ac13-4ecb-a6b6-8632d832cc5d,Ghassan,22,24,36,95,42,86,305,
0f2ae1ff-0e57-42f6-8eb4-264b60630150,Giada,53,65,48,77,51,57,351,
02e17315-ca0b-4131-b755-2def45648ed4,Giana,21,55,73,59,27,31,266,
5267ed5a-5733-431f-9fc3-de2f079d2e59,Gianella,31,20,32,62,11,10,166,
065f8161-144c-4096-955a-818a9e4b6ee5,Gianelle,86,95,96,33,53,42,405,
8188fdb0-2969-4f40-8d38-015490c3caf7,Giani,26,36,48,93,0,56,259,
2b4429e4-5e2f-4c6d-9cb0-c133e6953331,Gianluca,46,52,89,61,59,50,357,
affd363b-5de4-4019-b4b1-9926d735fd6b,Gianlucas,82,20,29,91,76,3,301,
f0142df3-9c05-4bb9-b510-a98e68143560,Gianlucas,28,23,71,43,74,45,284,
067223d5-7e5f-4082-be1a-a15bddfde3ba,Gianna,55,37,71,48,53,58,322,
9ccfe705-d15a-4b4a-9f20-6f5f213e0698,Giannina,33,98,33,65,51,98,378,
6a05a1bb-b137-4008-9ddb-0a34321b14c5,Giannina,0,2,44,57,58,18,179,
992a332d-02d8-45cf-85b1-622d469f7685,Gideon,9,45,38,78,14,36,220,
a4a13526-8e13-4e7b-bc26-29903a907d23,Gil,48,37,41,51,30,37,244,
8708094e-aa25-4862-a119-335d044d9182,Gilad,16,76,14,82,41,10,239,
77dfc0f8-d1fb-4b83-a5a9-3de30adcec6f,Gilverto,43,4,100,70,38,99,354,
e63cfb42-044d-443d-99c9-dab1652d08bd,Gilverto,71,57,48,60,3,1,240,
5388f20f-d0ea-4ae8-b1e0-56c86ce3cee5,Ginelle,76,35,42,98,82,73,406,
08fb772f-a018-47d3-8cb7-89a90810efe3,Gini,34,47,92,91,91,63,418,
ae159c4d-b656-4a6d-8e7b-67242abe1b82,Ginny,13,11,87,93,0,86,290,
df95d9b5-92b8-451c-8dbd-0432435f486a,Ginobili,100,22,68,40,66,94,390,
8c9fcccf-a04f-4228-aa7a-b6946a5426fd,Gio,80,43,78,47,57,21,326,
6bc18f01-5d85-4e68-8192-5fc5a03f06f0,Gioia,80,71,74,38,52,55,370,
79f50ee2-eed3-451d-90f3-5a850da5abc6,Gionna,80,23,88,93,24,82,390,
cd3a62fa-3c7e-4e00-a04b-86f797a51127,Giorgi,32,35,37,14,24,79,221,
565e8307-b8c3-4c83-ad48-cd128af5d606,Giovanna,61,86,78,12,59,19,315,
26b3fbb5-520f-4cf5-8ad3-aa9afef1b93a,Giovanni,49,73,23,42,65,68,320,
8367c200-69c7-4f76-8cd5-8592fc45bd7e,Girl,37,46,78,2,74,68,305,
f152175a-6bd9-46d0-8e2d-f08fb618fb37,Girtie,96,58,25,27,87,79,372,
0a84945a-040d-4c4a-b242-262003f7578d,Gisel,23,88,11,86,39,72,319,
1deda219-e954-44c1-bbf9-3a3134f6d46b,Gisele,91,34,8,35,69,63,300,
66a961e8-09cf-4e99-9356-f5d949179f27,Gissela,67,18,46,93,41,2,267,
36e14786-d806-4207-9e85-89f684d3ef1c,Gitty,76,71,79,95,22,14,357,
91193517-3f34-492f-aefb-aa6ef94c5bfc,Giuseppina,18,77,19,46,7,55,222,
0aa56822-7fcd-42e0-92c1-f7eda4f32c45,Gizel,29,52,20,47,3,47,198,
78c69f73-db03-41aa-88fa-0b5bba52b588,Gizel,59,50,67,45,61,18,300,
907fadbd-f0f6-404d-812a-972f10e1eef9,Gjon,34,34,42,52,32,77,271,
8abe6c83-24f3-4fdd-b34b-ef59b970846c,Glade,41,63,7,85,76,10,282,
c9f261b7-1471-4e0a-9db6-98ea03556344,Glade,46,16,71,41,7,91,272,
ce5d6046-afcc-47d6-82a3-85479b46dd28,Gleen,88,36,15,40,10,88,277,
39be92ff-18c1-48d7-a699-5c1dde2de797,Glenadine,7,96,9,8,1,15,136,
30580b19-c90e-4dad-ba38-0d9cfc2c324b,Glendal,92,62,12,64,36,61,327,
1b345061-d228-4dfb-935e-4dfbc2a19b0f,Glendaly,58,77,74,86,47,80,422,
0ebddee4-3e3c-497b-87fd-e39fa228a1b2,Glendel,51,61,95,31,32,99,369,
96ef1188-5271-44a9-ab08-2acc876eb56f,Glendola,60,0,39,97,86,92,374,
fb9c5df9-6a6f-4915-950c-89012954f8ae,Glendy,80,18,83,68,82,34,365,
8955bfcc-3e4d-4cce-8358-b415004c5073,Gleneva,88,23,10,43,59,85,308,
6e4e81a1-7278-492c-98d9-44a79b414390,Gleneva,98,49,8,14,41,84,294,
ed4a140e-bde6-4a25-879d-2a5052b0dbdd,Glenford,51,1,71,20,45,64,252,
a437f45e-d2d4-4460-865b-941503b1ee7d,Glenford,90,62,30,49,16,71,318,
2ac9d885-fdda-4dd0-b259-c5e58047ca9b,Glenice,59,37,13,92,83,20,304,
b732cb0b-fdfb-41b6-9280-2f661f922b2d,Glennda,66,10,65,45,71,46,303,
275d7ddc-f00a-4e2a-a118-19bda60d5330,Glenston,73,95,24,27,0,98,317,
07b21ff6-dd16-4a6d-a63b-f7d78e14b618,Glenville,35,8,98,54,51,20,266,
875ceeb1-a361-46a1-b11e-32551dcf0e5b,Glenville,61,9,28,47,67,60,272,
e078ce66-9b9b-4f8a-9a8e-adddb2f421ec,Glenys,3,1,45,93,28,61,231,
ee31052a-2ed9-4c1f-b108-faf9f0497c5c,Glenys,95,32,18,4,23,98,270,
11fe938c-49de-4897-b152-ba17b9895ddf,Glinda,67,87,3,91,72,0,320,
3b95cd32-8f4b-4bbd-8ba9-989191a686dd,Gloriana,88,47,32,23,22,6,218,
cfefd8dc-bbb4-4fe1-9907-5b33bb488fd4,Glyn,8,3,89,31,61,34,226,
49a22a37-bb93-4636-a197-3c8ce293bd03,Glynda,18,54,28,99,94,29,322,
7e1c728c-b7fd-4f68-a49f-5ed5da511b36,Glynda,59,10,84,63,46,30,292,
d5958314-4b95-4224-b2df-18bbd0b12a80,Gobel,27,61,4,95,91,86,364,
4767ea07-3093-4bba-9996-aabfa2e0e7d3,Godfrey,52,87,77,58,4,92,370,
eb956c29-e1ab-424f-ba83-aa954a052fb8,Godfrey,94,96,51,8,27,40,316,
e3207ced-7c90-4af1-bb66-a0b2b81159be,Godfrey,10,90,56,62,42,66,326,
7673f9c5-20bb-470d-90d1-47ded8e07960,Godric,86,80,62,91,33,72,424,
62af3e18-835e-44bd-8e99-757d0de93cc1,Godric,74,60,86,57,70,1,348,
8815ec8a-4650-40a8-95f5-908c2675e385,Godwin,41,52,56,7,77,30,263,
837346d6-64cf-4e72-96dc-67d31211adbd,Golda,3,8,14,26,22,17,90,
51344b48-6171-4608-9e55-93c88e14eac6,Golda,32,86,77,6,87,53,341,
9db8ce18-0ec2-4348-8077-d128e8292106,Gomer,78,23,0,33,92,43,269,
f2f2bfce-12f0-47ef-8716-dfce60f7b071,Gonsalo,51,80,72,98,19,2,322,
dba986af-10b3-415d-98f7-380cfc4e1c77,Gordean,40,49,76,8,34,80,287,
c8de9cf6-1784-420e-adb8-9acb4255736e,Gordean,87,75,11,15,17,61,266,
03b9666c-68fb-4ded-9223-f4c7c7d486ed,Gordie,92,14,74,43,26,57,306,
4f9ca759-ecec-4e67-a1fd-8b8ed336ee1c,Goretti,85,39,43,35,31,38,271,
0137155a-4c01-4c0f-8128-6a96320c0481,Goretti,87,3,92,88,41,62,373,
3a337a22-c1a9-4338-b516-ce4b3e90f7e6,Gorje,37,19,96,75,88,6,321,
cc0c43a0-5de7-4999-a14d-0a90398a023a,Gottlob,61,78,82,21,82,57,381,
fb2eac09-bc05-4d5c-899d-e01f258280b5,Grabiel,81,53,67,13,99,39,352,
804e6be7-973e-4127-a1bf-b93f2b26aeb0,Graceanne,13,24,13,65,41,53,209,
6df6e7c8-b098-4330-9d67-f87e050facaf,Graceanne,6,94,61,96,20,27,304,
b8b5ef14-2ce5-4a0e-81d2-859df2dfceb7,Gracee,77,56,53,5,89,1,281,
6fe1b264-2908-41bd-b7d1-6b6a6063218f,Gracee,21,15,13,29,58,10,146,
ca80e0f1-29a4-4019-9030-0319c6581781,Gracelynn,96,75,2,100,50,6,329,
d196f6a0-04a8-4a1f-91a0-4be9ba180f1c,Gracey,14,10,68,67,88,92,339,
dd768b30-0e83-4d28-9615-26baf7423a30,Graci,38,99,21,99,67,60,384,
bf8574df-e7b0-447e-94f7-8cf1f3734930,Gradyn,51,10,46,97,71,94,369,
8ad6f67d-f8c6-4eab-b35c-7dc46034b42b,Granger,62,11,66,83,67,62,351,
eaddee3a-7b16-497d-9c33-d2174155ebdd,Grant,12,9,23,85,61,87,277,
08b3fcbf-9e8c-45d3-871e-428aafe60a37,Granville,20,9,72,66,76,51,294,
d69d7031-fd4b-44b3-8c7c-23aa56c085b2,Gray,59,78,97,18,30,68,350,
c47d72c6-9d25-45f2-b33c-afb9abc424f2,Graylin,16,52,86,77,39,69,339,
4124c1b4-0d4f-42ab-918e-4bc8fd944281,Grazia,60,26,71,85,70,75,387,
bb2fe0b0-e37b-40e5-b8bf-c3e9b9cb98a0,Graziella,4,100,3,52,80,19,258,
a1d67271-5361-4a74-a7e1-e419d156a9e4,Green,38,93,17,48,63,37,296,
d3cc1ed5-26f3-4e2b-8f33-a9f3ef2d1cf1,Greer,84,34,37,97,9,40,301,
a27d7bfc-7dd5-47fd-ad21-1f725da4f286,Greer,21,79,37,6,16,38,197,
fba7bebe-34a7-446c-9552-e95a8298f75d,Gregor,58,80,30,67,41,37,313,
ec2bada6-fa28-42ad-958a-efdcb6f3409d,Gregoria,19,40,58,96,17,35,265,
8e8ad9c6-28dd-414a-9c57-1326c0613825,Gregorio,7,16,29,22,13,51,138,
13896319-c46a-40c6-8419-301266f696cf,Greidy,17,84,99,5,4,28,237,
32878c11-d33d-4523-9d04-f1881104ecf5,Gretta,100,58,77,55,97,97,484,
f5047734-944d-45d7-a8e5-7d67ac8540e3,Greyson,22,68,21,45,24,54,234,
dbc25d2a-e3cb-4292-91b5-ecbf834d3112,Griffith,0,28,13,69,81,33,224,
93f57f0b-e496-493f-9f4d-c1e48b50081d,Griffith,92,95,42,87,13,46,375,
53d15564-4b02-4737-977a-f608148426e8,Grisel,16,36,44,30,19,91,236,
14ac4530-19c9-450c-af20-9b3f89f35467,Grissel,44,71,35,15,84,81,330,
3993dcce-d373-46a3-b2c0-3ab3fcc727f8,Grizel,57,99,48,71,21,93,389,
9f8d2548-15eb-4a3d-bd0e-ca35eaea44e0,Gryffin,48,30,10,9,75,71,243,
5036db1a-ffb1-4982-9daa-e51f2ab2a937,Gryphon,67,61,86,94,74,74,456,
2dd74ea4-aba4-4e85-9d44-c5001eb0d2e7,Guadelupe,1,42,95,97,57,93,385,
fa0f5c04-53e4-4b99-a76e-e3b7b57552e4,Guido,57,27,61,79,34,87,345,
5240986b-5017-4e0e-918c-341c117fb854,Guillerma,100,45,3,3,75,82,308,
12b4d31b-368e-48b7-9e93-2fa52dacec8f,Guillermo,98,56,31,68,25,30,308,
61e5f2b7-6ab9-4dfe-a47d-58ad3cf30c45,Guinn,45,89,57,45,90,98,424,
73b5bc79-0c6a-4801-8de0-947d92115e0c,Guisela,68,35,74,50,16,11,254,
f83cd33d-a4cf-44e2-9bda-4e6819abbed4,Gumaro,71,81,53,59,78,12,354,
68d59960-8add-447d-8bff-a1dad8f73990,Gumecindo,29,88,100,54,80,75,426,
7a2a532b-fbea-426a-ba62-dcad655a647b,Gurkirat,27,13,84,60,17,30,231,
2b793502-922b-4c70-bd9a-ecf906411773,Gurney,93,96,21,48,77,8,343,
325f324e-1c79-4386-a062-38b0b900327a,Gurney,30,66,94,69,80,46,385,
08d2821a-2901-40de-a052-704d252caa8a,Gurnoor,7,52,62,48,23,61,253,
90b11708-4d95-4cb9-90ea-dc081660d044,Gurshaan,92,8,66,60,33,62,321,
a8dac95d-9df0-4e0c-ab4e-898c4f601f96,Gurvir,2,52,14,86,42,73,269,
cda1a662-f22d-4178-a9c7-536d166aa80e,Gus,21,67,37,93,35,91,344,
2252214c-af3c-4d09-ba87-28ef12337b1e,Gust,91,45,91,8,68,60,363,
e2de0641-871a-447b-9ceb-667480e385a5,Gustav,17,47,9,26,76,60,235,
805fe566-5e2a-4a9b-9cba-38d04b9746ab,Guthrie,21,34,90,28,98,49,320,
89b8815d-debb-49aa-a007-e8d7c83e1202,Guy,45,10,2,49,58,29,193,
54dae49c-b1a8-4a8d-af47-dbafdfb353dc,Gwen,77,1,41,55,20,29,223,
b3a4b304-9cc2-4536-8522-6a08dfc482b4,Gwenda,66,48,4,31,81,29,259,
48e592bd-8020-47cc-a544-121462681f71,Gwendlyn,48,18,19,36,69,61,251,
e1abca44-96c1-4b66-b211-890c9841dbb3,Gwendlyon,27,32,44,71,53,11,238,
78632ea5-fc28-4fe7-9796-21d12026c65c,Gwendol,11,100,75,80,63,73,402,
5c4f97e7-ab1e-40b0-83b6-8a3bb67a5f93,Gwendola,9,98,95,59,26,58,345,
936d2d5a-d262-40f5-9ef7-1c34a63cb688,Gwendolyn,3,90,87,85,91,22,378,
1b708d2d-35ad-4189-af88-bf274657877c,Gwendolyn,77,7,75,98,24,24,305,
ccc9132b-009f-45e9-a450-052420c9895b,Gwenivere,28,85,52,77,26,36,304,
92d19f76-9da7-468c-8dfc-9e1fa60a34a2,Gwyneth,47,41,40,47,23,48,246,
1c74c3ea-2a67-4339-8ccb-f97e586b7108,Gwynn,87,82,17,88,68,86,428,
06222f71-1b40-4c3a-9ed3-e35cc83afead,Gwynne,59,91,66,66,63,83,428,
b70a01b6-157c-494f-9a14-f6c5ffd301aa,Gwynneth,4,90,5,63,43,66,271,
c75313a4-b957-449c-9ff7-d2b1ce264104,Gyanna,50,25,92,98,36,53,354,
5f9c5731-a77e-4ddd-b33b-eeec8d801c4f,Gyasi,98,59,94,54,92,94,491,
5d126b28-46d9-44f0-8632-176ce80133b2,Gyasi,16,39,18,67,22,36,198,
90030906-14d3-4b20-acf2-1c61027778e4,Gyselle,17,29,78,36,59,80,299,
279c5d1e-083c-4f66-8c47-fdcda5cf7f2c,Ha,52,46,94,96,20,66,374,
e10fd1c7-a4a4-48fb-abe0-d2f84aa9f642,Habib,50,28,95,6,37,85,301,
438b1e77-1621-4412-b562-b9e8d04f8cc1,Hachiro,77,47,60,92,20,72,368,
4185c5e3-99aa-46a9-b68f-50e4ebb3cae8,Hadar,44,46,96,0,84,10,280,
6bb0eee9-03e7-46e8-bd17-0287930c6bbe,Hadasa,55,68,4,96,40,14,277,
ff4d440e-e08d-4590-99c6-75850eb80371,Hadeel,74,27,82,67,90,74,414,
3b01a1d8-a390-4e4b-9544-6da549122713,Hadeel,48,16,68,11,13,100,256,
da141aee-b319-4365-9c78-6af49b20ce90,Hadja,37,90,69,47,44,40,327,
ca9724bf-8834-4782-97b1-83812aa49787,Hadlee,10,90,75,41,1,32,249,
c12f8f41-786a-42a7-9b2e-2c50385793da,Hadley,35,27,29,18,38,15,162,
7a046e12-dd9d-4bbf-aa08-af32ba4eeb00,Haide,38,100,33,79,83,91,424,
345a43bb-c6fa-4ac3-a47c-3d0f849429c4,Haide,81,92,72,35,26,22,328,
b8711686-1bae-4390-9694-fc899f2abb20,Haiden,13,43,63,29,79,53,280,
3e38abc4-8359-4b5f-a46b-f1e239b9d63c,Haiden,11,88,75,19,41,45,279,
7c10692c-61e7-45e9-8701-7a9a58195c13,Haidi,70,50,5,40,16,76,257,
7daa9082-8688-4fc4-a10b-30088717cfff,Haidy,28,45,16,56,79,61,285,
58f52d10-3dd5-412b-a23f-35bd774f7318,Haig,43,70,92,59,3,77,344,
23d089e6-3f79-49ae-bece-9be4de6a0331,Haig,22,96,86,29,13,15,261,
72940076-b1a0-4188-ab1f-5d0a8d4d239b,Haig,34,16,25,8,18,33,134,
85cc1346-c2e0-44f8-8aa4-94e18362c7d2,Haik,46,37,77,28,15,56,259,
ac86f75c-35d6-49ee-986e-13bc85a4b700,Haik,67,46,34,40,62,59,308,
8e67b7e8-87f2-49af-89bb-4a012265693c,Haile,13,0,87,53,44,93,290,
9e2de54c-b4fe-44e0-a04a-e727e6353d60,Hailea,15,64,32,23,97,97,328,
5a30b3e4-f2ce-4351-87ad-084124db31f5,Hailei,44,79,16,1,39,31,210,
2fa9ccfc-bbc2-4079-a8c5-76a4cebf1ae3,Hailie,72,91,84,7,3,34,291,
ceff44eb-72b0-42a3-9a39-77dfeb731b88,Haille,80,86,42,51,2,83,344,
9965c942-355f-4d5b-ac6c-78ad8a8aaacc,Haille,37,83,65,26,36,90,337,
ecc6e309-77cc-41b8-a448-2d3c2bc015d0,Hailley,50,15,52,52,35,42,246,
1f7dfda1-c7c9-4b3d-a0d4-326012b027ed,Hajra,30,56,22,20,25,70,223,
66815f15-c014-4abf-8654-9de458b3de9e,Hakeem,43,71,100,60,51,99,424,
cfa584da-536c-426c-ac02-7bf88795dd53,Halbert,83,7,60,51,56,14,271,
14bd615f-859d-4f3d-af45-038753ef18f3,Haleigh,56,20,68,68,79,99,390,
c2f74bf0-53ca-447a-b29d-46a4ec247eab,Halie,1,4,38,95,45,36,219,
7cb659d8-4393-4dc5-b9c7-5943dc92332a,Halima,38,89,94,9,33,71,334,
88b14d86-1f53-46eb-862b-10d2aa70b093,Halima,72,73,29,64,11,75,324,
63266930-5d87-4f97-a7e3-06b06036d0ac,Halimatou,80,74,99,34,100,39,426,
74c42b02-5be1-4057-8bda-e2248343a16a,Halle,80,51,85,84,86,80,466,
67a64cd1-f7ed-475a-9d12-d9ed0d774a43,Hallee,36,88,75,98,46,87,430,
7509e95a-e3a6-4c66-826a-a5917e21f440,Halley,98,25,58,10,71,89,351,
f466e0a3-0a44-4d9b-9dce-2bcb7acd36ec,Halley,1,64,56,31,69,56,277,
db9b9e00-700e-46b9-bf35-44f86dfd2f29,Hally,43,92,47,29,10,100,321,
0621801b-2a51-4733-852a-e5b5dc8a7ca4,Halston,85,90,19,89,9,89,381,
472dc5c4-2bed-4dfa-ba6d-408a023b1d13,Hamdan,3,54,49,54,74,88,322,
f2dd31ca-26e9-4006-b14e-32b270a9208b,Hamid,26,90,60,62,21,24,283,
b4464955-0af5-4b94-92c8-645773d3af7a,Hamse,15,14,49,100,42,9,229,
fa3a2eca-f017-4833-bca8-2ea505ba07ca,Hamzah,95,73,98,57,63,38,424,
a44cf7b4-4cac-4484-9cd3-3f78b2c84312,Hana,88,69,47,27,1,80,312,
5c8e0d3e-c6d3-4023-9305-fe74c4e777bf,Hanalei,84,53,16,16,37,49,255,
dc6fd3f2-ab03-43d4-ade9-4feedc287d06,Hanan,39,39,98,98,98,1,373,
b927ef13-97b2-4b16-a312-2708a5273c5a,Hanh,26,9,57,86,57,77,312,
c0c1b6f4-cf06-4662-8781-fe739cec9d8f,Hani,71,31,5,6,35,22,170,
844897be-25c0-4366-ad71-e5ef395a2b29,Hania,19,13,14,45,6,61,158,
dbcbf8d3-1076-40e0-9e18-3feb5bd6086c,Haniel,12,94,24,78,35,74,317,
217ce61f-bbf3-45ef-954e-715e27a5b2b7,Haniyah,76,38,41,95,57,81,388,
bb45ac72-7117-4602-92e9-9266e83ab8c3,Hannah,4,88,38,51,69,23,273,
a49b3e9b-b73f-4b5f-9a97-22808b38d52d,Hanny,9,93,58,72,70,38,340,
0a5d7b2f-738e-47d7-8727-0578fc695fc3,Hanny,72,96,18,83,16,84,369,
9875b4c2-0687-4348-92c4-d65f70058e1a,Hannya,28,39,11,13,99,84,274,
7f2c0f50-4e3c-4353-b5fc-c81fcff995ab,Hans,97,54,84,73,4,72,384,
524b9b74-c69e-4bab-a38c-4d768aee686a,Hansel,8,73,54,66,71,73,345,
018b6b14-9a1c-4e88-925e-f71ffcb86b2e,Hansen,7,74,29,74,96,8,288,
ace85c13-d049-4938-8684-b9c2551f28dc,Hansika,42,6,60,13,66,84,271,
8d972b0a-1b01-4818-80c2-f3f782c8c4da,Hao,96,68,3,56,86,93,402,
b2a51b35-d8b7-460e-b24a-ad99a2ae9995,Hao,34,43,43,62,74,69,325,
83154160-f73f-4346-ac6f-fa30396a3015,Haralambos,27,100,27,29,67,81,331,
814921ec-a182-416d-be3a-17e62379d6b6,Harbor,76,95,58,63,98,10,400,
aca656b8-aa83-4b2a-8c03-ca276bf349bb,Hardie,34,44,78,45,7,27,235,
a8364a03-0da8-4173-a0ba-01a43f9c2314,Hardy,41,46,8,75,13,8,191,
ddf09f04-3d3b-499a-b11b-a18aebcf6c55,Hargun,91,92,38,55,86,27,389,
70a6d3ff-86a8-49b0-917b-53fedb1d17e0,Hargus,99,0,63,27,92,56,337,
c86599a1-f683-44a1-a59b-7a068fcde705,Hari,8,39,8,93,22,37,207,
469abacf-cc02-42ec-88c9-37bfa2cb982b,Haris,100,98,27,100,42,24,391,
5d36767c-62bf-49bc-89f8-897f76027ca3,Harjot,42,86,41,27,14,25,235,
cf6cc9f6-edbc-4ec8-b6bc-6270ed79c0a6,Harleen,64,11,53,35,85,51,299,
962f7aec-63a3-42dc-9e48-0c3dc8e546e2,Harlie,63,81,98,68,55,10,375,
43fd59b5-816e-4256-8613-fac5eedbb3ad,Harlow,58,23,90,47,36,16,270,
1416514c-e7f1-47e8-8324-86716ef5d420,Harlynn,80,11,95,46,2,52,286,
4d88224c-a9b9-4db7-868f-35558db75c18,Harmonee,80,20,96,72,15,12,295,
9430fddf-fce2-4def-b441-54a86ae504e1,Harmoney,74,87,38,99,35,29,362,
5ac024a5-81cb-4f5c-a041-70798a96d2af,Harmoney,84,9,67,59,69,43,331,
57269504-5066-41b3-9bd8-de78162f0c0f,Harmoni,28,68,0,88,2,6,192,
8a65f1e4-d112-48c8-ad6e-3e41d61ddb44,Harmonii,41,15,51,81,92,11,291,
5706988f-4712-495b-9980-7a816221cf77,Harmonii,22,19,72,6,75,99,293,
2182bfd0-e403-4e16-bdba-8c9599bb09e6,Harold,31,95,83,20,44,72,345,
a61aa8c6-f730-4bb9-a562-a00afd85c517,Harpreet,35,64,88,55,40,41,323,
a3ca0b85-b169-4b6e-b304-6a7f5191719c,Harrington,1,65,98,15,57,26,262,
c0ecffb4-5b97-4ee7-84af-61fe1d4de056,Harris,59,69,47,27,20,89,311,
53470477-3187-48de-9e36-6f4efa0ee136,Harrison,73,85,16,44,67,67,352,
1b82bd57-3066-4b76-a0da-9f82ab388d17,Harsh,0,85,52,38,2,49,226,
22878630-c036-4224-9b34-89e50a3c0643,Harshith,60,35,39,79,4,51,268,
b4ac2c81-d728-4014-817b-36745ad75dc6,Harshith,69,6,37,28,98,71,309,
3340cbc7-65d1-4d56-b463-b58a5bfe0176,Hartley,58,23,45,91,0,47,264,
c726e3c6-d696-43b8-bd11-8aa0e1a95b03,Harumi,56,46,2,56,11,40,211,
d84a7266-d7d1-4be1-9601-7307005e4fda,Harveen,70,39,59,13,57,26,264,
783ae8fd-20ec-4670-a39f-a820b34483cc,Harveen,92,98,14,22,32,36,294,
a3b8482f-c514-46e8-a157-77698b26d243,Harvel,87,26,45,29,64,12,263,
cab16464-b1d3-4346-afb6-1e3458b0b8c7,Harvie,20,16,69,15,77,90,287,
a947f473-22f3-4283-a285-32785a38089e,Harwell,28,8,74,85,52,53,300,
473d19b7-4130-41b9-84b6-174b6559cb7f,Haseeb,22,90,62,36,88,0,298,
06fe1e72-3696-4753-8b31-4810774b4621,Hasini,22,91,13,60,96,2,284,
9ce462f7-2f1f-445a-ba82-b62cc24714e9,Haskel,63,82,50,72,7,58,332,
e7372f0d-bbf7-4edb-a37a-3663180c9e78,Hasker,67,8,89,2,13,9,188,
0ff2eba2-58ea-4218-b947-399c60a4d083,Haskie,98,76,44,7,98,70,393,
894cebd9-6de3-4e87-b6cc-56ca0db45f40,Hassani,85,33,77,84,62,39,380,
9526240a-3c2f-44f1-af19-3790f5752c87,Hassel,19,72,56,65,96,44,352,
d4746d5d-2af2-4044-9485-b64b32dabb1c,Hassell,1,21,58,36,99,14,229,
ae0116f6-9df6-426e-ac0e-ce8d0d62a5a9,Hatim,4,78,81,11,88,77,339,
eb640203-9cfc-4f6c-895b-a21ce1e07607,Hatsuyo,87,28,17,98,29,19,278,
c102a31e-bed0-43d6-9bdb-5bfc2f1ef3c6,Hattie,39,13,8,44,45,42,191,
86ed1169-7753-465c-a931-0cab4d297e57,Havana,37,73,87,90,27,41,355,
cc4d2cb6-a39f-4e0d-9c88-3afa65052dc2,Hawa,68,5,13,25,76,21,208,
d25696f5-db5e-4289-b494-8e50870a7aa1,Hawkins,1,34,43,20,67,76,241,
e1986c33-8860-40b2-a4fa-3973dd218e1f,Hawkins,41,5,19,73,14,8,160,
600518cc-3687-4937-9748-0bea9b217a2d,Hayat,26,21,35,70,45,27,224,
e57e79d4-f308-4f8b-824d-5097272554e0,Hayden,82,34,13,34,69,53,285,
36738280-29fa-4df6-9487-02fca39b9c11,Haydn,1,42,6,57,6,72,184,
cc6ce335-0d61-431f-86a4-5883ce43b2c4,Haydon,77,69,65,33,98,52,394,
383e76e6-6c51-4c25-a033-28efdabacd1a,Haydyn,70,21,34,1,38,54,218,
2e942f3c-adb8-4b72-b319-530aae694f0f,Haygen,51,42,90,42,27,43,295,
d2c83f2a-bf2a-4a08-80bb-f2a8604ced14,Hayle,22,18,11,93,72,16,232,
c4d03a1f-df14-49ef-9c5c-996cb69f0919,Haylei,43,80,38,8,49,92,310,
f54d5e57-a2e9-49a3-abf9-6d070ebc4e57,Hayleigh,57,91,38,34,22,67,309,
55a9a4d9-441a-490d-b56a-448a9faed657,Haylie,90,87,33,37,40,39,326,
44ad9c4b-3bf6-470f-97a0-a23df53b2d57,Haylin,2,89,67,4,46,37,245,
e8916b02-a245-4842-bafd-aff73f1105e2,Hayward,46,25,41,69,2,96,279,
d78c81b7-f93e-4693-9b35-2cfbfc8c885b,Hayze,38,73,87,33,12,46,289,
a0d7e497-acd6-46c4-ab90-cc20f990ade6,Hayzel,94,86,24,8,97,64,373,
cbecf422-e826-4443-a02d-6b219c968262,Hazel,60,10,82,34,31,29,246,
d8cc575a-2973-4c5c-b6a4-eb2633a21ea0,Hazelle,82,49,80,92,8,64,375,
ed53e97f-897c-4939-b6d8-7cde544e9ceb,Hazen,9,53,1,55,85,26,229,
60706930-2391-41ea-9e0e-bfbe38d87bb2,Hazen,73,27,89,94,49,85,417,
7564acb7-27be-41e4-92b8-62fb22058ee8,Hearl,1,53,14,25,31,65,189,
c67bf685-1853-4a13-a41b-9c5ebd47a640,Hearl,60,96,53,13,99,45,366,
c63dfd71-1a75-490c-bd9a-0953f2fa37e1,Heavyn,47,88,29,74,49,93,380,
d01aadea-9d84-47fa-92ca-9653cf57c6af,Hebe,46,100,18,22,19,22,227,
31bd8681-4f52-42e8-bdee-99bc4fd26298,Heber,34,97,3,67,83,3,287,
62eda61b-a9e9-4668-8efa-6af4bedbfa69,Heber,93,50,45,99,38,76,401,
f81cf331-7b28-4c01-8d20-2a94062d211a,Hebert,84,21,91,73,61,64,394,
5465c1ea-871c-41a1-8992-085eae7b68f8,Hedda,16,99,61,72,12,93,353,
a2d4a7d0-4bc5-46ff-a7b6-533df7369416,Heflin,90,47,55,98,99,41,430,
9314d946-f1de-4b00-af69-a2e3774e1735,Heflin,92,69,54,78,89,97,479,
8cbf9340-67b7-4265-ba10-add1e1d48c80,Heide,59,3,47,16,7,66,198,
b485d37f-617c-4ad7-b992-5d4822f302fd,Heily,2,22,13,11,49,35,132,
cd16613b-8f49-467d-ab0f-952a9ba33f1d,Heith,18,79,20,31,71,35,254,
178e8eb2-ba75-48c4-9a50-def221aa7883,Helaina,10,46,34,100,19,85,294,
217de03b-4925-48e6-b8d7-71baa59c75f2,Helaine,84,77,57,83,47,27,375,
19dcd0d5-22b8-440e-88d9-9a5cc2205171,Helaman,53,87,68,48,28,34,318,
36acbf93-d848-4bc3-a50c-61cee52c0357,Helayne,81,87,0,100,64,35,367,
00569ab5-6296-4c81-8e95-f9b78e4bd839,Helena,1,14,92,38,78,82,305,
f470fe02-c099-4773-81db-31454e22d52a,Helio,100,1,72,89,3,13,278,
cc4d6d3d-652f-4f44-8ece-7cfab7b9d5f6,Helma,31,10,90,14,100,50,295,
50602377-596e-48b7-84e5-fad1f77aaa68,Helmer,39,85,64,41,98,23,350,
f20bbe23-de87-4086-8c92-653e557fdceb,Helmuth,81,33,36,7,9,74,240,
5912b623-d74d-45fa-abdb-cf193d60a61c,Henderson,8,15,62,71,89,58,303,
bd0a4dc9-5f16-4214-abdc-f57170a0055b,Henderson,12,66,34,86,54,99,351,
91111709-af42-44aa-a571-30969d35c061,Hendrix,40,52,100,39,5,18,254,
19d50741-6e10-4cc3-bc08-1fe55a61575f,Hennessey,56,76,59,65,28,90,374,
4540b496-362f-4d4d-80c4-3cf56b1d7afa,Hennesy,60,41,20,80,22,18,241,
bbf0885a-507c-4a1d-9592-56e3834fe8a2,Henretta,21,2,9,13,17,0,62,
49c86212-8c3a-40bd-af3b-bde6fef626f5,Henryetta,45,16,32,69,78,72,312,
c488fa8f-ad84-4736-be99-2525485e46dd,Hensel,58,87,77,60,61,14,357,
f4d9bba5-ac77-4ab6-897a-cf2397841a69,Henya,34,55,96,20,18,91,314,
4aff8894-2add-468b-90e3-dd66bbfe6d19,Heraclio,95,6,18,22,18,33,192,
598983f7-ef0b-41a3-afc5-41b64da4d7c4,Herald,98,80,14,79,84,19,374,
1b1140fd-1aa3-4294-a5da-df1756125551,Herber,95,0,30,91,11,87,314,
592828a3-f9e6-478a-b921-51cc72f23171,Herbie,4,56,34,54,33,75,256,
8a992851-275a-43f6-870b-c4c517c6d35a,Hercules,75,38,71,74,77,25,360,
58ec714f-fdc6-433d-898d-389bbd3f95fb,Heriberta,94,23,57,86,52,43,355,
050953e9-bd83-4ef3-b1e4-7c78ed73ae97,Hermann,96,92,1,23,85,44,341,
0a0cd84e-8d4b-409d-a5a2-ec807cd9aee3,Hermina,87,79,23,59,69,71,388,
20038bcb-aa9c-40c0-9172-1acdd798c24a,Herminia,36,58,6,20,53,80,253,
005884f6-ce4d-4ffd-b11e-3f47db6f16c4,Hermione,78,81,49,57,73,35,373,
47b89de9-f098-45fb-83c6-6ab543f6b37a,Hernando,47,74,90,49,90,97,447,
bcb313d3-9eb7-4e9d-a7ec-37b9bec751ea,Herold,58,54,98,34,47,77,368,
5295e702-f798-4c2c-8548-3d86afa983b8,Hersch,47,28,25,97,55,48,300,
1779b10d-0f93-4b5b-91ee-1734da73eb6a,Herschel,10,38,12,41,50,28,179,
ada29e7b-97e7-412d-9aa0-05c5bdf8b961,Hersh,1,57,95,49,53,43,298,
53febddb-3998-4d46-b8ef-92cce4ca3e77,Herson,53,86,3,45,12,58,257,
2196723f-205d-4160-bef3-da69a48a7868,Herson,50,95,46,43,72,9,315,
5b77552b-3542-442b-995f-1e46e8ee2e41,Herve,56,10,53,88,0,93,300,
7546678e-508b-4515-b6ef-e2adcdefc8b5,Hessie,35,48,18,42,67,1,211,
23982454-6110-40cc-83a7-4e262d58bc76,Hessie,11,99,49,13,56,17,245,
ea6d6074-66c2-436d-a8d6-838fa01d43de,Hester,97,88,47,31,50,46,359,
5662d0dd-0b58-4085-980e-8c359ecfa098,Hether,90,41,34,47,48,69,329,
362b48cd-eebc-4d2a-b1e7-71387e684b43,Hettie,84,71,5,96,60,91,407,
f01a5db7-9893-40a5-a9ab-415f186eaf2b,Hewitt,4,34,74,4,59,19,194,
b00276eb-e721-4534-bb85-fd411ed835a5,Heyward,72,14,85,26,27,74,298,
d46f55ce-6b2f-47b5-a413-106e3512d87a,Heywood,19,90,64,44,72,34,323,
2f9daacc-e111-4450-8fa5-59de6179100b,Hiba,79,46,88,15,10,92,330,
36f13522-b26f-4d34-a55c-5bf424cc45e5,Hidemi,73,93,35,63,65,7,336,
e613e455-fe26-4ed2-9142-a474edb0e3d8,Hiedi,23,52,88,11,14,94,282,
dfe28965-5972-46a5-a594-c60ba0af3142,Hikaru,32,33,72,69,86,51,343,
18c8ca79-e77b-458d-af38-b524d7c84570,Hilaria,42,71,88,20,45,69,335,
8edd6a08-3a83-4515-9684-f906ac7fe1d7,Hilario,44,48,75,1,18,65,251,
7c4eb0a4-f517-40d8-83ee-2c9911acee0e,Hilberto,15,97,62,93,80,24,371,
a8a597cf-dc22-448c-9ba0-50989a73e2db,Hilja,51,8,96,39,2,3,199,
e86493ed-ad91-42cc-a026-9715022e3f46,Hillman,67,92,79,51,41,69,399,
c771ae5a-18fc-457d-ae04-1d6d6fddf5e4,Hinckley,25,95,7,88,76,38,329,
4a39b71d-65db-42f9-8228-6367bd889d3d,Hinton,62,3,27,11,34,95,232,
dc0cfcdb-a1a3-4075-857f-adc0553a7be5,Hiral,67,80,37,99,51,91,425,
68abf7ad-79f0-4779-96f6-4c7fd4c0821a,Hiro,91,8,58,96,76,73,402,
68e79a13-b7ec-4037-b622-90f47674d37b,Hiro,83,80,63,40,83,37,386,
b29e325d-fa66-4d64-94c7-2e2ef49dc29d,Hiroshi,70,37,22,27,21,87,264,
966988da-6389-4a2b-a186-b87edaa9d542,Hisako,18,86,28,4,85,45,266,
b574c8a8-9f84-439a-8a10-ba2930d2d02c,Hisao,87,88,64,20,72,80,411,
5a5df994-918a-4236-a582-e82a5466ceb1,Hisham,91,14,71,2,69,11,258,
626421af-c718-430e-8719-7069deb8eac2,Hitoshi,33,84,90,92,54,79,432,
ca1b8c35-f883-4d9b-9ed1-18aabeb66591,Hiya,55,38,46,40,81,31,291,
a52856aa-12ce-4477-84a4-ea26d04c6aad,Hiya,43,76,91,40,83,66,399,
a9713d80-df4b-4d8e-8240-cdfdd0a27256,Hjalmer,43,68,61,64,49,10,295,
33a8af6a-bf97-40cc-9b1a-5580436431d2,Hlee,8,0,77,62,74,75,296,
ac0242ce-dd7a-477b-8845-cfba3874614a,Hlee,56,96,28,91,63,19,353,
677ea226-7ef6-4ab9-9790-af0466f000d2,Hoai,31,91,58,37,99,78,394,
81ab1844-e3c2-4a6d-ba07-b325fba3bbd1,Hoang,90,84,66,22,98,53,413,
728a5de5-7281-4076-b88d-d90d250330a2,Hobby,67,94,87,2,24,31,305,
ae74a6b7-45ad-4ef9-a4da-74223a661af4,Hobby,85,49,22,21,14,41,232,
720fcf2a-80aa-4e9d-a0e1-74034cbb0ab2,Hoby,61,68,89,27,20,59,324,
944b8b43-a699-44e8-8257-8b69bd644d4a,Hoda,42,92,82,16,6,99,337,
a79e8c6d-2e33-4b35-a44c-271b1ef70e8a,Hoda,25,57,44,92,70,49,337,
e772d5a1-8f4a-4f9e-bcf4-367dc975f48e,Hodari,80,74,59,86,3,82,384,
999e91b3-8041-4588-a1bf-55ad4fe42734,Hodari,3,86,9,46,92,94,330,
e5ee09f7-a24b-40c9-b931-4ce7676bb932,Hodaya,13,96,40,20,31,35,235,
85ea12a7-43f6-4a81-96ac-0533d47e9e09,Hogan,79,78,54,44,98,82,435,
4d0de14b-5af4-4134-a161-54fc667412aa,Hokulani,76,91,78,48,87,19,399,
353d9079-ccdc-48e2-943f-2424efa8f004,Holden,37,94,36,30,41,70,308,
ad023be9-5ec4-478d-8583-2111d7335139,Holiday,34,72,26,17,59,99,307,
94c425d1-2511-4f69-b585-804b37520af2,Hollace,33,93,83,57,13,9,288,
b6796f0c-1225-438a-ae65-78a30697bfc3,Holley,88,28,10,36,47,24,233,
1136b959-2271-4721-813f-bd3da16fba03,Hollis,33,78,29,84,7,4,235,
3b7d2a5a-204e-4cd8-a43a-1c1399a9c705,Hollye,75,4,60,26,38,42,245,
506898cd-c514-4caa-b463-7783ec3007e9,Hollye,21,20,55,26,61,34,217,
9560fa50-16e6-4852-b867-8871ba26b02f,Holston,33,7,47,75,30,36,228,
ed84d509-ae94-4d41-96ab-c77b9dc29a8b,Holten,30,32,75,18,92,21,268,
3b5667a3-0b1d-41c4-8bc1-04636697e759,Honesty,3,70,72,60,3,37,245,
7ca92d63-fbd7-469b-9469-781961478547,Honora,97,14,44,54,25,70,304,
ed00ebeb-d1b6-47c3-b357-41765f476aae,Hooper,94,86,84,96,81,85,526,
81bac349-e53b-492e-8d8a-5ce713ca76f6,Hopie,47,80,39,19,65,20,270,
24d003c7-45a3-4d0f-8bda-0e37e0ab4afd,Hortence,70,20,92,75,28,84,369,
4bb35e39-00b9-48a4-8b70-738312f5af8e,Horton,59,100,94,86,24,61,424,
8cb4984c-b925-4f5e-a0b2-3c3a7acb625d,Hosanna,92,13,58,57,77,96,393,
6c5c207d-7d39-42e8-858a-5852a7f987ba,Hovsep,14,65,100,61,97,12,349,
fdb0a1db-9f79-42ee-a59c-0373ea8203fa,Hovsep,45,10,45,29,96,81,306,
507f988e-0eb4-4cdd-ba0f-d9b60dcf762e,Howie,92,70,65,61,63,68,419,
292656c5-8047-46bb-bb7f-86922799638b,Hoyt,46,70,40,22,32,42,252,
d047d93f-5bea-413e-a9db-fbc8bd395f4d,Hristopher,26,95,92,14,69,58,354,
2b10bb74-7b2c-4c37-8726-733b5dcf07ed,Huan,15,5,22,77,36,55,210,
8d608b04-cb10-41e2-ba69-f4d79e081ad3,Hubbard,69,20,43,50,39,77,298,
b0e544dd-ec1b-4fb0-920c-ae20626237f0,Huck,37,96,5,75,36,78,327,
d38fb03c-8067-47f4-bfde-691cade4345c,Hue,11,40,77,63,92,39,322,
fcdb88ad-f601-4c64-93bd-7a16b9f0d4c8,Huel,73,17,64,83,43,31,311,
771fee2c-4ed7-4d99-b571-f793ec35ce2f,Huey,25,99,84,55,59,75,397,
5c1c25ff-fd39-4ae8-9c1e-fd4b6f99341d,Hulda,70,76,34,46,91,99,416,
f5ddacee-ed4c-4153-8549-078e425a1b23,Hulda,17,100,56,32,53,16,274,
2b11e82e-5e5c-44a4-ae15-1df43dd2e360,Huldah,64,45,79,75,67,43,373,
0f3eb862-bfa7-4449-bd1d-c6566d9f52f1,Humbert,30,81,23,61,6,51,252,
2b9ce3ab-7e43-41d8-af17-03bf4589fb06,Humphrey,31,78,40,2,92,14,257,
972dc5e3-0f1d-4269-8c06-0e29c624b343,Hunner,61,97,70,61,10,82,381,
be68586f-4d9e-410b-b718-857f1156d8a1,Hunter,92,73,82,53,86,83,469,
41d9c5eb-32c0-4ac9-8cf0-9020f77d6394,Huriel,94,50,80,56,30,22,332,
51edbf17-4b09-422c-9ce7-48317a5061cb,Huriel,15,100,97,45,71,56,384,
35c5e294-31b4-413a-aca9-bf0c141d2282,Hurley,52,18,36,59,22,83,270,
d04d41a4-21b2-4e1f-97fb-abb083a24669,Hurschel,62,42,27,53,58,3,245,
9814a88d-5505-4d94-9b8a-61c80044506b,Hurschel,95,36,16,64,62,19,292,
0113bd94-8f1d-4055-b34b-229602624199,Husam,6,14,33,16,33,72,174,
a998fdf0-9470-49ef-a651-682fd817649f,Hussain,47,38,78,10,28,66,267,
308dd229-3972-42c1-bab2-c944a7cb951a,Huy,70,40,12,97,61,14,294,
01f0494b-7760-4dc9-b7b4-1d80c4574888,Huy,85,99,17,12,15,7,235,
19cb3b91-d787-4dac-a514-1dc485210e99,Hydia,86,60,44,41,45,48,324,
fd03d77c-1780-4cc3-bee5-472d5d8c859f,Hyrum,82,37,41,53,91,67,371,
38dbca48-98cb-434b-ae71-d8e1ce4788e3,Iana,45,62,20,69,34,93,323,
58f3539b-bbfb-40ac-bf7e-3bd5731b4295,Ianna,43,19,2,74,55,59,252,
1d7893c0-15fd-4223-aff3-a69e16d03cda,Ibis,58,55,78,4,24,71,290,
7e2b355e-b086-4175-9c40-4f05d89218b5,Ibis,0,8,57,72,54,59,250,
1692c0e3-d376-4169-9b57-648727c25290,Ibrahima,76,87,36,89,52,57,397,
4d8c954f-2533-4c95-9fa7-027c03bf3d01,Ibrahima,93,67,92,82,54,38,426,
da7cf952-2730-45bb-bfc8-a082fd24ac39,Ibrahima,19,80,80,29,61,6,275,
c755fd7e-ffb6-4704-a501-01b95be3b0e6,Ichael,7,87,71,89,70,5,329,
e49fbc0a-489e-4bbc-9306-35dd5206b7f2,Ichael,66,84,19,58,19,98,344,
de611595-7e54-46f7-80f2-0df3ec32508f,Ichael,40,24,30,48,52,26,220,
df62d365-9514-413a-b5c3-ef48b85f670c,Idalis,71,52,25,32,52,94,326,
65d41e5c-0696-46a0-b131-8b93cdb395a8,Idella,58,41,95,0,0,40,234,
afaa4413-b539-4550-86b4-f589f218b995,Idella,75,14,50,62,75,28,304,
8c0fd209-997d-4bf5-afdb-48e65d286b7b,Idella,17,41,18,83,6,35,200,
a65ca8ee-4539-4565-8472-373abaf53f7a,Idus,96,65,4,65,89,74,393,
eca529e1-0365-4144-8e91-9979968665e9,Iesha,52,72,51,60,88,44,367,
1b8f7026-d863-43c8-bd7d-16c21be9e5ef,Iesha,78,72,80,94,61,47,432,
5e706d85-c160-45ef-9358-0c228b6bb0c8,Ieshia,52,59,72,13,88,39,323,
f18db423-636d-4108-b996-286c47004449,Ieshia,19,44,97,66,96,81,403,
0222ccd1-5e39-4e4b-8869-b7bd958e6e20,Ifeoluwa,100,85,63,4,97,8,357,
5faa592c-7f09-44d2-931b-9aa1c93bb350,Ifeoma,39,46,17,48,6,42,198,
8e08c6ca-99a0-451e-868c-d2a78b48e9db,Ifeoma,80,42,34,87,24,10,277,
c6d5cc7b-fbe5-4316-a0b5-9d26ed7c2022,Ignacia,91,43,14,30,73,42,293,
a1bfa493-dc3d-4091-a2c8-8994bc0f77d2,Ignacio,46,35,51,84,96,73,385,
b820b2c6-61b8-4534-b162-0ada106b68d7,Ignazio,24,69,23,9,21,49,195,
a5829003-7320-4835-bf6b-4b56bb339e9c,Ignazio,9,56,20,32,58,36,211,
9a6f1143-cd65-4275-b46e-b8719df1a2f0,Ijeoma,64,37,59,96,57,55,368,
8818898d-f80f-4776-876d-7a11bcf6c6d2,Ijeoma,51,2,84,20,35,6,198,
512f680d-3206-4779-abfd-ae02dbfbf235,Ike,60,20,49,93,67,64,353,
9e7d1859-a625-4c40-8a66-2d5a974b1667,Ikea,23,49,35,59,6,24,196,
a48277f1-36a3-484c-b917-00dca5072135,Ikechukwu,79,98,79,74,43,36,409,
a208c59b-6795-4879-a7e4-141e5d123bd8,Ikesha,6,5,75,19,32,75,212,
c5a98a60-0c0f-47e1-9689-335cc27d4fbe,Ikia,52,96,63,40,2,23,276,
3d8b882d-59ab-45a7-b852-25130a000587,Ikram,24,63,82,25,49,86,329,
420ee78f-6bb6-43db-bca4-c7a290aaf286,Ikram,15,84,15,94,31,96,335,
e37cc3e3-ef85-4986-bcbf-2fc8c3458060,Ilah,44,70,11,37,22,24,208,
17dc1422-c57d-450b-a3b6-129606e56752,Ilany,30,98,92,98,78,68,464,
702d467c-7dcf-4eff-9282-057e0e220f28,Ileana,59,88,21,58,77,77,380,
9dbf49b6-f399-429c-a3ec-57f2963d49a5,Ileana,28,0,88,54,29,66,265,
d39c135d-f232-4b63-8462-b7745bd212c8,Ilhan,31,39,13,34,11,15,143,
08d682ef-6184-4c3b-bf18-d203c28d1273,Ilia,10,0,78,99,35,97,319,
027c4125-3d27-41d2-8c07-791c56f4c291,Ilijah,91,72,93,86,93,70,505,
2c59d1ab-58b1-4769-8d5f-3dc9eaa80752,Ilissa,4,28,67,66,11,93,269,
8c0f1163-2f76-42c7-8189-d514531bff8f,Iliyan,51,73,23,1,57,93,298,
ef5578f9-716a-4033-984a-114c96c8e5c1,Ilka,93,7,33,95,68,18,314,
d5369ade-7314-4a30-9ead-85b6a2c59fb2,Ilka,39,56,38,64,19,43,259,
eb88b7d0-8058-401b-88da-bf28c571c65b,Ilka,24,74,81,16,16,28,239,
d5c29b49-47b3-4e27-8b15-dc16244dc442,Illeana,69,75,21,51,79,39,334,
f11ef4e8-f066-4cb7-be8a-42ac27d834aa,Ilse,33,13,39,84,40,52,261,
70ccc218-bbce-4905-a154-74e5510a885a,Ilyse,9,74,87,38,7,19,234,
024a1309-a6dc-47e3-85b3-e11496c88f79,Imaan,35,75,45,87,17,0,259,
bab80aa0-5a7b-4875-a65d-94ea8ccf5647,Imagine,6,69,39,41,0,29,184,
13b55eb4-b470-49b6-b628-d74de7026f6b,Imalay,17,38,41,63,76,6,241,
ec955c4b-403f-4d32-8efd-2c970daf3bca,Iman,0,56,50,18,23,44,191,
fc497015-44cc-49d8-98ad-ca8fdbb8152a,Imara,61,60,54,51,60,87,373,
1f77db75-b011-4d2a-a2c2-298b7e3542b6,Imelda,33,33,52,77,99,64,358,
d4c023f4-ea57-45c3-950c-9b58850786aa,Imelda,66,81,22,90,84,54,397,
a8e8592d-4683-4e26-b3b8-b946d4616888,Imo,65,35,39,77,44,32,292,
b9eb03d1-2cb7-4359-9eaf-79b34f6933a4,Imo,90,35,61,50,56,9,301,
23c4389b-d9c6-47ab-b296-adf1a31c7731,Imogean,63,29,51,31,2,40,216,
ee2dd16e-851c-4c8b-9cac-2094ba61b995,Inaya,60,58,16,2,25,52,213,
b8a95eba-8eaf-4f11-9a00-6b0c2b652079,Indica,20,34,93,25,13,10,195,
9780b978-e322-4511-995b-645ad8956d15,Indira,70,53,84,88,59,30,384,
705eaa59-4089-4ee5-b93f-95e08fc24a01,Indiya,91,22,5,35,11,45,209,
793f98b3-c7a3-42cd-b5c6-056dc43f0e06,Indiya,0,78,97,44,20,64,303,
42210538-4343-4f99-8ab6-9da94e16e536,Inell,67,35,64,6,75,97,344,
8d3cf34a-68eb-444a-baef-509a98475303,Inessa,50,30,21,92,77,59,329,
b2f8d667-a28c-448e-b1e2-eeadf553ef8c,Infantboy,39,70,74,100,54,61,398,
b80578bd-b9d1-44e3-8e4b-884e68944843,Infantof,29,32,64,85,47,37,294,
a30ac913-d20c-4c07-9c17-41a2898655f1,Infinity,21,20,69,14,20,45,189,
699d9918-41c7-4250-a683-10394e5ff89c,Inga,94,100,18,82,81,45,420,
ade881d1-779d-4e02-bb1b-30fd131675c8,Ingeborg,78,47,33,55,29,33,275,
743524e5-2536-45ba-893c-a9e59bff622f,Inger,52,89,81,54,70,76,422,
401c39dd-ec26-49ac-ac1e-e16e6b84cb95,Iniya,34,14,53,62,44,39,246,
f82e83dc-48b5-472d-9be8-09bf459d1d07,Iniya,55,4,34,37,80,2,212,
86aedcda-462c-4e7e-bc90-ef465d514f26,Inola,75,52,66,19,27,100,339,
a0c6c44c-8e63-4e71-8d23-1dce65b783b3,Iola,20,3,16,50,79,46,214,
3da82935-7d0e-4581-8a39-a6e6bb2f7c03,Iola,68,99,92,71,77,98,505,
48986c43-5baf-41d1-bb82-a09ab9b003e5,Iolanda,11,71,70,76,29,51,308,
c4e1c503-59f2-4458-8f5b-ff50af557cf5,Iolani,12,10,54,52,24,56,208,
422fa529-140e-4500-b3bd-ef3279f9d30c,Iqra,27,53,88,2,32,0,202,
6732b634-4ca4-4abf-856f-04d28ff52b69,Irazema,39,14,44,83,86,28,294,
6edf729e-8fcb-4ce4-99cb-f6a5c8af4ca2,Irby,14,43,26,58,25,89,255,
dfa5f0c4-0266-4aca-a332-be7f2cc99230,Irean,20,9,44,23,33,100,229,
67ace22c-89e0-4b56-9c2f-078e9272562d,Irena,66,18,33,45,15,75,252,
ed7cc657-faef-401f-bd95-07303da8e9b5,Irene,97,55,49,89,41,12,343,
57ba7389-7b4c-451e-aa53-09e27e09601f,Irfan,90,19,29,33,79,75,325,
11a68956-a7d4-4af1-8022-c6e12938c33d,Irfan,68,19,54,87,38,29,295,
841f70a9-7153-49e4-ac66-3b174f475aaf,Iridiana,15,78,76,26,89,7,291,
167f2b59-0492-41e1-8986-1a81524eae00,Iriel,9,40,59,86,14,76,284,
e9aad613-2a90-48c7-ba8a-994a1cf0fb60,Irish,37,42,29,75,20,4,207,
500f21f9-8fe0-4b6e-a35c-e2383aad37bb,Irl,12,36,86,87,14,18,253,
364b9a23-94ef-4de1-8f2b-8d6ec32f4509,Irlanda,55,40,89,29,50,46,309,
7f2e5d0c-dbc8-40ef-a2f3-67285a2395d6,Irvin,64,18,40,37,6,31,196,
6c9e95e0-369e-4437-9919-6941c0356a04,Irvin,51,1,89,77,40,90,348,
efa79a2a-0e34-406c-825f-9dcaea8163b1,Irwin,90,14,67,58,51,81,361,
605b42d3-13db-4ac9-ba10-1d45f7f7b6fa,Isabellamarie,53,24,52,81,19,45,274,
35e37735-ac3f-470d-bffd-6729ab69c2c0,Isabelle,45,21,54,82,65,70,337,
1a99ce0c-3a6d-4ca6-b657-82c6d3ea7b50,Isabelle,56,45,75,56,0,94,326,
a8fe6a6e-777e-49d2-b935-d7e90045bfe5,Isabelle,28,76,5,70,44,1,224,
5a53dafa-eeee-4e9e-b6a5-fdc3573502cf,Isabelly,19,9,61,15,26,86,216,
1385a437-7978-4c38-9238-c0fea5a9f52d,Isack,19,85,50,53,41,46,294,
ac8bf913-e0ca-4b41-b154-7ba59d699055,Isadora,86,91,69,51,6,83,386,
73fac537-cd5d-4652-a990-bca03a5a28a9,Isai,6,31,46,27,87,29,226,
fb093afa-2b7b-4ffe-bb79-2acddf5471e0,Isai,61,15,18,78,83,13,268,
67dabf1e-6354-4b3f-b71d-fd2db4d8f01d,Isaiahs,32,12,14,92,75,4,229,
5b3221fe-626f-4866-b60e-cd5559b96330,Isaiha,79,21,20,59,21,80,280,
cc3873d9-c208-4ef3-ab42-bb41c5d89a61,Isamar,17,72,56,68,87,61,361,
8f941b76-1ed9-40f7-ac0a-0e0fef42e7a6,Isamara,68,25,66,55,97,76,387,
117a85a7-4f7c-4ed5-911a-6e2210eafd0d,Isami,41,51,99,32,99,4,326,
73ddc25b-932a-43be-a07a-8bf66b25e047,Isami,0,92,66,47,94,22,321,
3a68ce41-0647-433b-9419-27c5ceb25075,Isatou,43,83,5,1,73,14,219,
09f0ea9a-aa6d-409d-9ae8-4e30673f7054,Isatou,20,77,72,49,49,53,320,
8d13d901-eac9-49af-adab-a443d287e96d,Isatou,3,89,81,78,0,81,332,
887de5d8-a11c-4689-9c5f-76c72d8808ef,Isela,69,48,12,9,97,79,314,
36bb0c32-1899-42ee-a164-297fc6c7168f,Ishani,97,63,41,60,81,17,359,
54f4b18e-a4cd-428c-946c-146b2fbe64d6,Ishita,34,3,1,80,57,60,235,
064c5b0c-37e6-4005-abfa-b5a03f553e4a,Ishmael,50,32,24,64,18,74,262,
16cc2eef-a1ab-477c-8a2a-84d63dc7befa,Ishmael,57,77,58,31,53,99,375,
357c49a5-be7f-4753-b8b5-c04fd78fe8fa,Ishmel,92,27,18,13,2,28,180,
0033a77e-2d51-4346-94bc-1d046ec50563,Ishraq,97,82,93,98,46,14,430,
0d074083-c931-48fc-a330-69d09e0d2ec0,Isiah,30,43,77,4,90,89,333,
7857e75e-21e1-4905-8635-1db0338f4d23,Isidor,44,76,63,56,19,63,321,
d17d481f-6dcc-4c47-8bb1-b078c677a532,Isidoro,80,19,31,84,5,11,230,
c42203ce-46a6-48ff-8e4a-24e68b8c6c47,Isidra,28,63,68,8,42,69,278,
03be934e-0949-4324-aa0b-db385b1010ad,Isidra,33,5,11,47,53,12,161,
2d9264d9-73c2-4672-8746-744d0ee36fb1,Isidro,72,37,75,94,39,45,362,
c8e84c60-d804-4649-b6b0-6ede064efbb4,Islam,89,4,67,39,80,12,291,
1c45fbe2-e52f-416e-99f3-d85d6d45a8b1,Ismael,50,18,40,67,64,18,257,
22fa4b49-ee5c-4a07-b5a2-914d73b2f325,Ismael,56,58,87,14,23,33,271,
b7f55e72-a945-4e18-b834-23b6667acf65,Ismar,5,58,54,58,50,61,286,
b23308ff-5759-44ce-b78b-d1636efba753,Ismay,48,16,79,73,100,99,415,
dfb3d411-7ecc-404e-90cd-a7be72d2e3a8,Ismay,88,97,88,40,95,5,413,
18c8c151-7124-4389-afad-ba0d3d1785c4,Ismenia,98,23,1,33,63,30,248,
2106f160-b9bf-4339-b7b0-712b62051038,Ismerai,34,67,85,91,4,81,362,
7d22024b-5831-427c-8495-ebe3b6486546,Isola,31,53,42,73,15,65,279,
7da3e519-a9f7-464d-a680-dc9f8ac34996,Isolde,55,95,63,15,93,32,353,
512f1aec-91d0-410f-996d-28d177c81f11,Isolde,5,74,69,67,4,6,225,
78552247-dc64-4b84-beef-0a30237bdda9,Issa,24,5,50,30,95,28,232,
cb3c3b28-45b3-413b-be7a-188e423ea457,Issak,74,0,70,2,100,12,258,
e69c781b-21a3-4677-a6be-26210045bd41,Issis,3,15,61,35,97,51,262,
bb852727-b6cb-43ed-abc4-7c5daa21e888,Ita,32,85,62,69,89,94,431,
244c1682-b849-4eb0-8821-e88dba556cd4,Itati,25,65,95,65,44,47,341,
00b17b3a-8a79-48a8-8a12-c91c08888d81,Ithan,62,88,13,1,60,75,299,
218c9731-f12d-4fa9-9f9f-5eae3d4224f7,Itzamara,16,62,51,58,75,68,330,
9fac5dbc-1cea-4b2c-b3b0-10ce823c6bb1,Itzanami,37,54,59,7,79,5,241,
501b029c-2430-4412-a0a0-47758c57b56e,Itzela,90,71,90,24,65,28,368,
f17067be-929f-4ecf-ab8f-2fcc782e01de,Itzelle,4,98,34,0,22,18,176,
c428e8af-d792-4f49-8260-5bc20d769168,Ival,23,94,46,47,71,36,317,
cd81fb8e-9c45-4f93-8f0c-9db10cdb7f1e,Ivann,74,38,39,6,60,43,260,
c4486734-71f9-41c5-bf06-51538037e3de,Ivelise,91,54,14,15,18,75,267,
aee138b8-d39f-4cb2-b00c-b71e001d483f,Ivelisse,62,62,84,51,99,78,436,
6131d506-68ce-4de8-8766-81605e1cfe87,Ivey,72,64,74,91,28,29,358,
d7d3abcd-8f8e-4722-a392-a350399eea2a,Ivo,84,44,83,0,71,94,376,
16adc3af-82ae-48d2-b83f-89f116815d57,Ivone,75,12,26,23,8,16,160,
225018ec-2f37-410c-89c0-074e5ca76b54,Ivonne,76,58,58,62,8,35,297,
336f008e-0cad-4d55-a29e-41f5c6df720c,Ivory,70,3,31,27,57,55,243,
6e4cabf5-5d84-49c6-b158-46485f74351f,Ivy,84,32,63,5,47,15,246,
d142a875-4b68-4949-aa07-759a24de2280,Ivyanna,79,30,11,25,17,32,194,
75887e83-fd16-4ff4-ba3d-e5ec96efe7ff,Iwalani,64,88,4,1,91,81,329,
2bab5535-618b-4d61-8079-7eaefe60e632,Ixel,34,88,3,59,76,27,287,
63073e0e-6da0-42f2-b9d4-b7aeffb8c5ac,Ixel,65,59,32,6,24,85,271,
20f5a871-7921-49b8-a80d-37c83b654b34,Iyana,91,82,68,85,96,41,463,
26a85163-61d8-4146-b269-cb1b57ac1e07,Iyannah,17,41,51,14,59,37,219,
200c105a-4685-4bf3-8242-95d05dabe6da,Iyari,10,59,47,7,30,8,161,
6ea2cf58-2a85-4baa-8c49-f2ecca8a3f37,Iyla,46,80,11,23,37,53,250,
383a9965-ab3c-4a61-8faf-cde8587b0e53,Iyonna,83,47,30,85,25,72,342,
76f071ea-09e9-4ccb-94b5-9c4850d9545e,Izaac,14,69,62,56,14,15,230,
f2c94dff-1d16-4912-ac86-cff52bae5ea5,Izaak,26,55,60,73,44,88,346,
eaef633b-178d-42ee-9836-c7c04bb3ed04,Izabelle,18,96,18,51,51,31,265,
69f98283-e30b-486a-9cb9-cac5841ce385,Izacc,35,9,36,70,16,86,252,
ddd20517-39b1-47d1-ab9e-1d9bc2e2f243,Izael,63,85,16,87,97,33,381,
f0e3b1f5-a344-4197-9e8d-a11d876bd958,Izak,52,92,73,52,27,17,313,
cd5909b8-59fb-4ae4-a802-e7d4cf4001b0,Izamary,18,54,89,45,55,84,345,
fee50327-7599-439d-beb2-4acde56001d7,Izan,16,36,79,2,100,13,246,
18de4e69-cd75-47cd-8716-4916b3b153c5,Izekiel,3,4,18,93,27,4,149,
e70d9515-5021-435c-970c-74a317973f14,Izel,46,24,77,62,18,16,243,
eb872c43-4d41-43fb-b109-661d5f5e3a8a,Izella,42,22,96,32,23,69,284,
167fd1e3-de6b-42df-9bde-7579d70a4019,Izetta,16,0,68,90,27,12,213,
f360fced-cac5-4f3d-a027-babd928aa313,Izick,46,89,64,8,10,100,317,
fd4b791a-2e34-4c63-96e7-0d667c6b14a5,Izik,31,53,73,100,66,89,412,
2f6d98e8-a68b-4c24-915d-f885c23bcd40,Izik,86,87,79,76,6,20,354,
77846755-c94a-4b2e-a872-8be88cb9b3da,Izrael,25,82,64,85,29,62,347,
5c8476e1-a8e9-4e2e-a79c-85d1a5c9c37d,Izzy,2,69,51,12,69,64,267,
9b054240-881b-4bda-b29f-1121bdb48af5,Ja,43,80,11,75,26,96,331,
e3cfd1de-ae96-4101-8a39-c6aac57b2bdf,Ja,19,82,26,78,83,61,349,
cb3e8ccc-97a8-4e84-9b05-5e8962dbe7f7,Jaaziel,0,62,2,6,97,38,205,
82c8e5ff-9977-46f5-aec9-f76a36535db2,Jabraylen,92,36,26,68,100,43,365,
ea3e9e58-9729-4484-9c9d-c33eed16bd02,Jacarius,95,33,73,89,41,54,385,
4ee26f73-df78-4bd0-8081-37b419b0bc40,Jacarius,9,74,87,24,28,16,238,
d1468680-1688-481e-9379-2e4c569ccfd4,Jaccob,22,81,93,91,43,61,391,
f78fc6e5-af9d-4230-81da-87a0245c4810,Jaceion,96,24,14,24,92,39,289,
a8bb3caf-cda4-4473-8eac-c62510767e83,Jaceon,77,34,91,11,58,41,312,
78526da7-76e0-47e0-bf16-4ee7d76a5ecf,Jacey,58,57,83,61,17,98,374,
972347b6-c795-46b6-a98f-dec1c3fdbe21,Jacinda,80,31,15,84,21,68,299,
de009e46-e594-4c5e-9402-93a52d3be910,Jacinta,66,81,72,95,37,59,410,
d847869a-ccb3-487a-a164-7501c86ad1c6,Jackie,82,54,14,58,90,50,348,
69b4269e-8dcf-414a-96c9-470c73fea0ab,Jackie,72,99,82,42,72,11,378,
ad2ef45d-bcaf-4d3a-9334-f3ebc8a1b81c,Jackline,94,70,28,54,19,76,341,
2420438e-a6be-47a2-84e0-8e7052a6f666,Jackqueline,18,84,89,9,4,97,301,
1fe46b10-a0fb-4f60-87b2-ccfd9f0e8c16,Jackson,25,39,36,91,42,27,260,
8f11c42c-be64-4344-b29a-b37df83cc0d9,Jaclynn,69,52,42,95,36,8,302,
134de9d4-fb4e-46f2-ad1e-ea66f1a1a2c1,Jacob,41,52,45,96,6,49,289,
469b0073-ab43-4396-a85e-c5edf0049f53,Jacobe,47,26,11,40,100,26,250,
c0997ad7-64df-4465-ad07-07726efec5a9,Jacqualine,63,39,33,14,90,99,338,
b751a38f-9c7a-4d9a-984c-3c192d7c2874,Jacque,24,95,36,25,68,37,285,
256c9325-9d11-45fb-9400-97f23e4a221a,Jacqueline,34,36,80,98,39,44,331,
ea72f941-771a-46ac-b743-b21b9d5041f8,Jacquely,31,52,53,61,60,14,271,
e3285524-34a0-42c5-8cb7-91f553adff60,Jacquelynne,32,29,39,28,78,50,256,
33dc93f1-508c-474d-8fcf-267c66a283d6,Jacquiline,69,4,4,25,23,95,220,
3a19039b-59fa-4e4c-ac20-97d039b0872e,Jacquilyn,3,44,57,48,53,74,279,
57471a40-0cc2-4578-84f3-63a3fa9dec83,Jacquita,46,92,73,60,49,27,347,
f0029f53-60f5-4fba-bab1-73cb32c95cbe,Jacqulin,72,28,96,90,82,68,436,
02d3ffff-bdcb-4c9d-ad9b-7beb56a9c2d4,Jacy,15,87,81,91,63,56,393,
88bdf5b2-1c01-4141-98e6-e51f7902563c,Jadakiss,43,26,24,83,29,7,212,
063148ec-dc7b-454a-999e-769cc29ef936,Jadalynn,63,9,42,64,24,49,251,
ccde47f6-b9a0-49e7-a27e-422c24e9b017,Jadalys,32,71,81,12,70,82,348,
23ea4dd8-6ad0-4ebe-801f-3094370cd13b,Jadarian,28,27,12,75,19,8,169,
dd882532-e58d-4b7b-8aa6-333f4a3f8839,Jadarian,41,25,90,43,27,90,316,
c208bf8e-ba8d-4697-9eee-85eaf211cfea,Jadarious,44,44,89,18,15,19,229,
2eddee5c-b973-4c4a-979b-fc0ed8873f6e,Jadarrius,27,62,86,79,6,31,291,
51e84c5f-ca1b-4393-8b73-5b80c889f706,Jadden,16,100,44,71,85,70,386,
a05c48f4-9b59-435a-a7ff-774317b85ba8,Jadey,2,83,27,72,14,70,268,
70a5b70e-5ec1-4c03-8d17-086541d231fe,Jadiel,19,67,29,96,6,37,254,
c9745fe1-cea0-43b7-a50d-1585499c10aa,Jadien,4,21,76,96,9,79,285,
0123e0e3-5646-40f9-8e80-24c58f73a0e6,Jadon,99,22,50,8,74,76,329,
96443850-adcc-4b40-821e-f8388709d1bf,Jadrian,98,49,8,58,66,74,353,
9c338337-0174-4524-b174-2086a0f3d485,Jadrian,88,74,25,8,95,47,337,
9f176074-573d-4e7c-bf82-b7c7d81078f3,Jadrien,16,39,38,15,9,12,129,
560f1620-fc1c-42ad-8b62-bdf946b2f7e7,Jadwiga,22,95,13,57,30,90,307,
97a2728d-6134-4b47-9b04-3a1fdc209c62,Jadyn,18,23,56,63,96,12,268,
55b3eacf-0555-43c1-9f84-35780206d00d,Jadynn,34,10,83,53,35,49,264,
c8e14615-bd94-466e-9c59-22251b123cbb,Jadynn,27,76,1,23,94,76,297,
7c7cd425-42e3-4e2b-9454-74bfcf61403d,Jaedin,34,49,9,99,80,89,360,
4a576a19-5f43-4695-9bd0-d456c680ae36,Jaedon,72,70,39,33,41,21,276,
8679ff41-1554-459f-84ed-14952799619f,Jaeger,4,31,15,81,24,20,175,
40328575-d681-4b00-949c-0b16cd4cf273,Jaelah,82,72,64,100,69,62,449,
d98e59c8-208a-4cc2-bada-57379e4aced4,Jaeliana,33,18,87,3,37,83,261,
f19436ff-8fcd-4764-a587-bb1bf70d3cac,Jaelynne,74,22,76,25,79,5,281,
16cb28cf-eabc-4b36-897c-fb1990aeaa10,Jafar,67,19,7,42,80,49,264,
fb5439c9-8296-453b-8bb1-5a3bad5e9188,Jahad,35,28,33,85,74,85,340,
e258c90b-cec5-40cb-b687-cf21afdc6090,Jahaida,79,14,84,6,15,37,235,
58a00d2f-8c73-4d29-a04d-efeee600c6ef,Jahayra,71,23,71,88,69,38,360,
742581a7-b99b-44df-a763-a9e43da7487b,Jahayra,94,4,81,11,81,34,305,
44c4cc10-6fff-422d-bbbd-951ddf7b4b77,Jahaziel,96,26,6,96,13,93,330,
5b204d7a-b820-4934-ad2b-25f0264e6260,Jahfari,94,73,60,25,100,64,416,
df78e0d4-5f5d-4317-8ab7-6bd1436c987b,Jahiem,25,3,7,12,25,85,157,
bb346a6c-d6c4-4d8d-94a6-ecccddac7eb0,Jahiya,54,79,13,78,24,50,298,
bbde20b4-259c-4284-8343-5e2c81f1edb2,Jahkeem,43,92,25,44,52,10,266,
f6df50d5-1a8e-4d72-abcb-f91b7239d0fe,Jahki,88,34,63,40,16,33,274,
a5eb5395-3055-492e-b8ff-f2ce95fbbb5d,Jahleel,6,17,42,46,24,94,229,
03b18abc-020f-48ac-9d52-53362a9c0651,Jahlil,82,54,66,23,85,61,371,
9baf58f9-3771-496b-aed9-f525b6dff27e,Jahlil,87,28,44,56,98,88,401,
8bc73e4a-9695-489a-a3a6-53567359d705,Jahlisa,52,64,97,22,70,15,320,
89ffaddb-806f-4480-a055-49532e1883ec,Jahlon,73,92,72,86,30,74,427,
3691f53c-9785-4099-9d29-f3c5ef2c2c77,Jahmal,7,75,51,43,26,42,244,
d196fdba-f070-4c0b-a8a5-8803228fec38,Jahmal,90,75,44,59,8,91,367,
f52790f2-8732-4447-8099-e7cf8006b202,Jahmal,28,66,11,35,80,52,272,
6f988641-bc7a-4b27-947c-e48fec16b13d,Jahmar,77,86,69,7,5,39,283,
75ccc458-3031-47bf-9532-4b095fbeeebe,Jahmari,87,10,69,75,31,42,314,
159d8579-9254-45ea-b413-7a4aa13053d4,Jahmeek,14,88,56,56,40,72,326,
a5a88f85-7a37-4f44-a38d-748c353456e0,Jahmeir,27,69,16,2,72,96,282,
ca5c1579-a029-4fad-80f8-11c79d0e769a,Jahmere,31,53,21,11,40,92,248,
8620b6b8-e17a-4732-8fc8-ccd22418d089,Jahna,31,37,25,18,70,53,234,
329ea17d-aa45-4767-83fd-8d18b215e585,Jahniya,90,31,91,69,92,85,458,
9e62b5d8-2707-4515-99b4-c0a7c2a7eddf,Jahniya,21,59,33,77,31,96,317,
0fcb62cd-5fbd-45d0-801a-677f4039cc8d,Jahniyah,29,27,36,20,71,99,282,
6309cfea-d40f-482c-9b31-05ab85a584cf,Jahniyah,75,33,77,28,65,90,368,
75046c8c-88eb-47bb-bb34-f6c81eb99e0d,Jahnyah,13,56,77,9,89,42,286,
6694537d-6527-4c48-9b8d-789c3b7185c7,Jahquan,51,2,95,19,31,19,217,
4f4ccd96-98e7-41dc-8c88-a5995d7377f3,Jahquel,81,16,29,28,73,85,312,
6ad04fa4-e83a-4adc-b05f-2e514325dfd2,Jahred,27,13,28,37,83,33,221,
db1986f6-9d2e-4f62-83e8-6663451dff34,Jahsir,51,46,98,24,37,5,261,
fad26b55-3a4c-4f01-a803-19ae2683bc2d,Jahsir,26,97,46,100,69,76,414,
bcbb8077-2050-48b2-931b-88f78eeed723,Jahsir,1,75,86,88,12,7,269,
295e6cda-e87e-446e-9403-f94b8024331f,Jahvon,57,48,51,47,59,23,285,
1729bc97-0599-4794-b92e-b0d8da85b9e7,Jahzaria,80,34,22,8,22,24,190,
30aa11df-420a-49ca-be31-e9ae50901cd6,Jahzir,54,63,15,70,67,78,347,
a9a35ddd-7898-4e3a-8ae9-627dc4b8dc46,Jahzir,66,44,92,95,98,18,413,
98e173f1-deda-4c56-a0ef-c56ce4f4ad33,Jahzir,86,35,21,32,16,11,201,
9726c762-035c-4526-be88-4c9c0fff40fc,Jaiah,20,48,79,91,26,97,361,
a00dadc9-4b05-4c57-b977-8bf0727e4ea7,Jaide,26,30,37,95,31,2,221,
f0640c9b-7a0d-45ff-b35d-e557dd16ff23,Jaideep,11,46,29,66,81,41,274,
57744126-f330-4abe-a5be-0137259bc986,Jaideep,43,28,64,65,15,20,235,
7ae6e7d0-69e2-4292-94c4-6087091d2248,Jaidin,61,100,80,18,34,50,343,
25250d2d-3ece-4aa6-81de-3dae87524a48,Jaidin,88,5,3,94,41,6,237,
602a5ef8-5aa3-437d-ba5a-cd125ff58779,Jaidon,96,47,58,66,22,62,351,
605270dd-afc1-49e7-9d2c-599b8528391c,Jaila,24,94,60,56,16,84,334,
52a8b50a-63e8-4c80-a302-36b68dbd69b7,Jailen,52,38,84,13,33,73,293,
c739b2b9-a6f4-4473-9c91-d5bca1660119,Jailynn,29,28,47,43,29,96,272,
6ad508ba-b0f9-4968-88dc-02dea89a6c63,Jaime,11,50,87,33,28,100,309,
9c9a75a2-66b9-4bb5-90c9-6f069ec4ec9d,Jaimee,13,60,81,52,9,98,313,
34c004a4-b711-4d94-9d91-1917f0c9d1ae,Jaimeson,41,39,5,15,36,66,202,
e8cf9219-7e7d-4604-9904-7a515682643c,Jaion,47,87,79,91,26,90,420,
481e50e4-6601-4a5e-9d5a-cc958ccbc60b,Jaiquan,72,12,17,49,47,11,208,
8efbef7a-cdb4-4645-b135-fca39967d827,Jaira,53,31,19,10,58,65,236,
5f0b3ee6-7735-4057-9f3a-0273228c7e3f,Jairo,61,68,56,42,13,75,315,
3aaeb03e-61d4-4422-8a08-7ad09c21025e,Jaison,64,2,8,93,74,69,310,
5756ed90-61db-4df3-b4c9-248ce4722b7f,Jaiveer,38,79,52,37,32,74,312,
b6eec441-c6d9-494c-bd28-6a6123d37093,Jaiveer,40,65,92,1,70,45,313,
0be67caa-c6be-42f9-8f91-07d5b292adde,Jaiven,36,19,73,84,60,59,331,
1c986c51-6a57-4eab-ad34-f41db8933a24,Jaiven,69,30,11,8,38,16,172,
2dfa0152-4c97-4262-b3c9-5201d52b4311,Jaiver,73,73,80,100,65,49,440,
3868d52e-4067-4183-8348-115d8b1437dd,Jaiya,6,10,59,61,16,17,169,
17b0c91f-5492-4ea1-a1d5-9dc736f46c2b,Jaja,12,56,85,48,94,3,298,
431eeb88-09ae-43db-9545-fd9f9a7f0427,Jakai,59,91,95,69,100,64,478,
5ee12434-73c0-40f5-817d-8d49a25e189e,Jakala,92,7,34,0,10,36,179,
bb0f4dbf-efc4-4fda-8a7b-0e2c31819b48,Jakavion,57,67,44,0,95,44,307,
a32912a5-1d0e-4b39-a3f0-dec6cc6055d9,Jakavion,46,58,16,71,76,5,272,
ed74ee8c-03b6-4c04-8ea0-b399ea379320,Jakeline,42,50,81,70,19,37,299,
c68894c5-fb40-459e-8e64-3e8cc762acc9,Jakelyn,2,97,79,45,56,18,297,
cac0b62e-1d7f-4116-9e2c-606b2c99c924,Jakevious,29,30,91,57,99,14,320,
eef2458d-d330-4546-9dd3-3eef5c774edd,Jakhi,58,46,9,83,83,86,365,
0c13c687-1f2e-46ff-91c0-34e7b7124613,Jakia,33,78,89,65,33,3,301,
b89c5378-51a5-4f4d-9605-394b6f22bbb3,Jakiah,94,25,15,96,37,37,304,
d97ee74d-af01-4836-815c-0d7133447e75,Jakiah,90,9,38,61,47,53,298,
bf43d593-d902-4697-bc7c-ba6be90de527,Jakim,9,50,4,81,97,45,286,
44009651-13b0-4277-99d2-fdb01fd37669,Jakiyah,47,10,52,13,30,6,158,
238bacc6-b18e-4355-aff0-8f702e16aa9a,Jakiyah,61,75,5,48,27,94,310,
10e27ff2-3f2e-43dd-b4a9-23c1f0d2ffcc,Jakoby,3,73,12,53,72,28,241,
b198f973-7d09-4387-b011-d1699b26d97b,Jakorian,72,23,10,46,10,93,254,
1522971c-a91d-427d-a294-71f9fae7dbb2,Jakorian,96,54,55,4,63,87,359,
dc8ea694-a027-4c73-a0eb-59d517048381,Jakson,11,100,16,93,12,36,268,
2864ad3c-df14-4d88-b057-e4f8640b0757,Jakub,63,8,3,50,3,50,177,
0cb9e988-1946-471c-a27d-e4a888a8be94,Jakub,13,34,57,80,64,79,327,
2c5d0709-d6f9-4676-a63e-2a6f5a84617f,Jakyla,51,33,55,46,2,73,260,
08b103e5-cffb-4797-a77a-98a6aa661235,Jakyla,64,52,53,69,39,8,285,
98337e70-4e18-4553-b7c7-a68f1cb3bafe,Jakyra,59,31,59,72,52,5,278,
f71ade00-af66-4764-af07-8683d3bc87d5,Jala,20,48,72,97,91,89,417,
a744c122-e99e-489c-9328-3f22e280328c,Jalacia,86,43,39,45,24,7,244,
bf2b3749-ad4f-4099-91ca-86ec19c547d3,Jalaine,18,61,28,98,56,0,261,
86c8bf6b-9239-4b1e-ae83-84600f4d0c9c,Jalana,2,48,15,66,21,81,233,
21e86e68-4e2a-4437-926c-89f258e1547b,Jalana,68,42,77,23,27,54,291,
34e13998-6214-49ff-827b-e33cdff346aa,Jalee,12,22,66,28,8,81,217,
a88261dc-3a96-4b7f-9dd0-0f8348da3f54,Jaleel,54,85,90,84,10,100,423,
1151ec65-d996-4ae6-abd5-f2874a038de1,Jaleel,71,81,34,30,94,3,313,
6579b256-9d3e-4c5e-a306-2f8f76f52f70,Jaleria,59,45,84,17,69,48,322,
f96caa45-86eb-4c19-9899-45dc81dd3323,Jaleyah,26,4,40,55,55,5,185,
5a59afe5-965c-4df5-ad7b-b82c56ecc245,Jalia,49,100,76,52,17,9,303,
553702c3-fe64-4265-8be9-f0e97d615bb8,Jalil,97,1,19,74,50,64,305,
d0597a29-dad5-49fb-9f6b-79a12cd72944,Jalin,74,26,72,53,6,89,320,
b007ef42-8ffa-4365-8cc0-fc05ce7ee709,Jalina,57,50,64,22,76,77,346,
a8c484e2-b6bd-43ec-a50f-da4f039a67bb,Jalyssa,60,61,23,57,13,46,260,
80cd4049-2736-4ea7-b8a1-c198a70fd148,Jamar,71,70,7,51,96,70,365,
7cebe2cb-193c-43fb-b15b-d378cd56dcc0,Jamara,57,35,1,41,56,24,214,
20da263f-dbe8-48f6-a49c-92eb250822a7,Jamare,46,28,47,70,50,52,293,
1a379f51-030d-405d-9782-ee3a87066957,Jamarr,73,86,12,37,92,82,382,
5c3b17a6-8108-45ee-8a57-3e3eec123b8e,Jamayah,80,94,2,45,98,40,359,
f97cb8c6-4ae0-40cb-b29a-058e7d978e5d,Jamecia,43,61,79,96,30,24,333,
c7c58714-c4a3-4a1f-9bb9-513b7e9ed409,Jamee,61,11,78,65,93,50,358,
8a62137c-7d22-4505-afd0-21eec948f027,Jamela,8,50,12,84,19,53,226,
14e6b568-6272-4948-9914-f3ceeaab33ea,Jamelia,21,44,73,75,37,30,280,
8368ea86-7e4e-46d3-91fe-64ab6e6cb045,Jamera,25,95,49,27,33,49,278,
3bf1de9a-6a63-428c-9f67-931986a46395,James,2,84,1,73,64,54,278,
1870dba4-5f0e-4c2c-88d9-7189e151d3f3,Jamesha,71,23,45,68,29,28,264,
cd4a3396-f720-4c5b-98f6-94425f19c42d,Jamesley,9,7,29,77,51,42,215,
de1ccf3c-ace0-469a-99b5-e74df91da684,Jamiah,55,36,2,14,50,89,246,
d67f4749-db3a-4f11-b787-130b815c3b1e,Jamicheal,65,100,92,66,85,98,506,
84f8706a-bae3-41ca-989b-1787be8431a2,Jamieann,59,92,3,52,20,85,311,
12e4ca27-b10d-4029-9791-eafd63ec5b34,Jamielyn,9,25,20,14,73,7,148,
9295faf9-7b05-4575-83af-079e47090eb7,Jamielyn,25,51,81,84,77,90,408,
77de0fe7-9c30-4ea5-b935-5820dcd85d4d,Jamiere,34,49,58,90,11,24,266,
c2edf60b-a4be-4740-8ac7-236ee82c6bd1,Jamika,23,73,75,93,69,90,423,
5c936a8e-b1b6-4266-9304-b44dc8608105,Jamilah,80,23,7,71,26,2,209,
56417f20-f22c-4a0b-b46a-bf76b0375c94,Jamileth,54,32,2,89,65,71,313,
818ae4eb-b62c-4848-af36-ab5b38a05cc5,Jamileth,8,49,14,1,61,52,185,
16db4cf1-15ef-45fa-be78-7b5d549890d1,Jamileth,86,94,57,57,4,22,320,
ecb7c7cb-944c-4456-b67d-d0e0c8557e93,Jamilette,57,83,54,32,93,72,391,
cdcf4f32-72fe-4ed7-b1e9-3b50a191a064,Jamilia,35,63,4,12,5,10,129,
982490ff-bf4e-4305-a697-ac241661124a,Jamiracle,45,79,51,67,19,85,346,
14e1b11f-2b8c-4a5a-87eb-dcabf02338bd,Jamisha,94,19,100,15,54,2,284,
8055c846-bb7c-41e4-a90e-45421a955e4f,Jamison,93,48,94,43,71,82,431,
3a465f00-fa62-4af6-8585-1b001dfc4c65,Jamiya,82,20,19,14,34,69,238,
09cf6b03-668d-48e3-bc67-122d2bbf445d,Jamiyl,83,91,3,87,24,97,385,
93e7ead9-6a12-4665-a1bf-81c7ea99b698,Jamiyla,97,99,72,44,94,56,462,
1747976b-7319-46e9-9164-8f91a4ae804c,Jammy,3,42,39,49,95,95,323,
2b4ac9ca-51d9-456e-9436-fac48283ec4d,Jammy,74,81,69,90,81,49,444,
87bb1b08-97a3-4ad0-9440-61939eff3009,Jamon,30,93,88,89,35,92,427,
ae26baf5-b92a-4862-a40a-6ee4ae20625f,Jamond,90,16,20,98,79,41,344,
6eb2e7f2-5575-49ab-bbb9-0160c12ba179,Jamonte,15,87,4,24,67,42,239,
b1b9ef3f-6c00-49f3-adc9-79ec40a5837d,Jamy,17,69,38,2,70,38,234,
b2febb7c-6d4f-4f6b-a257-f1faee461b5b,Jamy,61,2,99,87,31,99,379,
cfe28744-feed-404b-8876-76a12593c48c,Jamy,2,13,17,16,70,3,121,
d77bcaa2-307d-4acb-bb68-5526abaaf640,Janae,76,80,25,43,0,25,249,
00fbd1c9-2891-442c-9ab7-a530cd854be3,Janae,90,3,41,31,39,93,297,
528513ce-2612-4c15-97d3-d960f29f80f8,Janaia,45,47,4,47,22,15,180,
44216f6f-1df7-45fa-9fe3-8ed34d1b11d0,Janautica,44,4,20,75,21,71,235,
fc211516-91ea-4b40-812a-e912cfd011bf,Janaya,0,29,28,38,48,10,153,
0aefc4e0-6632-4b41-aa69-8e0c4bbc1e2c,Janayla,90,52,94,85,71,17,409,
00fc0190-0d9c-4778-ac1b-af60b695c2db,Janea,64,69,23,3,21,41,221,
4c6257d4-8322-4381-939c-27022bb76f4c,Janeah,69,61,69,74,37,72,382,
f721208d-5f90-4664-86d2-26107eedd2de,Janeal,75,43,41,46,18,37,260,
c21549b8-e8c1-43c7-8811-f3d87fae036c,Janean,87,12,21,25,77,2,224,
34df9e49-6a9c-47c9-8fc9-3fb59e47b358,Janeen,88,97,12,83,46,27,353,
99cf25d8-83c0-495b-925b-87daf4e48a68,Janeen,25,0,15,7,78,24,149,
6c232ac0-4a6b-47be-85b1-6e270eb0e3f3,Janeen,72,45,41,64,99,60,381,
8a476392-f0f7-4295-b6d0-0a7b632ec821,Janeli,44,3,45,77,30,72,271,
5c9784a7-7e95-43a8-9a11-207861187ec5,Janell,11,50,68,43,31,93,296,
77119816-c0a7-45e4-8842-87f58e8fd5db,Janelli,48,56,7,56,3,90,260,
458dea7d-17ce-4b03-bf37-1f84296c699d,Janelli,24,60,37,37,22,25,205,
346a9aba-67c7-4b4e-b03f-196e8e89960b,Janely,44,1,13,56,2,47,163,
3f735fbf-7acf-48f0-a364-35b96e0f3c44,Janesa,47,100,21,86,48,28,330,
884062e1-6089-4a47-8fdd-b8b75be5be24,Janese,41,96,19,67,35,59,317,
f851fdbd-fbf2-4240-8462-b8d2252d00da,Janet,100,3,16,32,69,63,283,
1ed18865-fc5d-473e-896f-c2b09224d919,Jania,53,92,6,62,37,87,337,
f7aead28-a52a-48a2-806a-2c8aa47556b4,Janica,28,18,16,82,85,36,265,
42ba496d-b710-4c51-8ec4-9a870ea81a49,Janiece,99,100,43,66,52,68,428,
5236b88c-6ad2-4888-b009-58916a957641,Janika,97,60,85,16,39,0,297,
ae926224-1ebe-477b-897c-accb1c1ad33e,Janill,42,14,27,48,24,85,240,
586fee7b-f1ac-4ec7-90ed-a070cd612ccf,Janique,82,92,71,59,72,38,414,
060bba15-906f-4180-858f-7ada22536538,Janisa,14,13,28,91,90,87,323,
4044679e-864e-448a-bbf0-25029dab378c,Janisha,85,38,37,72,99,66,397,
e7a4951b-7d85-46d8-8423-55ea64185393,Janith,66,49,66,82,2,69,334,
c6c20121-1395-41f0-93bd-a1694137cf9b,Janki,97,62,91,83,86,89,508,
51289e26-a7f0-4a0e-b761-ea5f1d84dbe6,Jannah,12,95,63,21,34,66,291,
c04299e3-faf4-404a-a253-919968887ada,Jannell,8,21,8,34,62,63,196,
14c90c57-a78d-4e11-bbf7-7ecc840fe10f,Jannessa,29,62,15,30,65,21,222,
28b7ee50-f9b2-4835-8ab4-44722f722dfb,Jannete,49,44,28,0,31,75,227,
e7dc300f-e366-473e-95ba-ebae7be78a0e,Jannice,87,6,44,81,61,86,365,
38e44d57-a4ae-40a8-b1d2-e478adf861ad,Jannifer,47,69,24,37,94,86,357,
0c743219-7756-41e3-bf6b-763165824882,Jansel,60,53,10,67,53,38,281,
9ba3d2b0-d60e-4ba8-af6e-a35fe1b35759,Janthony,89,57,6,36,76,14,278,
2aca4b5d-6dfc-424b-83ba-9a0e04d1f4b3,Januel,66,65,12,67,34,43,287,
b0e82706-2dd8-4b9e-94c3-7921df1339f1,Jany,38,58,78,99,64,83,420,
6e30830a-b5f1-4290-aea3-dd02c57fc56f,Janylah,98,57,63,79,14,88,399,
c67bcbc5-64f9-42ce-8e64-9cc082310f93,Janyll,50,90,7,56,99,31,333,
1d2e5b1e-1884-4f08-bc2d-083c1cf3cee0,Jap,58,24,14,84,40,59,279,
1638c94d-cf2e-43c1-a7ab-39a4c259d73c,Jap,91,15,31,87,56,9,289,
4aebaac8-0d57-4429-af2b-0d416b6902be,Japhet,1,33,74,40,52,29,229,
99121dea-f4a3-45bc-8a13-0eaf4728a644,Japhet,7,53,92,73,90,55,370,
c95bb478-595e-4ffa-829b-9e2bae1c6013,Japleen,56,12,81,3,76,44,272,
9e464e1c-dabf-4607-a733-51b4c5c136ba,Jaqualon,47,86,94,63,48,100,438,
7a3987db-a8a7-49e0-8880-4e76cc6310c2,Jaquan,40,88,5,48,38,78,297,
b2070dd1-d49c-4b6d-998f-ac0a02f971ab,Jaquana,86,53,92,82,24,0,337,
4aea0b3d-401a-467e-882c-d7b6236bc796,Jaquanna,18,37,49,75,66,69,314,
e1378d35-6f4b-4b0d-ae1a-e9859b49250a,Jaquante,41,58,89,21,86,89,384,
0bc06ffe-4fe2-459b-9cb4-bdee38510aee,Jaquasia,11,6,93,94,74,74,352,
cbef17e0-d43a-400f-86c0-eab9b5999717,Jaquavious,40,60,30,37,15,64,246,
9e0975cd-03fe-4bee-8ee8-8ce5ea8243d0,Jaquelin,20,84,17,89,90,37,337,
14e5d2a0-9bf2-4d99-8f02-4d2490818d31,Jaqueline,87,51,3,50,13,4,208,
0067b1f7-e8e2-47ce-811c-ad0f50e33c01,Jaquelinne,0,80,77,70,86,82,395,
8e6c27ea-d838-4c10-8cf0-ff3ddbf648c4,Jaquell,2,27,48,76,13,86,252,
656f47fb-5f86-41bf-882f-c46ac40c7fb5,Jaquetta,20,69,1,67,21,3,181,
766ef781-cbe8-49be-ac31-035ce776e172,Jaquille,91,79,44,38,30,18,300,
00c6a173-95a1-413b-9199-2a30f9b64fd4,Jaquitta,38,66,63,25,51,27,270,
82db91cc-1479-4c2a-8492-78925769afdc,Jarad,60,53,68,10,6,85,282,
6c1144a3-7dc2-4e3d-bd35-f768a1ba5c3c,Jarell,78,2,25,86,20,16,227,
74b467cb-0cfa-4774-bb33-3b1f053ac91e,Jaren,63,83,61,49,69,48,373,
e51bcb8f-ea83-4332-afb2-28945d95537e,Jaretzi,99,43,14,74,93,38,361,
109ce004-763d-4ee7-bca5-d1c9dd57c81d,Jaritsa,99,13,8,71,32,3,226,
6653c044-6265-403f-8954-50890dd66d1e,Jaritsa,75,35,38,3,60,74,285,
2f404dce-6ffc-48a6-b547-3947e945ea97,Jaritza,81,64,94,35,82,46,402,
7c635f8f-9677-4277-b6b7-995092eaf7e3,Jarius,56,63,53,22,77,42,313,
97bed4b5-8447-4739-8a2d-8a25301a9e5a,Jarmall,48,53,82,92,28,90,393,
37b2dc0c-d022-4885-a9fb-b8cafd9e7e13,Jarmarcus,20,8,7,90,51,59,235,
82a3b97c-7bf8-4918-b78a-fe3747664072,Jarmel,37,89,61,34,55,6,282,
9f20d40c-702f-48c5-a092-b6cff414557d,Jarmila,48,34,27,81,86,86,362,
59a97b7e-295c-4528-85bd-74fdc3357db2,Jarod,83,54,81,94,34,40,386,
b2b4b018-8972-4c39-8e8c-55007fa6abd2,Jarod,44,9,59,20,38,37,207,
6d24fa97-2725-42bb-9276-db3713f60646,Jaron,2,49,87,94,15,99,346,
e9ea5373-9bcd-49d4-816b-06654da19818,Jarreau,91,31,58,43,42,9,274,
41f9418b-89d4-4a33-a6ee-43d115004c4c,Jarrod,67,70,48,98,34,68,385,
edfe2520-150d-418b-83b4-ae855e40cc44,Jarvin,59,92,94,74,61,97,477,
a6425c11-408d-42b5-8497-0a3657bc3157,Jaryn,36,36,6,61,30,79,248,
cf96e8f4-1ee2-481e-b079-30d3f3f7fa91,Jasai,63,62,50,91,97,29,392,
0a245ad6-1084-4a3e-8542-150a5203e3e7,Jasani,7,28,0,39,6,69,149,
5939e35b-e060-4d2c-b9e2-15904a132c6f,Jasean,99,80,44,80,27,89,419,
568eb8d8-d37d-4ee1-9a9a-6562873ac9f1,Jaselle,28,99,64,45,33,94,363,
e4f2a177-c474-41bd-8fc5-8e1e6572efd1,Jaselyn,43,61,41,53,12,20,230,
0e3f3946-f5f0-4379-82b1-47a0a26587a8,Jasha,12,96,82,20,94,20,324,
9a3e8927-a9bf-4303-afd9-a0c0f4258d64,Jashan,25,94,58,18,29,29,253,
7e5ad4de-6827-4e30-a9c9-d5142d262068,Jashanti,17,6,11,29,91,44,198,
92410922-c256-40a1-abe9-8a65b93e7d12,Jashaun,47,32,81,14,42,45,261,
dd34eaeb-6fd2-4683-aaf6-58f1750ca5fd,Jashawn,89,24,57,59,32,54,315,
bd7231d2-9436-495e-8ba0-fe86942c79ee,Jashua,46,12,85,63,45,91,342,
f9b25083-47f6-4f77-bf07-7c0606f019fb,Jasiyah,47,92,13,68,37,86,343,
a5ef9d3b-995e-45fd-ac0d-4c62a9488ed6,Jaskarn,100,70,61,29,6,48,314,
a97f0cba-19f2-47e0-84a9-aac946424112,Jaskirat,79,85,44,62,2,57,329,
19df9259-c678-4d4c-a975-8190b20f6af4,Jaslene,53,61,41,33,42,61,291,
e3ae5464-d1c3-4b1f-b11b-9a84a51ab0ed,Jaslynn,50,41,84,24,27,24,250,
1f0897a3-07a6-47a9-91fb-5d960c05ebb5,Jasmarie,52,23,73,12,6,64,230,
97cff632-e4dc-4aef-a2f8-90376b2d1b6d,Jasmarie,76,87,78,97,48,64,450,
05b4c174-c716-49e9-b5a0-d744fcf875b8,Jasmarie,34,31,62,55,32,96,310,
aaf65d93-6894-4cf0-8eb0-39e29672f704,Jasmeet,74,72,58,28,13,100,345,
9c0df669-711b-4233-bf31-4ebd60e6e650,Jasmyn,16,35,47,85,82,4,269,
6a65fe5f-72e5-4a0a-89ec-e144f2d141f1,Jasmyne,3,40,30,1,66,73,213,
bdd429ea-588a-48c3-9238-ba02d4c17886,Jaspal,25,8,22,57,90,42,244,
cc084292-1f5d-4f6d-b074-abd9e359a4d9,Jassiah,19,12,23,17,30,81,182,
8dbf6e9f-92f8-4bc3-b8ba-51c029851e97,Jassiel,63,3,78,25,98,30,297,
a98e16a0-42ce-4359-b9f6-4d0613d5aa2b,Jasun,23,36,87,82,69,48,345,
a4cd11c5-6d49-41b6-ad67-8b071dfe08e3,Jasun,76,28,86,34,6,93,323,
cb823448-fc20-49d3-97f5-dec16c7d271f,Jatana,42,30,21,72,14,44,223,
8111576e-bb4d-4a28-a1f1-8b1fe18b89af,Jatavious,99,82,3,22,33,32,271,
34c888e1-e061-49ac-825e-813502d2f2b0,Jatavius,39,83,61,31,43,33,290,
eb2bcc68-85a7-4d6a-a55c-d1e6480da42e,Jatavius,99,53,59,25,60,72,368,
0ef85bf2-f576-4032-94c4-8ef82b252318,Jatinder,1,61,100,0,45,33,240,
5e3cf6bd-134c-42da-b30a-74f2a0bd8760,Jatniel,92,62,48,50,8,7,267,
a9a1cf0e-d30f-45fb-bfa5-8b669e78495c,Jatziri,20,65,14,3,21,19,142,
45ad39eb-e275-4a76-9670-8b233af7183e,Jatziry,38,65,34,3,71,98,309,
0980284c-1d2a-437b-8d53-e44ad837ee99,Jaun,55,34,64,22,45,7,227,
c6161b4c-4eb3-4074-9463-14a695c46abe,Jaunita,45,78,91,19,19,5,257,
ffc6957b-5b80-4b0e-9dbe-ca131af0e403,Javen,4,89,19,16,85,87,300,
21e57d64-480f-4ce6-b5c8-917d99285b41,Javery,11,57,7,7,69,98,249,
443f533a-c308-4631-9166-07a29b3dad7e,Javia,31,49,49,74,31,65,299,
5a303f6d-feaa-40a5-8a56-3f092209dbdf,Javian,76,60,42,43,88,83,392,
68aa6a01-b419-4273-a632-ddb54ec91d0f,Javien,63,42,24,86,33,66,314,
e961c7cc-93fc-471c-a222-5a74e7281b6e,Javin,52,17,28,9,37,76,219,
938ef0dd-f64c-4ba0-87bf-4638970c9b22,Javoris,88,33,64,94,69,85,433,
26bb102d-a48a-4018-bacc-0772d5957fc4,Javoris,56,46,98,17,6,80,303,
5da9cf83-27fa-47a7-86b3-74dde04a63b1,Javoris,83,7,8,15,92,69,274,
e94eb45c-6e0d-48e0-8b6f-ed60d83e7200,Javoris,44,32,10,33,86,39,244,
646da0ec-1b1b-4bd2-95a3-96ec9366dafe,Jawad,70,43,12,1,88,52,266,
07cb6df7-ffe5-4530-adf5-6ccb280d3532,Jawan,50,88,95,34,14,26,307,
92e6dc63-4f4b-4395-9fc8-dd8f296ec4da,Jawanna,59,61,80,21,89,70,380,
b2027312-3540-4330-9177-4487c5a76f53,Jawara,27,62,50,55,34,43,271,
e3f8d7a8-f61d-4472-9255-99d75296200d,Jawaun,16,51,50,19,100,24,260,
47e92090-f6b9-4471-93df-7c55b568ddfb,Jawuan,14,89,74,63,33,57,330,
ff4ede6f-2e62-4ba7-80d0-295f1b9d7906,Jax,15,70,7,45,79,47,263,
554ff07f-1266-4a6a-b7fe-090d9a05fec4,Jaxon,29,14,37,41,66,72,259,
f0e80a52-e416-4b8d-82c7-6b547463f7db,Jaxon,71,52,68,69,73,65,398,
34784c5a-96e3-4841-b54b-d347cf923ccd,Jaxon,20,97,53,32,66,68,336,
bb20c48b-26a9-4e16-bfad-42ab761b939b,Jaxsyn,3,48,5,24,17,32,129,
91adffe3-83d3-4639-a4a7-2825b471da6d,Jaxton,78,58,63,40,53,55,347,
699da367-031e-4356-85ca-cdb36e1cf002,Jaya,79,84,100,46,37,83,429,
9682a54e-6c63-471d-b078-da16338fe698,Jayan,11,78,97,0,90,61,337,
8384fa6b-4d33-4cc7-8e17-b7dd4f90ee6c,Jayan,40,74,74,32,51,37,308,
b42b314a-83bf-4115-83d1-47129f71dfa0,Jaycelynn,28,17,6,66,61,70,248,
7dff5603-b6a0-4902-9c5d-b5a5527962e3,Jaycelynn,28,3,1,100,22,47,201,
9e6ab56f-e399-4a86-a454-786bf893dd8e,Jaydah,79,62,70,24,37,14,286,
dd76a12b-0bc5-43e5-8dbd-d29647a04214,Jaydah,3,31,17,9,22,17,99,
ea7a6faa-f60e-48f4-8ab7-c4c3ed05e89e,Jaydan,37,18,98,97,48,67,365,
b1935c88-559b-4b01-a147-e9409b4d8fc1,Jaydrian,91,59,78,10,82,1,321,
2d6ff6ac-09fe-4fb2-8564-09064cf16f3c,Jaydrian,8,99,83,77,70,35,372,
111c59c6-2ea5-460f-9a25-7e72bfcb7153,Jaykob,98,2,80,74,2,8,264,
e1bc820c-b6eb-4e10-a9ea-87d3a674cfa1,Jayland,63,60,39,17,2,2,183,
e804f5ac-4f38-49d6-9f10-8890f1e8ed39,Jaylani,13,39,51,54,81,86,324,
280c8863-4304-4b2b-8722-dbdc1d1c98d7,Jaylei,53,65,32,89,87,75,401,
10d58c72-cff0-45cd-a4bc-fe953f76ced3,Jaylen,56,59,55,78,17,40,305,
761a6861-ee6b-48c7-a7fe-32c421abebb3,Jaylen,56,15,85,87,18,68,329,
fc19ae03-fa1f-45fc-a722-d96adad41d21,Jaylenn,35,71,81,36,47,68,338,
f7335b4e-786e-4664-bd91-337c30a68d69,Jaylie,28,89,33,53,8,54,265,
aa81390a-f3e5-4357-9c68-f160ad284ccd,Jayln,17,82,20,58,69,76,322,
40728bc4-ed8f-4520-b3ff-3aea1d1fa8c7,Jayln,97,61,94,49,81,85,467,
d4110018-6f9c-482f-98a6-49c8b16f6dcb,Jaylynne,89,7,90,94,11,17,308,
86f33567-7880-48d3-89a4-fe3f52f0b50b,Jayma,7,98,20,36,63,37,261,
cd09c3c0-d27c-4d94-bcf7-3a169b25b39b,Jaymee,32,26,87,77,70,71,363,
a38f3c78-880e-44e0-89bb-3dc286e8f34b,Jaymes,95,20,15,98,11,63,302,
0ecd8d9b-83d8-482a-a749-735d5724c866,Jaymie,34,55,76,55,13,0,233,
1e24fd91-45c4-4ba5-a3cd-f7760afea650,Jaymir,68,19,46,6,46,29,214,
9f223597-0d36-44a7-9334-e1af16c79960,Jaynee,62,93,63,51,58,100,427,
f77a190f-42e4-4514-8250-bc4588a38775,Jaynee,58,91,34,50,0,97,330,
b4fd4258-97ac-4454-aef5-03efb8e83c3d,Jaynie,50,7,53,83,92,70,355,
49164114-52b8-48dc-9452-46abaa7c77a2,Jaythan,52,75,19,35,52,10,243,
5cafed57-41c9-4997-803e-1b6bc7677a0e,Jaythan,93,11,68,28,19,79,298,
6607cfbb-3711-44e3-9c33-6a995f07c948,Jaythian,91,69,15,86,61,3,325,
220dfb3d-e115-4ec0-b15e-ce4e80c28ee5,Jayven,73,9,9,15,3,100,209,
0db78f13-ff93-42a6-a92b-6ee9c8c7ca9b,Jayveon,79,29,18,15,4,5,150,
13bb6959-e558-4537-ad2a-10a99cc99ecc,Jayvion,97,36,4,51,75,56,319,
7aa51312-0583-451d-95c9-874e9fc84872,Jazaria,68,30,82,85,91,26,382,
a29af2dc-a78e-471f-b54d-1c288c117032,Jazariah,77,61,69,18,81,57,363,
41e91b4b-cbbb-46bf-bcb2-43d5b9a09d16,Jazariah,97,22,43,56,9,11,238,
e3e3ec4a-ce14-49cd-a808-def5fbe44fe6,Jazariah,34,81,72,28,64,36,315,
35a7df61-5579-4b7d-8bc9-3f04f1622b57,Jazelle,88,1,13,49,59,47,257,
7ee35dff-ec7e-4483-a882-436de537530f,Jaziah,16,90,27,65,34,84,316,
64a3fa6a-0c14-4845-9e73-6acf1cd5c6d7,Jazira,95,53,99,59,8,91,405,
47fa1e32-986d-4681-9c55-63184e987d80,Jazleen,68,46,0,3,82,69,268,
98ccdd00-4b7e-4f7f-b4cf-34d05fa4e2fb,Jazleen,19,28,84,12,70,25,238,
98c3e461-ec3f-4497-b171-a5c66b5c350b,Jazline,40,57,0,90,53,84,324,
1b0217ac-6f28-4e09-8c3b-754efcb1f479,Jazman,23,72,80,84,26,4,289,
11f81663-cf5c-4ab3-adc1-8ad6362d059f,Jazman,10,79,64,85,10,91,339,
cbd433c4-64ea-47bb-a3fc-d8670bac15da,Jazmin,24,83,9,98,72,5,291,
f96633a1-a09f-4614-92f9-b66d16b7daa0,Jazmyn,94,33,95,41,74,96,433,
4b0aae1a-4e60-4859-9cf2-ae0189a8ac86,Jazmynn,20,19,51,17,75,95,277,
3d9a9f52-fd71-4c2e-9e1f-7fd195ea0665,Jazzlin,95,90,0,82,33,89,389,
93cd0f27-43af-4b95-bac3-4ec1ca4e4ad7,Jazzlyn,65,33,35,91,92,71,387,
757bc931-ba04-4dce-8c5c-6bb18330899c,Jazzlyn,99,10,68,24,91,91,383,
8f65a142-18f3-46de-9107-2374d91b3d96,Jazzman,64,74,6,5,57,4,210,
750f6fb5-e221-401a-bbe4-74f844bb5241,Jean,42,98,50,1,13,90,294,
fdab2cfb-3fd5-4761-8422-eadc530bdd01,Jeanae,60,19,32,0,96,97,304,
09041a53-0533-4b09-bde5-733cbad05c93,Jeaneen,13,100,27,29,11,11,191,
00194e41-bfc3-481d-83f7-9e20c7cb93f9,Jeanet,18,68,20,61,55,9,231,
bd436866-fbd0-49bc-8e6c-0266f3de17b1,Jeaneth,36,66,94,18,92,40,346,
cb84b3dd-eb77-4daa-864f-07061bda889b,Jeaneth,56,9,86,7,74,84,316,
9b615bd2-77ca-4eeb-a02f-0ad23bf36b94,Jeanetta,34,8,85,80,14,75,296,
c7e39e0e-dc05-499b-87d3-91415cb6127a,Jeanetta,34,47,22,14,17,74,208,
84c4bc0d-f16f-4a73-8c6f-1f80d76a5b35,Jeanette,50,90,15,92,29,45,321,
20a1b9e9-d2af-415e-a2de-076b0b5c87cd,Jeanice,67,20,39,5,15,71,217,
629f7e1c-05fe-43ae-b006-e6fc4f4f97f7,Jeanmarie,24,88,78,45,73,22,330,
b84ecd4d-0f96-45b5-973a-9644f1898b1f,Jeanny,85,24,80,96,73,89,447,
b1d9bd8b-99a9-4057-8366-8336fc7dab31,Jearlean,28,33,49,33,61,1,205,
55adb1fe-1aa9-4420-94e9-9e4c94fd7a3b,Jebediah,28,60,87,78,37,4,294,
9a81f710-153f-432a-a865-fb737e5019f0,Jedediah,84,57,30,65,25,73,334,
d550087c-e5e3-4a68-a93e-4b481a7a35b3,Jef,23,98,37,75,6,5,244,
35328493-cc56-4249-9731-42b610f7cb89,Jeffie,65,7,40,12,26,39,189,
2d8d1b4a-0381-4e39-9e58-74b6326dd660,Jeffrey,96,64,2,15,39,42,258,
34f50b33-b684-4dd5-bbcb-021599353db8,Jefrey,55,46,76,15,52,38,282,
9caa814a-6d79-445b-9f14-546ee70160f1,Jeilyn,85,44,14,25,7,54,229,
2d357f3d-4610-4902-acea-6676901154ec,Jemarcus,60,63,17,62,51,12,265,
0ff13663-cd7f-4e84-848e-ee9eccefca8a,Jemimah,27,100,74,26,48,33,308,
be9402dd-a8a3-4679-82b1-c51d7ae38c98,Jemma,31,5,88,25,18,50,217,
5d315113-51bb-4f50-8754-6c89c3dae45a,Jenafer,100,30,72,43,47,4,296,
e0ead34a-9c6a-4f1e-8cef-08cd33d17188,Jenai,3,40,40,74,19,42,218,
c34677e1-15f8-47cb-b81d-d0699f2f9bef,Jenalyn,62,12,19,82,7,54,236,
0aa51497-e174-44f9-9fb5-dfc997593ea4,Jenaro,10,77,21,87,74,92,361,
fe877688-2dbb-4173-9d89-42e596396f6a,Jenaveve,64,78,78,63,20,13,316,
c1fa73ce-7148-4c3b-baad-b9c55c0b01a9,Jenaya,76,11,92,95,41,93,408,
1f510a33-6be3-4dfa-8e75-bf367ca6a277,Jencarlo,77,22,24,27,0,20,170,
d26fa327-af16-4bf9-b566-a9a0128db4bf,Jencarlos,36,76,95,98,57,11,373,
608b0e49-97d6-4070-b08d-9f7084cee34e,Jency,57,10,79,10,41,16,213,
18a4020c-34a9-43c8-be84-16c1432a394f,Jeneane,71,97,99,61,10,5,343,
2e392d3e-0e49-4552-b222-cf1375e170f1,Jeneen,97,12,18,59,1,51,238,
52b2a59d-0043-4c78-ad12-430387dddcd5,Jenel,20,75,26,82,21,89,313,
2b2b7ecb-5066-46d3-98c4-aa0df2395faa,Jenelle,71,72,31,98,94,52,418,
cab79689-a442-49cb-8c82-64807deaa51f,Jenene,58,35,99,94,18,63,367,
69a22628-2e97-4b28-a2d5-f0245b1baad2,Jenesis,0,46,77,71,42,31,267,
94563418-c8de-4f5b-a0e1-a10209e73cce,Jenesis,69,83,96,57,15,18,338,
29598689-7fc8-452a-a3e8-bf9bd0dfee97,Jenessa,66,4,54,90,66,38,318,
8e173fa2-25e9-46e7-82c0-1403235cbc09,Jenessy,63,52,79,48,68,28,338,
e73c77ea-c71f-40cd-8f84-6a9dec804f4d,Jenette,90,98,71,23,39,99,420,
5b3d0a0d-bc7f-486e-b131-c00889d74953,Jeni,1,1,6,16,39,37,100,
2747a36b-b468-404e-babe-f166c754f98f,Jeniah,46,50,97,3,51,4,251,
900baa43-5d4e-4aa5-bd33-2e934ee10d1a,Jeniece,48,78,54,8,46,20,254,
edcaf32f-011a-46cc-ae6e-32e515c9fe3b,Jenipher,11,84,63,12,31,22,223,
3229ea05-06c3-4256-a783-a8cf0538d036,Jenna,13,88,19,70,52,84,326,
42cdd280-4660-4fac-970a-cfacec23b8a2,Jennalyn,18,52,11,76,16,52,225,
fd16037f-43e9-4a81-b13d-3988669456cc,Jennefer,67,34,63,97,57,47,365,
a0b4030d-5f7b-458d-9ff1-c31eda1a8549,Jennell,4,83,5,11,80,95,278,
47dc65ac-b70f-4837-970b-f5a63b0eb5f8,Jennell,75,97,54,49,30,94,399,
e6c8b0b0-5da7-4158-adb0-af14941c8776,Jenner,95,85,35,32,7,99,353,
4488ce4e-487b-4816-9a92-98c0ce63956c,Jennessa,56,69,10,72,70,30,307,
084a3249-9d4e-493e-bba1-f780c33b325c,Jennessy,13,21,30,81,68,10,223,
66d89f5c-57e0-4419-a142-170bd3e3eaa6,Jenni,88,71,96,51,87,28,421,
f029c5ef-8ae6-42c1-9282-cb2ecd97bd9f,Jennica,54,94,77,12,95,61,393,
27d574c0-b356-4673-ac39-ef9296199ffa,Jennica,49,83,89,93,96,96,506,
661d24be-48d3-4ac8-b474-a4b2811643ae,Jenniefer,89,55,36,95,74,25,374,
0c15ad37-5588-4d84-b3b2-c2c70d6352b3,Jenniffer,96,13,25,60,39,60,293,
fc3b967c-b3d0-4264-8751-5d703bb108bc,Jennifier,79,74,44,87,91,87,462,
ced90e12-8478-4e93-b067-6abb87786c6f,Jennika,92,40,99,3,79,41,354,
c7447212-604d-46ee-baaf-2f24d9de142c,Jennilee,26,81,44,92,40,28,311,
29a4be1a-2457-4dfa-9129-3055e8e6d827,Jensyn,9,17,7,100,15,94,242,
e542501e-40d4-4d48-bcc3-70ae6e3d7003,Jentri,42,34,34,0,62,5,177,
3f9a0af3-0498-49b9-98e7-19a2f06d985d,Jentri,58,7,80,42,61,7,255,
03f65ca4-031c-49b9-b760-4ea17d7c0a77,Jentry,97,93,66,28,28,24,336,
5d01c919-fae4-48ee-a617-521ca2fc9a09,Jeovani,48,46,5,94,31,89,313,
b2ba2183-529e-4c29-b0f2-6ae1962e9ae1,Jequan,69,50,75,0,16,84,294,
8c32161e-809c-4ca2-b7fc-bacf055dc9d8,Jerald,62,83,96,40,36,47,364,
a2130207-bc7a-48fa-a06b-e5b916ab8b55,Jeraldin,60,60,52,69,63,81,385,
633faec9-e804-41f8-84b9-6fca5e828084,Jerame,98,43,64,83,72,64,424,
3453aaa2-6e65-4413-bac1-adea64a0f5bf,Jeramey,88,95,84,34,37,62,400,
59ed5699-7405-46e6-8cbb-a34901d7e891,Jerami,56,35,12,59,74,32,268,
9b9fe264-16f1-48be-8231-6c895031a82d,Jeramy,86,70,35,64,79,39,373,
62453a3f-7e26-4d1c-bb98-5a587a6d922e,Jerardo,53,21,21,26,91,40,252,
38a0e1e8-2759-4971-beb4-f8b01355f7af,Jerardo,71,30,26,46,26,92,291,
3748d7c7-0010-41c6-9a09-39817a7ec376,Jerardo,6,12,12,93,29,79,231,
bfdcca45-be85-4eae-afc9-495dd0fcc725,Jerel,49,14,31,34,82,50,260,
8db5a459-7507-4409-9f14-bad665509a0a,Jerel,37,41,31,6,30,52,197,
da1803b6-c264-4038-891f-e89e54b5f58c,Jerelle,18,48,88,33,81,84,352,
8d1c1ff6-cd14-4526-a010-213942419033,Jerelyn,46,82,11,39,96,35,309,
acc9f0c8-58d2-4a54-bf4f-62ed2a916735,Jeremy,80,97,21,49,53,56,356,
f8686ced-5435-48cd-8e93-c25c6dbb36d0,Jeremyah,25,90,61,91,16,22,305,
c96aca44-bf67-410d-be78-fe73b0fce8ee,Jeremyah,98,78,39,69,66,38,388,
be662950-7b47-44f4-ad4e-062f5f911b25,Jerene,25,97,71,57,21,48,319,
e5fa4905-39ff-46e1-affb-5b452e6f16b3,Jeri,83,16,29,63,85,48,324,
a8a84a0c-aa1b-47ce-9ea3-1e02fd7a0dbb,Jeric,69,17,75,75,34,74,344,
06e15ab9-4595-48b9-b8a5-e56ed0501980,Jerick,31,59,66,55,34,91,336,
81447a76-bb2b-4014-8e18-5258448dd442,Jeriel,22,35,16,29,62,52,216,
dff27e37-76cb-42d2-bdb6-5e7ef516765c,Jerika,3,6,4,17,37,42,109,
d8971e21-a784-4d7e-8ef2-8d020c0b274e,Jeriko,89,46,63,53,81,60,392,
a606fede-6953-491d-b8a1-80863cfdede8,Jerimiah,82,53,90,33,0,48,306,
a0ece645-e9d3-4110-87eb-9780027d8b6d,Jerimyah,16,54,45,87,43,10,255,
db56b80c-1e8e-4afb-ab1e-862301aa2530,Jerlene,91,26,18,21,69,33,258,
ce826864-bf9d-4e94-b8b4-1feeb1ad3aa6,Jerman,76,80,67,54,32,43,352,
77401d2e-0b9e-4d96-98fa-3711e43c4ff8,Jermani,81,27,18,18,18,18,180,
a2341308-ea2d-45a0-a6e2-4e5faf95ba03,Jermarcus,70,88,5,85,96,34,378,
57a53f2f-ce87-46e1-b7ff-7a6b7e98dd6c,Jermarion,75,84,46,67,89,96,457,
0cbce84a-76c9-4532-96cc-536b4fdbfb42,Jermel,27,54,95,36,23,25,260,
f0f8fc14-641f-4fab-8976-ceda7fac681f,Jermiah,17,34,30,37,29,33,180,
6763a27d-5baf-44ee-9bce-e89bea3dcd76,Jermie,70,42,93,39,41,40,325,
c17d6f75-e2fa-40d9-8eb1-125567985903,Jermy,22,34,11,58,28,58,211,
7d1f1e8d-4995-4a37-92d1-961d29636a54,Jeromy,1,66,21,80,9,76,253,
194814d6-b668-4d63-95d7-b23eb7772f79,Jerra,68,59,68,41,45,38,319,
95526bb6-e0ac-484c-b01e-3edc1cc35cdd,Jerra,36,12,45,59,77,4,233,
a54a3dc3-6500-4077-b8d9-8d3ec9990bc3,Jerred,61,16,2,57,89,22,247,
15ffc1b4-7840-4baf-935b-37b76ab195dc,Jerrell,15,71,14,81,28,3,212,
848391ac-d1b2-4231-9d6b-1e8e883e7194,Jerrick,45,67,38,23,66,5,244,
ccf23367-0db3-4e55-9d99-e13b7312c6e0,Jerrilyn,58,42,2,42,58,74,276,
3197be34-7210-432b-b974-9884d99c5148,Jerrod,28,32,50,81,26,73,290,
0043fe73-a98a-41e9-9ba3-e35a5c4c34f8,Jerrol,89,31,22,21,74,97,334,
c64742f2-646f-48b9-9353-a8411b1da344,Jerrold,12,14,51,28,6,2,113,
500845ca-d1d4-4d4f-8b1a-c70732e7c610,Jerrold,54,11,58,83,51,25,282,
88d00eb1-9931-4825-988f-87167babe0e1,Jerrye,41,45,24,2,5,89,206,
6706cb29-acd8-483e-9ed3-bbf7e95f470f,Jerrye,44,93,84,81,34,90,426,
ff488f01-37fa-437e-af77-46f158426be6,Jersie,64,6,33,12,95,61,271,
affe0f9f-3996-4746-b98c-a9172fa120c6,Jerson,27,54,97,15,70,85,348,
e96d2012-62eb-4b2e-a0a4-159bd2a1fb8e,Jerusalem,8,77,82,94,90,10,361,
751ed328-7f22-4c67-9987-096eab9c42ab,Jeryl,2,28,7,61,73,4,175,
b3661518-a606-4128-ae39-7e0c2c1ac140,Jesaiah,21,58,56,76,9,93,313,
370a1091-d1d2-42bd-8b93-5df88d5c4500,Jesalyn,17,97,15,19,46,63,257,
19952f76-8cb1-4075-a834-da1216fc6831,Jese,3,67,30,26,84,27,237,
6fa75348-1362-4eb9-94bc-6343fed6537a,Jesenia,57,30,62,100,5,57,311,
6795bf43-36dd-4fac-b6cd-9a9a72840642,Jesenia,91,80,6,89,60,37,363,
c4e81074-266c-4435-80fe-aae65bac8291,Jesi,5,72,2,67,64,16,226,
3cb329ae-39b7-46e0-b07c-3412d4ef96c7,Jesica,31,40,44,11,82,68,276,
e2936c40-4ec5-4e04-98e4-00df42db80da,Jesica,5,93,53,2,41,54,248,
868e8d0f-e98c-4c20-9669-b92140fda0ce,Jessamyn,55,87,47,77,72,26,364,
be031039-b8b5-4a5a-8e5c-b03a39560062,Jesse,77,28,72,57,44,63,341,
adbdf73a-21a3-4426-909f-c9e8f8ed47fb,Jesselle,56,100,55,35,23,58,327,
9b5d1e8c-03c5-4fa4-90a2-a157a7f85158,Jesselyn,32,100,99,90,68,9,398,
2c02855b-1fcd-4e94-9aef-cf6ae36a8fc3,Jessicamarie,16,89,11,23,76,47,262,
6c44c93b-a117-47d7-a63b-c37c597d93ec,Jessicia,38,93,47,16,65,45,304,
a4da832f-dd24-4e0b-a454-52ac777f7704,Jessika,69,91,53,46,36,41,336,
14f895b3-6356-4084-8d6d-07ccfeb4ecec,Jesslyn,83,7,77,58,7,13,245,
493a88e5-267c-4649-a00e-fce2cc2902e5,Jessyka,17,54,6,16,46,22,161,
618d0f6e-283d-4d76-a59d-926c50a7651b,Jessyka,80,96,71,45,62,69,423,
22d1725c-9eb0-4d9d-aa0c-15500bbc3011,Jestin,43,95,18,47,43,73,319,
2e3ef122-d374-4ab3-ad83-0f50d66c44e3,Jesu,8,20,79,29,69,27,232,
32df332c-e06e-4f50-a484-0a46192418da,Jesusalberto,15,62,58,10,49,11,205,
444ac765-88bd-43c7-9bb7-0b5111af7cea,Jesusantonio,100,78,61,15,99,77,430,
e87da73a-9de0-4e62-9964-bccab823a090,Jesusantonio,58,83,69,28,22,1,261,
35af5613-0d4c-4ff1-ab98-718e776c6e7c,Jesusita,49,67,2,70,17,15,220,
3fda4558-c30e-4f80-9010-c2b06365faa6,Jet,79,21,40,20,77,57,294,
455dda84-7bf8-445e-93ef-7d6b4ca835ab,Jet,49,46,35,74,76,76,356,
888a4945-48e2-4701-9fa0-36c245544a21,Jet,98,99,78,84,2,25,386,
71cbeacb-890e-4be6-9a3f-97af3da89da9,Jetaun,13,25,36,63,94,37,268,
8d0b0183-1d22-4006-81e0-a831691a1d8e,Jeter,78,50,7,83,94,6,318,
ad45f58d-a0ad-487a-bea5-dd99fe6eadf9,Jettie,82,26,28,9,79,25,249,
3242ec5a-252c-4f52-a346-544528f7030b,Jeury,34,41,10,54,94,51,284,
5dc8379e-9309-43a4-bbaf-1d4f45bcf9b7,Jeury,28,65,5,98,98,96,390,
b667c966-c2e9-4848-aed0-b15cb59a8e47,Jevan,84,78,57,82,29,75,405,
dcefaa6d-546d-4142-ad74-09b34148ebd5,Jevon,64,98,85,37,66,17,367,
991d3c39-5c44-475e-8d5f-4c672b0b3bda,Jewelene,77,89,49,93,58,53,419,
7b8d3133-00f0-4a41-9991-5a68985427b6,Jewelene,49,77,82,74,17,100,399,
2f9c406c-af91-4f5e-a0ca-397da6d440a0,Jewelia,23,4,40,62,83,99,311,
7914b361-3874-4349-8f7a-ca3f9940f747,Jewelz,100,47,2,68,82,99,398,
9ff284c3-3a1e-4693-b51a-73361de27b84,Jeyden,15,54,63,65,59,7,263,
0156f35d-f133-4fd5-adfc-30cc92570698,Jeyla,77,73,69,57,7,19,302,
4c1b31a5-744c-443a-803b-967e9772c26c,Jeylah,34,75,79,33,84,59,364,
3b2c7877-1eb4-461a-9e40-680f19deed48,Jeylah,37,19,61,59,62,0,238,
b30ce3da-a375-431f-8bea-0b998f1eb449,Jeyson,78,72,76,79,44,93,442,
f64bc214-7eb2-4b0d-ba72-c431267da1c0,Jezabel,13,63,48,27,4,77,232,
db46992f-4e6c-41f4-be03-63d1e2a6e5eb,Jharline,37,86,87,51,76,23,360,
7173f52d-e4d5-4800-a86b-e55839c93977,Jhett,14,91,10,94,46,87,342,
4a68d8d4-d48c-47ae-b5ae-a05c9b52cde4,Jhoana,16,39,68,99,89,77,388,
2a3ee4ea-244d-4d5f-a738-74173cffcd7a,Jian,21,36,37,43,12,55,204,
8dee5dcd-9a84-45cf-82f6-0f00e20b96be,Jian,32,72,16,74,33,7,234,
990cc8c1-ae02-437a-8709-21fa34192912,Jie,8,58,20,37,47,11,181,
f1f18eb7-b3d1-416d-8b7d-804371101b52,Jigar,26,20,3,69,82,23,223,
5ba5b92e-cb0e-4ab9-9636-e8bb86fbd151,Jigar,18,71,45,77,11,50,272,
5864e77b-15b9-421a-968a-900ce9952d51,Jil,80,79,20,63,33,85,360,
8d3383c6-16f3-4af3-bde0-1992bb3987f2,Jiles,36,8,2,46,51,52,195,
1499f952-7c4f-4789-acdc-930042c3aa98,Jillaine,90,99,1,23,96,62,371,
8e6e635b-14a2-440b-a859-57f8e9e75abf,Jillane,82,41,86,37,47,32,325,
a1ca59f8-c452-4c98-8d36-8a084c1902e4,Jillene,67,64,80,76,88,58,433,
022b7c2e-3724-4ea4-b851-c9aa1dd3cbce,Jillianne,0,7,19,37,6,86,155,
cdfa6b0c-8f15-476e-8aae-68cf83dedd05,Jillyn,65,72,62,75,94,41,409,
f3086294-01ac-4a7d-8a55-d703e1197602,Jimmie,51,96,79,72,73,35,406,
26e013a5-f66d-4d11-9284-1492e149ddd6,Jimson,41,60,56,91,61,8,317,
7f3ce569-d8bc-4123-80cc-f9dbf9f46cc9,Jina,100,56,52,9,11,85,313,
e286fdfe-1f46-468f-8e1b-4a4c9b2cca2c,Jinelle,91,94,94,41,28,71,419,
614a928c-6fa2-4636-ace1-41bafe0153ad,Jinger,78,80,13,71,59,21,322,
4e95d158-c2d5-4444-85c7-bb97ae9bb1f2,Jiovani,33,84,29,95,79,28,348,
1cc1221c-d7f7-45ac-88c4-acb12d73d2a3,Jisela,8,78,11,75,31,82,285,
a0d643f3-36d3-4eae-b425-28c3a3644b64,Jisell,92,19,17,81,86,75,370,
4788f552-cbfe-4356-83ba-0960c2c7cae3,Jizel,48,22,71,5,85,23,254,
5690aa66-d269-4209-b34f-9b42724609f0,Jkwon,27,64,43,41,4,41,220,
613f1a8e-b670-49d9-8dee-e2bc2f1741d7,Jniyah,55,3,31,85,91,98,363,
77e35a2e-4bf0-4ef3-96d7-75271f38a40a,Jnya,12,32,80,48,41,77,290,
e0158b93-d0f2-4a82-acda-56b5031d91d0,Joanann,67,65,70,25,8,50,285,
364ff829-3a97-4f0d-89ce-e85e0a82c196,Joangel,13,71,55,84,58,49,330,
3704d7a7-f8f2-4546-9883-ae1ac16ab408,Joanmarie,62,35,46,30,50,100,323,
acb9c57c-5726-4766-b090-fdd600ee223e,Joao,27,62,5,32,26,99,251,
9bce7ae0-9bf0-4265-b1f4-5a6f8d6d150d,Joaquim,6,49,34,63,47,55,254,
189605a7-a18b-485a-af1a-f321a646a596,Joaquin,27,24,53,39,66,62,271,
4b177af5-f366-4fd1-ab4a-e02b4de58fc6,Joaquin,59,29,15,60,35,49,247,
e6ad720c-8e74-48f4-848c-ee38c17b6238,Joaquin,81,90,70,52,50,6,349,
dde665b8-6d3b-4d78-913c-e79a7ed23acd,Job,10,79,61,87,80,93,410,
92461de8-bf25-43ae-8284-19761717929c,Jobany,59,58,69,55,15,24,280,
8f8ef3ae-e497-45fb-b953-519e4531315d,Jobin,13,33,2,3,26,1,78,
f3c5130a-dbde-4ed7-b9ae-798d102dc4d0,Joceline,42,3,8,6,79,45,183,
ef9d73c6-9a69-46cf-97fe-31c49937a690,Jocelynn,93,3,37,20,3,32,188,
26cb9426-b850-49bc-b8c9-c028ac62bcad,Jock,99,76,36,19,31,71,332,
555d3a39-4446-4bde-9bfc-a2c044bde3b3,Jocob,8,39,51,14,65,80,257,
9de53766-87f8-48c8-a882-a9995244c8e2,Jodeci,61,90,45,86,51,26,359,
57ab6df0-90a1-461d-9bff-555e1c78b56a,Jodeci,74,37,88,39,74,40,352,
576a1c8a-83c5-4da6-9257-ea2bdd9dc7ad,Jodeen,56,22,89,84,45,50,346,
ee3c57cf-4136-4735-9475-89a5ce993ac9,Jodine,9,6,29,44,55,55,198,
687bae6c-7333-408d-8a6f-ad8e96684de1,Joellyn,54,99,22,10,69,55,309,
56c520ff-4eb5-4648-a896-9792fc328b60,Joellyn,92,8,1,74,7,91,273,
610c2bb7-afe1-4453-b4c4-28047746858f,Joelyn,56,90,61,95,45,45,392,
4906252e-87d5-40d8-9cb6-db032f0ef0cb,Johanne,52,9,41,91,92,93,378,
70b247df-0fee-4646-9dc3-0abfec67882d,Johanny,89,90,56,61,98,57,451,
ac54942a-a3cb-42b7-be7b-a4d44bc6bb1d,Johnae,86,35,28,55,16,11,231,
9dba462b-8c8a-462e-a1fd-846abea0c4b8,Johnatan,68,93,59,54,2,81,357,
88d2c53a-b44d-4e45-bfe6-c277487a048d,Johnatan,6,51,56,82,29,41,265,
ba9fcaa2-978a-45d8-9188-24d7646f80aa,Johnatan,43,16,36,64,55,58,272,
9da908ad-ef83-4354-9c97-4d684ada4549,Johnathan,10,40,95,13,87,35,280,
78536d25-796a-4925-a24e-fea0d38b0b19,Johnathon,45,36,10,46,39,66,242,
9ad4eb4f-6584-454c-8a51-2fb75d110963,Johnavon,4,16,61,51,40,76,248,
f1e35832-3a62-42cd-928b-5bcc5a2df810,Johndavid,95,40,16,87,62,37,337,
56664d1e-3e50-49fa-9a5a-e63ba5474da8,Johnelle,24,54,89,96,84,75,422,
6a06b710-80d6-4772-9d09-add1e839093b,Johnetta,90,17,25,37,88,96,353,
3ff80baa-8658-4424-ad7f-ea0a6351187e,Johney,24,30,44,19,60,45,222,
ff888326-bf89-4f89-97f2-66fc9ce4b245,Johnisha,1,61,38,75,57,11,243,
4e1c071b-925f-41d9-9af2-83fae7f5ab48,Johnmark,93,37,50,37,5,63,285,
538a1a89-dccd-441b-a650-55b4c6098a40,Johnna,41,91,98,90,23,15,358,
f8aa79c9-3dbd-410f-8fb1-5dc7437828e5,Johnnie,15,33,50,39,74,34,245,
568bbe0d-9800-4467-874d-f86036bbb084,Johnnye,46,39,55,58,11,88,297,
9b44c83e-3a4d-4be8-a437-0ab108a2d764,Johnsie,88,48,33,73,20,43,305,
b72cfe36-0c48-44fe-8f17-84468b760cae,Johnsie,36,1,29,26,55,75,222,
e4706801-6c0e-41a4-80c5-3cb44b6ffa2b,Johntae,24,49,46,29,89,76,313,
ad898e15-6d00-4f95-952e-455554ae4f08,Johntavious,89,75,13,90,5,58,330,
025f49bc-9bb8-421a-aa5d-37dcf97924ca,Johntavious,67,63,17,63,90,45,345,
000a45f5-3b16-4984-8372-d5506bb9dd96,Johnthan,67,82,28,49,83,41,350,
9542e65e-d06b-4353-8c0d-8a34ab689af8,Jojo,97,54,56,84,87,32,410,
2862335e-5ec0-47f5-8fb8-223c0f356ad8,Joleen,66,19,22,13,61,87,268,
09f18f12-5c89-4a2d-ab07-2aca1988e79f,Jolene,34,85,23,97,73,85,397,
6221b620-1357-4e38-a3ff-41de888fb119,Joley,82,17,53,21,3,90,266,
68efab27-9c60-4e96-9baa-35fa5f31916e,Jolie,72,98,48,31,40,24,313,
5bd39c6c-aa15-49f7-ac80-64e206dc4895,Jolyn,86,66,42,54,69,4,321,
cd9e66d9-7be1-429e-9b0e-edf82226de2b,Jomaira,5,32,78,2,38,76,231,
e459ae37-8c55-4ee0-9ad5-9e6c9636092c,Jomarie,15,1,40,35,93,63,247,
3dc0aa9d-eaba-4a8c-8c61-d5664e6cd006,Jometh,61,85,60,74,21,94,395,
436ed03c-0a36-4165-a4bf-ccb4d72878e9,Jonae,22,73,0,13,97,39,244,
82f66cb6-bb51-4404-90d7-3cfd5e4bad04,Jonan,42,25,33,53,97,20,270,
5e3b99fe-5800-411c-a997-de814589dc6b,Jonathan,100,71,45,66,89,52,423,
aaf79461-1312-429f-a1ca-adda221a0c64,Jonathon,73,57,98,63,97,86,474,
8751c8d0-db08-4987-8fb9-5e100104852e,Joncarlos,54,60,96,30,62,11,313,
397b0218-c211-474c-aa26-f010768259b9,Jonerik,79,53,2,95,15,90,334,
b6b06c66-3075-440f-89a2-a33a3e19662f,Jonetta,88,1,66,100,48,2,305,
bf7720b0-dc71-4638-87a7-7e409d53d395,Jonette,92,40,83,79,77,64,435,
ffb86d9c-53fa-4d30-8eee-781667c875a1,Jonhatan,30,7,54,24,21,38,174,
8c83601a-0838-4772-a1f4-adac484301c7,Jonier,81,55,12,54,59,26,287,
d9dd29d4-ead2-49a4-9309-87d77c69f84e,Jonique,10,17,74,71,37,27,236,
9c2c60ec-db6b-4e01-b239-acbf9d1f125f,Jonni,83,88,48,59,39,94,411,
2891ca83-f867-49c9-8b6a-11dd2e76e2ed,Jonovan,45,61,34,55,4,99,298,
e1a3cabf-8036-4a35-9805-f064ebfb10dd,Jonpaul,40,96,82,73,94,81,466,
5ffda06d-8a20-4e55-a6af-5b06143a9f5c,Jonquil,84,93,56,47,39,27,346,
5223f171-70ad-42b6-916e-0ce4bff4eb91,Jonquil,57,20,84,18,29,81,289,
5d757c18-05c6-46e5-8d85-f385c53e86a7,Jophy,47,71,28,76,24,78,324,
de7eb836-6e57-49d2-aa06-4a62ca66aa94,Joretta,21,18,87,14,66,39,245,
ce2f68d2-e6e3-45b6-8ca9-5716b97d1b18,Jorgeluis,98,16,100,80,91,100,485,
99dfb754-b0d8-423b-bf58-86885249663d,Jorie,69,94,55,79,18,74,389,
8d08e186-2b08-40a3-a40e-9c0fab8cb156,Jorley,76,22,46,51,79,83,357,
ddb2d3d4-d52e-43b7-b19c-8500bed95d53,Jorley,41,99,54,66,47,46,353,
0b8bafce-353f-44f9-a411-0b39f31da808,Joscelyn,4,65,83,7,14,54,227,
86df2a1e-773b-4d5c-80eb-454f9b67f83a,Josealfredo,27,58,92,84,18,46,325,
a15eaa45-90f9-4f0d-ae5b-e4cb50a39078,Joseandres,1,49,93,26,44,44,257,
416464d5-fb69-4ba7-868a-514504e910d3,Joseantonio,99,0,98,67,42,64,370,
636950ca-1d0b-4ce4-a25e-7177c22c20a2,Joseeduardo,7,0,35,28,78,94,242,
18a80d9d-a241-4622-aa4d-bfb2b9feb388,Josefita,84,81,54,74,70,57,420,
494e2704-6c8c-452c-a69c-599c6a998f65,Joseguadalupe,48,100,46,60,54,73,381,
461c806a-4a91-4efa-b984-4bd23764a12f,Josejr,35,47,83,96,41,58,360,
5ac56d48-e1b3-48bc-8f63-2c35ab4143cb,Josejuan,38,63,44,7,57,68,277,
d7ddad47-3bc3-4b1c-b9fb-a1a197de5678,Joselin,56,79,18,79,71,40,343,
3b52c96d-cbe3-40b8-98f4-ff85316b88b8,Josephin,60,55,68,33,44,27,287,
d7ec5f4c-e8a4-4923-bf48-259e6431ec7b,Josephin,59,47,78,24,95,49,352,
ac8252cd-8c45-4785-b9bd-994d31deec0f,Josephina,75,55,86,80,100,68,464,
15c699e8-6c83-400a-a14c-8106657bdc94,Josephina,98,15,32,21,35,62,263,
9c5a2269-aadc-4df9-a846-00927905b724,Josephus,40,75,77,27,87,49,355,
f69f4418-f250-4887-b0de-f240f748a50c,Josephyne,84,64,65,88,52,41,394,
c77117cb-742c-4c8e-a70a-0276816d35fe,Josette,89,74,36,77,20,22,318,
a9be5827-ed0e-46d5-9d8d-0b9113aa87cb,Josh,59,21,35,94,85,71,365,
7a86b69a-5cc2-408b-9e67-a496648f4839,Josha,23,98,18,62,63,51,315,
fb3a8421-460c-486e-8d35-a16ca9aa7a80,Joshue,23,17,8,95,59,82,284,
87304d23-626b-4416-ad0c-a0bc29f64e2f,Josiah,29,69,45,35,40,92,310,
227d899a-d94f-4a61-9ca6-db4e0833f1e5,Josias,100,22,20,37,32,47,258,
09569de8-d2b2-4e65-9791-0255f5ca758b,Josie,49,2,61,43,63,86,304,
6f7ac18b-a582-4c3a-95b2-1677feff6de9,Josiephine,7,53,93,36,81,8,278,
6d335620-d51b-4111-9f4a-1a91f0bb3da9,Josphine,3,38,75,89,45,49,299,
cb92b567-e541-4280-ad89-38d3fc6426f5,Josselin,24,11,82,57,63,35,272,
b3c7409a-b23e-4500-b3c8-c960c0a76051,Josselin,76,49,40,44,11,91,311,
b6d3bdeb-0201-4558-835e-d215480da7f2,Josselyn,50,55,56,63,21,78,323,
6cd4043a-9e20-4f43-afb3-73d4fec085df,Josselyne,29,89,93,67,45,35,358,
ccb2d6ce-62ba-4338-86f0-18479a44aca4,Jossette,50,5,9,82,10,88,244,
09aba1db-f2ca-4431-8296-56952351c180,Josten,65,4,72,37,30,83,291,
4868fc09-aafa-4ee0-96f9-86fb7df08779,Josua,44,30,35,53,33,63,258,
ad4ea0f1-2f95-4fa6-ae8c-822a90dde7b3,Josua,67,78,4,94,68,16,327,
25b3cebb-c870-465f-9bb2-822b7485872a,Josue,50,61,28,65,43,99,346,
22a9bdca-1e8b-4cbd-b2ae-e97a69afd572,Josyah,10,12,9,84,50,40,205,
9f3b6a3c-ca9d-44d7-bf62-1f6302594e3f,Joua,76,24,46,56,81,9,292,
06d78a5a-a8a5-4f41-966d-208999f473b8,Journee,59,81,52,12,48,76,328,
e8c939f2-9476-4fa1-af2d-285a4c077c68,Journee,4,79,79,31,17,96,306,
c700d12f-b3f2-43b5-9b37-109eff5628a5,Jovante,81,70,41,14,74,98,378,
e33eb391-d656-4c38-9e41-0a503a7e78e4,Jovie,62,68,56,85,48,72,391,
31def0bc-5f4d-4f61-b126-b424497efbb6,Jovie,95,83,61,9,40,45,333,
83cbaae7-1c6d-4d3d-93c7-830972aba130,Jovie,70,11,64,77,74,82,378,
d48d3162-ffcf-49a5-8042-d5476607fbd0,Jovin,10,44,40,44,87,77,302,
8cd613b2-0189-461d-9e07-353249cc5b1e,Jovita,38,3,6,90,90,43,270,
4621f230-f290-4859-ad12-49588be9ec2b,Jovon,56,34,1,82,51,17,241,
5bbfd5f4-0fe0-4055-a775-20c2a802792a,Jovonte,13,1,48,30,7,24,123,
2bfd9cb1-78d5-4ef2-bd80-d0455aefe59a,Jowell,43,65,62,79,63,80,392,
9911cea1-5fc8-4a3c-98dc-6fd627e9e2a9,Joyanna,57,73,86,89,82,66,453,
da92f90d-b19d-4077-b63c-d0fd7717b655,Joyceann,59,45,45,75,7,38,269,
96a21133-1300-4617-abb8-8251953b0421,Joycelin,33,6,38,12,65,87,241,
4045b0a4-85b8-4765-bb42-8004dc8e07de,Jquan,15,69,51,64,12,50,261,
b656f064-155a-486e-b63d-158184c50ac1,Jrue,80,95,12,50,91,42,370,
847dabe4-f23d-40bf-a27b-c8aa6e0c0bb1,Jshawn,31,39,38,68,81,17,274,
55b1a4f1-e493-4ce5-aee2-139948b80260,Jt,7,1,16,83,55,39,201,
16f54c43-281c-420f-bf81-4e51af0af2c3,Juana,41,52,37,40,48,81,299,
877eb5e9-4701-49d5-828e-0744e8091424,Juanalberto,98,36,52,42,82,11,321,
94282c2a-812e-4fc4-8786-865d4d452ba8,Juanantonio,75,11,81,93,29,69,358,
3661cb6c-e1bd-479e-846e-af784d74a102,Juancarlos,61,66,44,0,100,80,351,
593113f0-b34e-4bed-b724-23e47500895f,Juancarlos,79,16,84,94,63,12,348,
08ef01f4-f3c3-40c4-87bd-e4975a3ff1e7,Juandavid,82,11,73,33,81,77,357,
9a8018fb-b35a-4ca4-96ef-c08c7c3e0f1c,Juandedios,18,42,37,87,56,40,280,
84671db5-4909-4090-ae44-dc31b3246a8f,Juanell,73,64,33,68,65,10,313,
9225094c-caae-403b-89dc-c039ea8f9de5,Juanelle,46,5,85,78,73,80,367,
2ea31264-44a6-4b3b-afb5-30d23d4e78df,Juanramon,55,45,14,19,60,50,243,
03e1de41-26e9-4c27-bac9-efe839998e58,Juany,4,99,49,77,78,20,327,
6fd04c97-b657-45e0-95d0-fbc3cdf52aff,Jubal,41,80,79,3,4,13,220,
1aa3c99f-0d98-4400-8131-2484c5ee059a,Jubilee,44,89,66,22,29,19,269,
9606488e-c078-404e-afe2-03c176fba6a5,Judieth,43,82,23,70,97,15,330,
f926695f-9e2e-4d99-81ad-e00a81e512b5,Judit,81,76,85,64,100,77,483,
92fd7270-97e2-4875-8108-2d2662dfa601,Judithann,36,25,71,36,37,41,246,
96c4b2a9-1089-4505-a10e-939406e5ba49,Judyann,73,37,39,37,89,2,277,
0b6e5db8-48b4-4523-ac76-db747466fd05,Judyann,72,34,96,30,47,18,297,
41705834-64e5-4057-849d-5dd186ea27db,Juel,7,72,25,95,31,83,313,
071be560-01ff-4eb0-900a-1b9a7bb44f10,Juelz,22,89,96,69,73,19,368,
c1790a6c-f38f-4b0c-9ae0-5c0b934f74b6,Julane,39,81,60,0,63,64,307,
7a8fb834-db9a-4b39-b183-802622f10c46,Jule,59,72,20,50,86,26,313,
c0805e37-9202-42f8-ae4c-d1f48f4560e4,Julee,11,98,4,88,55,49,305,
423d005c-45d2-4219-8f3b-d6132f8d0011,Juli,75,98,20,78,50,23,344,
9e802593-bfbb-4ae9-b2b2-6636b98f855f,Julia,34,50,30,5,43,28,190,
b9d36070-b252-4994-844b-7bb1480ddc7b,Juliana,57,64,42,9,10,61,243,
f88bd648-43e3-40d2-a27d-eed81885dbe7,Juliana,45,8,71,91,22,90,327,
34d81e30-2f5f-44fc-8df3-b365b4f5d518,Julieana,17,38,52,77,99,72,355,
81ccb423-d94d-4001-8ccd-b8740a13bb65,Juliett,90,38,17,36,50,27,258,
078c1154-f382-4aaf-a90c-7f23037e35ff,Julio,33,84,81,59,68,72,397,
547c3e0a-b0b8-497c-80e1-b382707d2300,Julious,8,26,90,93,70,38,325,
d21dd5f1-fc3f-4a7e-b938-fcfb300ffe34,Juliza,55,12,4,90,82,43,286,
5df03cdf-6a27-4b70-bd7e-f72bccb42f56,Juliza,18,26,63,72,69,0,248,
05b98827-9f79-4959-9857-8bf92112ab7c,Julliana,17,63,58,46,51,70,305,
b5fb2b1a-9d82-4970-bcaf-399f7f6dfe39,Jullie,35,55,51,92,19,12,264,
063ad4d5-1db6-4f14-8f0a-c829b163563c,Jullie,91,38,39,26,53,55,302,
e840b761-e606-4363-940f-63c720116f06,Julyanna,59,88,12,62,1,83,305,
5444d42d-8218-4ae5-b7ab-e9cbcb716b5c,Juna,64,65,34,94,70,22,349,
3e86baf8-347f-4b02-bf54-f73a61f86065,Juna,37,89,93,64,67,26,376,
abc7880d-49d1-4b1d-9bc8-40c8b9df14bf,Junaid,30,31,4,35,81,34,215,
2bad2829-4e0c-4b6f-92e2-d573c1277e39,June,4,45,13,19,12,26,119,
f5ab478b-402b-4b1c-9ca8-48e3b7a27905,June,91,86,58,23,68,87,413,
fff3e40a-3e73-448a-a571-71fef8dd48eb,Junichi,84,5,34,68,13,39,243,
31521423-510d-4a4e-8b4d-8e951bef4368,Junichi,65,9,55,94,22,38,283,
3bf9dd4e-df50-4d74-a88a-51f73f1dc5c9,Junious,51,21,89,19,11,2,193,
3a4f219a-ed7b-4a12-9d10-0686ec699a10,Junko,14,43,54,73,75,68,327,
7f1dd19e-190a-426f-bd7b-dc83769ce3af,Jushua,61,31,9,29,80,19,229,
3ab124ac-c3f9-479e-8177-d10029286de6,Justinkyle,26,79,18,0,3,92,218,
18d4f9d3-0eee-4a0c-bf7b-7f8a1ab2c77d,Justyn,74,18,44,93,64,82,375,
7eebd6d5-5458-45e0-a621-6122cb3cb3d9,Juvens,58,2,15,38,63,85,261,
bce69a1d-7c5f-4649-b0e6-0d8b823b79c3,Juwon,90,73,43,4,47,98,355,
43033db3-02e6-41fb-8782-d6ed3ac6fe82,Juwon,51,35,96,50,12,78,322,
1060dbe1-77d7-424d-bff4-fcf467257979,Jyaire,67,14,78,65,56,21,301,
d3e369e5-9024-4fe5-a19d-162514fcdca9,Jyl,13,7,8,9,32,48,117,
3cabe774-853b-4f7f-bf78-60ad450d52cf,Jylan,46,47,52,1,56,17,219,
cb865c6a-ceef-4db7-b454-0e041932cbb2,Jymir,17,22,3,47,53,71,213,
068ce2c5-ef60-4d9b-b29d-999142af514a,Jyren,26,84,1,1,28,66,206,
f341e7a4-5726-48db-ae75-2c5b334f649a,Jyren,18,15,32,26,92,22,205,
381c0a54-0f35-4c02-979d-66ade802a831,Jyrin,11,61,52,10,60,27,221,
fb981884-5342-4a2a-a309-5687a4cd4837,Kaan,100,95,26,40,39,34,334,
b69ee29c-6e28-4391-a232-6a1b1ada950e,Kaaren,11,36,85,91,93,98,414,
6743ffac-a653-4154-8352-f78e5c4185a5,Kabir,94,54,4,54,32,44,282,
4fcac25a-0ee5-4826-bc06-cd64b3a81458,Kacen,87,36,59,31,38,83,334,
f42c2773-312d-455c-a413-98f55fae8945,Kacen,22,42,93,75,77,5,314,
9c3078d3-ef38-4fed-9ed0-b23c5001842b,Kacey,5,92,59,71,42,73,342,
1803e6a3-f25c-44fc-9c85-7690df054dda,Kachina,66,20,65,8,59,46,264,
8be4a2c6-5e53-4cd7-8c3b-8dfe74978e66,Kadee,55,46,69,34,96,70,370,
85b9370f-2e98-4654-b012-1f64c39f8e36,Kadeja,73,63,54,4,12,3,209,
bc963af7-1608-4516-9fcf-b8e6ad1eb393,Kadejah,9,96,95,5,20,29,254,
7870cba6-aa7b-4b65-b15b-c611fa72fd6a,Kadesha,31,100,89,31,24,61,336,
3951f511-1fb1-4194-8fba-c179d2541a86,Kadi,50,11,71,48,91,64,335,
80e716d7-5c67-4137-baac-77ab27c42a1c,Kadidia,72,2,86,67,12,27,266,
10e3b3b7-fbc5-4c99-8906-1e51dba264e6,Kadijah,65,69,45,59,3,55,296,
1932a5a2-b885-409a-906e-c9b646e02761,Kadrian,57,66,53,10,35,93,314,
1b696450-582d-4711-b8b2-8920249daa96,Kaedan,67,61,44,61,23,17,273,
ad191156-e05c-4b22-983b-b4d160cded7e,Kaede,13,19,25,36,95,17,205,
1bf5b186-2534-467b-8424-d97614458541,Kaela,74,31,75,13,17,32,242,
ab7ddb53-0e92-41c3-b7fa-692b8b8dbd76,Kaelani,2,65,69,73,40,15,264,
cd8adfb2-4b01-4104-93ac-bef1e4c1eeb1,Kaeleigh,100,0,68,48,23,83,322,
340570ff-f33c-4d59-8b88-aa7735ac2a50,Kaelin,95,86,49,93,1,38,362,
b43bb44b-f0b8-48b0-8b30-5a4d61ba5479,Kaelyn,38,46,51,19,36,42,232,
5f875b9b-941d-4464-9eb3-a5825f34a25f,Kaelynne,92,19,55,10,81,92,349,
ac444ae8-4b29-4a38-9375-847f3d448ac4,Kaelynne,90,30,22,3,21,77,243,
1cab8f0b-e728-4e29-af5c-7d417cd5af98,Kafi,37,75,49,95,35,64,355,
bfeffd3d-921b-4142-89fb-61ac2aba29b2,Kagan,93,9,20,93,37,18,270,
65517867-4af5-4341-b312-9d02c15c38ec,Kahari,64,24,9,17,74,11,199,
54b90a1f-286a-4677-9db9-c73b9b989b58,Kahlan,3,96,15,66,50,9,239,
aaa1c88e-e237-40fd-9e01-bdf509783062,Kahmani,58,39,6,6,10,8,127,
cbf56696-19f1-4baa-95b4-6910db761420,Kaidance,96,99,28,94,83,56,456,
bc45eee4-4466-4880-97a6-1a146b07a779,Kaidence,1,93,42,62,31,60,289,
bfa70732-28e8-4191-b606-df0178e8dcc9,Kaidon,75,32,86,79,2,45,319,
bac23abc-cc8e-46a1-89f6-c20eb9c6efdb,Kaidynce,3,79,40,92,30,46,290,
daad7100-e9e7-4a05-a43e-0477d0d14070,Kaige,90,45,99,80,36,58,408,
ac2681ef-a1de-4f93-bd88-3cb064a71d73,Kailah,73,12,45,62,24,72,288,
eecc46e1-3aad-42e7-8af3-8091390b23c7,Kailan,34,37,19,32,68,33,223,
f31ee438-6434-46f5-b8c9-526607e81c62,Kailan,61,12,40,3,34,0,150,
e65beb04-5dbf-44fe-a675-f0af73be838f,Kaileigh,38,99,64,18,1,73,293,
b7dffb7c-f8d0-41e2-98a2-72b9af9fc10f,Kailer,50,46,93,51,94,62,396,
224a1ab5-1052-4b67-b6a8-86cc2ddf5f7e,Kailey,88,89,53,5,67,58,360,
a984dc05-bd54-426a-a8c0-364fde1f02c3,Kailie,26,72,17,70,1,57,243,
623e8b04-6034-4dae-be83-78ec46e14c7d,Kailin,66,29,81,29,95,100,400,
bd908b67-3c51-40a1-93ca-aada1045db47,Kaily,79,85,39,43,90,72,408,
5a3dea63-8fbd-433b-91f3-b7496468f935,Kaimi,82,53,19,86,64,47,351,
dc2c26bc-46ff-4c3b-b552-aaa02ad81151,Kain,41,45,70,63,86,7,312,
10328403-8bb4-4682-9f61-d677fe66ff5d,Kain,91,52,65,4,19,80,311,
793ee912-b986-408f-bc3d-3b5ff9f3c728,Kain,36,45,99,74,63,74,391,
b56db348-b48f-4b3c-bcdb-ab3db6a9e1fa,Kainen,67,50,31,50,83,28,309,
a3932789-b64e-40e4-9035-6b1b1b7cd5af,Kaio,76,89,47,26,96,34,368,
346f8d87-c0a3-43c4-9113-81a536bfef30,Kais,50,17,8,47,24,22,168,
101aae14-fddf-46eb-8ecb-b37fd007c66a,Kaisha,39,97,2,61,58,46,303,
9c89f469-6ed2-4c4f-9d7f-4f9686031d41,Kaisley,48,15,49,23,58,21,214,
5ec12249-98e8-45ff-af99-110d6fab62cb,Kaison,69,70,30,43,35,15,262,
3f69dbd6-3024-4bfd-a701-791d7c6f387e,Kaitlin,1,53,51,3,31,6,145,
1911c5e7-8187-4c55-8dd6-04e244aaae8b,Kaitlyne,95,90,44,42,3,59,333,
ce4215fb-e291-478e-ba05-711f1fbbd4b3,Kaitlynne,88,22,36,6,75,65,292,
8b9cc1fd-66ac-4ed4-b4b0-40aa880a4801,Kaius,82,1,13,32,70,74,272,
f58a7ceb-6dae-4531-a784-0021fb042854,Kaiyan,43,77,15,24,83,9,251,
0eadab44-5dbd-4015-a4c5-ae8a1de87da6,Kaizen,32,22,33,4,81,28,200,
23202dbb-e51c-4afd-9909-ac8f960d5ea7,Kaizlee,59,68,40,11,88,43,309,
5e622ffc-bbd7-4db1-a4ca-aea70287c8d4,Kajal,1,87,23,20,13,66,210,
b1d13f7c-0768-4a7a-a9fe-dc055c853772,Kala,79,60,96,63,21,95,414,
5b6642e7-2a3c-48de-bdc7-d9e4996e44ed,Kalah,72,18,68,16,78,43,295,
88c8a278-e2de-4d25-bf30-2a2883f0d56e,Kalee,69,65,66,7,70,55,332,
fc8f875e-ef25-4045-b4c7-5c7e8649b0c3,Kalee,54,76,79,50,41,29,329,
4b304167-3928-45bb-866b-e1aad7410e2c,Kaleesi,76,15,70,22,76,89,348,
72a54022-c98e-4617-8104-a8001b18e78f,Kaleesi,85,92,69,78,14,41,379,
29500d2b-4594-458f-8b29-e4e4ed13a67e,Kalei,60,74,99,0,59,43,335,
eecd6f51-d1e2-44de-bcca-478e019e8ea6,Kaleigh,9,69,19,32,47,6,182,
65d5a393-cd34-49a7-879d-6591110e48e3,Kaleigha,62,86,91,58,69,24,390,
05dfece5-414e-4798-b87c-0fa34c08a5a2,Kalen,8,6,78,12,23,61,188,
2c8280a6-761d-414d-bd05-b5ea553bff3c,Kaley,12,68,22,60,33,66,261,
30ca86f5-09ac-4366-adaa-177abc135ee1,Kaleyah,43,32,14,48,93,40,270,
815332f6-4492-4ce9-9e0c-f7a9759d4bf1,Kalifa,14,11,78,13,68,10,194,
f3c10e25-12ef-4cde-be93-7c48c5131574,Kalil,28,15,47,6,50,87,233,
c68864f0-144f-4552-a9cb-e080b13b7e94,Kalila,66,1,69,31,74,94,335,
4a09ba06-031a-467e-98ac-952f9978f732,Kalima,40,91,1,98,39,88,357,
21c689ff-5792-41e8-924d-7c2f7b980daa,Kalimah,42,29,95,12,60,24,262,
14f4bfe7-1b58-4427-978a-43bd0fb4162a,Kalimah,4,80,72,33,58,3,250,
6b437e29-abeb-4d66-92d0-ae2dd165821f,Kalimah,26,48,31,83,77,87,352,
bffcfe33-c1bd-4268-907e-02fe275d371a,Kalina,26,60,25,26,21,0,158,
711a2290-c71d-421d-8a2f-8377606019dd,Kaliya,89,72,80,88,32,83,444,
02fdbbcc-f45f-4a67-a4f8-35562cd039b6,Kalley,33,98,60,75,18,76,360,
b4fec39e-d03a-4e2d-acfb-23f76b170b08,Kally,8,62,12,11,23,66,182,
e84241ab-d28f-462d-8182-721986f3ff8a,Kalmen,85,79,51,93,75,86,469,
7c9735d1-1227-4543-a42e-a497083b0350,Kalmen,90,11,93,91,12,98,395,
fcd949f2-b316-42ae-9a1b-8f71b06c6c12,Kalub,74,64,83,2,64,73,360,
ec504af9-6ad3-4455-87d8-618fc7360756,Kaly,98,67,50,98,86,92,491,
36abf794-dd88-4784-982a-c61d52439441,Kam,93,94,80,36,73,86,462,
925d8c22-a029-4cb1-b6eb-1b56bbf27bb3,Kama,27,20,43,32,68,83,273,
ea571f0d-486d-4292-9026-056089daa0f6,Kamakana,28,58,99,92,6,15,298,
4239fc99-975d-4bb1-94f8-0ed31213c78b,Kamakani,87,49,11,71,21,56,295,
ba12e560-01a4-4bf6-b94b-30b4b3dbce37,Kamalei,76,32,37,54,27,5,231,
44a80aab-a2b7-4851-815f-43973279cda0,Kamaree,46,17,75,18,57,3,216,
b481997a-218b-4546-ad54-832b66ad75cf,Kamariah,7,53,94,30,34,29,247,
7d2319ae-0dee-4875-9ce4-518e0b42dc9d,Kamariah,39,9,59,63,22,31,223,
50d002b8-360f-4dea-bc1c-9d5e759f624d,Kamaya,63,72,8,6,37,18,204,
052aeaa0-7f94-4259-8c66-455cf133e8cb,Kamaya,64,83,12,61,26,36,282,
0f1e75f6-dbcc-450e-b4fc-a0f318c6d593,Kambria,94,48,15,81,61,51,350,
00659806-1ab5-469f-9dde-c928f7637e70,Kambry,41,50,82,31,52,59,315,
66c8033e-ceec-44c7-a445-2426130d74e5,Kamden,73,49,22,2,92,45,283,
34558982-447c-4110-b5a4-15a36a8657f9,Kamdon,18,90,96,33,57,26,320,
4bf67b62-7689-4120-8c5b-c4f75b6fa2ed,Kamea,79,34,52,0,2,28,195,
50d5d4bd-60d5-4e50-8e50-15cbe7d6833e,Kamela,53,87,58,84,17,94,393,
aa8318f6-890d-45fa-be8a-613a8c02040c,Kamela,29,99,87,68,0,17,300,
ed663298-c7f2-4919-b4ca-29bd351034c2,Kamen,92,85,64,32,81,27,381,
26dbb612-2253-4df5-bae2-830748af45c7,Kameren,38,90,20,80,82,64,374,
c5caba59-8f95-4ed8-b43d-180449c18333,Kameron,30,41,60,7,12,97,247,
1eeb4a2c-23dd-4097-a40f-7f1f06be3e5a,Kameron,73,3,9,43,37,35,200,
67cd86ff-9af3-42e5-830a-df0b61c7b0b7,Kameshia,18,94,50,57,21,100,340,
c3fdfefd-4978-4926-9e2f-2d2c9d9a8d0f,Kamia,3,18,88,55,29,71,264,
ff41661f-4ef4-44e3-a827-6c4dc539400b,Kamila,9,37,54,84,34,60,278,
1acef00e-c8ee-42f8-8362-bd71cd55c103,Kamisha,41,28,47,93,82,47,338,
090553d9-700b-4c91-9bad-b4d6adada203,Kamree,99,52,2,36,40,19,248,
619d4626-e517-4fce-a08c-5db9cd177f2a,Kamri,45,0,0,62,87,60,254,
fe5b9ee1-6715-45ae-9d89-5c17e4f76027,Kamron,71,14,14,40,40,46,225,
9ba1f25f-6699-473b-ade4-f916d4856685,Kamuela,95,61,53,53,95,6,363,
aeb77c1b-0a66-4252-a4cb-e2bd2c7bca54,Kamyah,16,47,85,30,16,26,220,
5471c892-76cf-4b90-85c9-5b748ddeba52,Kanan,36,79,90,8,77,41,331,
d1baa743-53c8-47e6-9e4f-78f021483440,Kandee,31,81,36,5,23,15,191,
8d753003-ef6f-4731-9c8d-c15cc9115e19,Kandi,96,86,75,27,60,6,350,
eb6f20be-5da3-4743-9c1d-c43a7caf54e6,Kandice,0,42,96,80,71,57,346,
1098a079-77b8-4120-9e4f-976cc2cee88a,Kandis,62,93,4,10,9,23,201,
de0a53d1-5f08-4c01-9a62-d09efd69ccf2,Kandis,62,63,100,87,79,42,433,
48aa59a4-1191-4f92-8277-fa5dbaa10709,Kaneisha,58,83,89,72,31,30,363,
3ada3d83-4063-46fb-aa27-8b09041bcc0f,Kanesha,4,24,80,1,63,80,252,
76cec8be-03b0-428f-ac39-72befa838e7c,Kani,34,6,86,77,18,79,300,
7eb9b820-ce56-4b17-84ec-db1798b0724d,Kanijah,95,30,24,76,85,6,316,
17896a94-cbd4-42ee-ae92-671d991bf054,Kanin,66,6,37,25,84,88,306,
d152cf3d-1a0d-401c-a684-24c5585e22e1,Kanji,95,14,26,20,81,46,282,
e486c3c1-7185-4c53-ae13-52680ff8ee6e,Kanna,71,84,8,41,24,24,252,
542bd048-e3a5-41b6-9ad3-6818db397871,Kannon,33,24,47,90,78,64,336,
f85e985a-754e-4454-8a3e-7f538ec59498,Kanon,42,68,87,44,28,54,323,
4a06aed8-60c5-4aa8-a72f-494160dfb76b,Kanyon,65,42,75,5,5,30,222,
6e3b5d9f-fab2-44e8-b924-e1c32b3820bd,Kaoru,98,81,100,6,32,72,389,
1547dc82-8fb5-40f1-afb3-ba40b00bbd2a,Kapono,37,16,17,65,86,92,313,
1047cac8-3fe6-4935-a00b-f2dbe9295ef3,Karalee,1,86,95,66,97,32,377,
56e63f86-568f-4a47-b121-a81d3d5d86de,Kareem,32,56,27,56,94,96,361,
264b2e06-0f01-4332-87ca-34596e084035,Kareema,51,86,64,94,71,20,386,
705c9c00-b18d-4ee9-a1f6-9e281641be30,Kareena,30,21,54,52,98,64,319,
5ce8f127-cedc-427d-94c7-cc3bb936fe1c,Karelly,77,25,72,26,2,35,237,
b41d2ea9-becc-4066-b99b-1f57c1ed1a5c,Karem,60,91,24,66,35,51,327,
4f873409-7971-48b8-9ebf-916224496d11,Karen,93,65,97,86,51,26,418,
554b22f3-7df8-444b-9d00-cddc2ea58e8d,Karessa,37,80,62,13,59,27,278,
9bf0237d-7abc-4873-98e4-574345b58f4c,Kari,6,37,82,25,57,64,271,
3521bbed-1dd3-4336-82f7-c2fdb385965d,Kari,3,24,20,5,59,36,147,
6b25dd93-3797-40c7-a43b-ab1fca5a0b6e,Karicia,43,82,51,6,76,27,285,
8ccf6ad3-615f-4934-afa8-64ac115e390c,Kariem,93,61,100,35,65,9,363,
f74c34c4-fc02-4555-8eaa-1cd2e6508f3f,Karilyn,83,55,74,27,31,20,290,
eb2481b7-3594-490b-90fb-14b14481cfc7,Karima,60,17,41,91,64,52,325,
a1fc6205-b2fc-46e8-b07e-458a85d86a4a,Karimah,25,82,16,15,77,58,273,
e290a439-3040-4246-b9c9-1c566c772871,Karina,42,43,16,59,42,92,294,
d7342264-86ed-42a7-9fc0-c0ea818da729,Karinne,64,98,60,91,80,94,487,
2f1bed06-396c-495d-9fac-7b78440d45c9,Karisa,51,46,68,78,43,62,348,
ec768d2d-6eb3-4cda-bca0-ce3a4c2be469,Karisha,31,62,21,56,65,37,272,
20b0bc15-06e3-4d65-955a-146b504d3e5c,Karisha,34,23,8,7,1,18,91,
8d9e09d1-0202-4ed7-90aa-571530b11105,Karizma,44,82,8,90,15,32,271,
9ab6a47e-9555-4adf-a01d-e379029d0b53,Karla,61,91,56,64,60,75,407,
86db7dca-78ec-47fc-979b-13882d4da536,Karla,82,13,75,24,68,90,352,
775dfcc8-4d80-454f-ac35-7fce56622156,Karleen,44,89,90,61,98,42,424,
0e16dae0-b807-470d-ac92-19c90cb02f67,Karlo,0,57,48,36,8,89,238,
1d1fe8dc-13a6-4528-839e-d29a89b8c3e3,Karlo,54,83,1,5,26,82,251,
e3431317-4d27-43e6-8479-dfc20c1a4fbd,Karmelo,29,23,9,44,98,28,231,
56a2175f-a42e-4e64-b72e-d30643d6bf06,Karmina,22,40,26,12,59,83,242,
b30b6914-5245-4bba-9273-e84c76c8ed05,Karna,37,68,27,4,7,62,205,
4d3c0f26-7adb-410e-aac4-b4775dd87df4,Karna,16,65,63,23,76,49,292,
289166e5-2019-40ff-b52f-9714e039d23e,Karole,46,59,79,100,67,27,378,
aac2b8fe-d721-4201-b1c7-212205a3fb79,Karolina,67,83,67,64,40,13,334,
0dd2d68c-e71e-4349-96e5-84758ab6e8cf,Karrie,19,84,54,96,20,11,284,
e625514f-f7b2-4e42-9bf6-083668a84b4a,Karriem,83,27,55,17,75,29,286,
777ea5f3-68ad-48c4-b030-d45fa73eb5d9,Karrigan,60,82,7,75,44,48,316,
b19c30a2-eab5-4583-8305-a21f3cec8c12,Karrina,52,99,37,71,72,45,376,
adda3366-e440-42be-a58f-4d89cf34e940,Karrisa,96,43,24,65,58,24,310,
b212b019-27f8-4070-9bbd-22ed83cb7356,Karsynn,73,72,85,41,40,22,333,
5d559ceb-18e9-4a9b-8a94-740b298007d6,Kartik,31,30,57,14,57,60,249,
e82a1ad1-86e9-40f9-89d3-ada6eeff16af,Kary,21,61,97,29,67,62,337,
5507b969-b06e-4746-b675-8c5bc0d02366,Karyl,97,16,64,44,43,66,330,
9dd0fce5-2b3c-4402-9fd1-0a40798dd302,Karyme,83,65,44,77,61,56,386,
a524f468-2046-4df3-9ecf-7eca7db06f8c,Kase,0,34,17,84,59,12,206,
41e75529-4cd2-4bf5-be29-b5e0c6b0097f,Kasey,11,58,71,69,79,87,375,
b8da7e10-501e-4056-b1c8-d985b8021db8,Kash,90,72,70,51,8,6,297,
f9bf294c-0958-4bc7-85e5-270cccde23fa,Kashia,4,9,100,73,42,38,266,
99ff2ca5-48a2-4a2a-aac2-4bc16bad6fee,Kashlyn,78,93,5,54,86,53,369,
62ec6485-1c64-4353-9f41-5f68681e0769,Kashlynn,65,24,42,84,10,63,288,
f1138609-fd75-4959-8cb9-aabf2d9dd369,Kashmere,37,84,4,46,87,49,307,
d4138eb6-fd41-46b3-a811-26ed4e6dae52,Kashon,85,34,38,61,85,73,376,
02cfe9c3-68c0-44e6-9988-0487dc5c9899,Kasi,62,26,22,6,45,75,236,
9708d1b0-0ab8-4693-b8be-632743193dbe,Kasi,13,6,42,52,77,54,244,
681bda72-57b0-46f9-a9e3-1958cb78e600,Kasidy,1,84,32,10,12,17,156,
82dfce08-439f-4d5d-888a-ead35a9d526d,Kasim,15,68,26,17,3,29,158,
1053ac0b-53b5-4bc3-b88f-457ec8c3fc7f,Kasir,61,65,48,88,6,71,339,
8c0fc103-7c1e-4876-8d7f-2acfbaf9ca93,Kasondra,23,39,36,50,93,22,263,
47637751-fa7a-4b61-b0d8-29150563e011,Kasper,57,98,65,46,93,1,360,
f6de8701-8457-4364-b158-2c3dcae5bf97,Kassem,86,13,18,53,60,3,233,
0cee0404-07a7-45ae-bf18-36084b5275b8,Kassem,32,34,81,53,12,51,263,
0a64bb9e-ef17-4fa1-bec8-947b435cf953,Kassidi,9,24,78,68,16,40,235,
052f111a-c82c-4226-9cae-5df4ff934373,Katalaya,94,4,74,71,86,53,382,
33345619-654f-4d2b-b916-5613bf6e6233,Katalea,42,49,37,74,70,10,282,
29dd3b4e-82ee-4288-bc33-947cc73b1d22,Kataleyah,33,44,26,17,0,5,125,
119f6e5a-8bb8-4fd2-acdb-813bfed3d104,Katarzyna,21,38,4,68,63,94,288,
85bafe11-ec53-41c4-a739-0f529f4cef4a,Kateland,57,51,57,97,89,98,449,
f0887a4c-117e-469d-9e6a-5452ebb167d1,Kateleen,78,52,40,43,95,22,330,
1f70bef5-3b5b-4139-af67-8f5c1d2e8432,Katelen,24,51,99,4,91,40,309,
20b875fd-817a-4792-a28f-34b4956e1e1b,Katelen,5,97,81,2,36,67,288,
0a79793f-5f9a-4367-92b7-7802a684263c,Katelyn,40,14,58,64,94,74,344,
a6485d8d-c50e-48c3-a8a5-cfb5f42853c3,Katena,100,70,68,21,88,13,360,
e1f1bfec-3c5c-4ba9-8239-a64ea19efc0c,Katerin,99,70,1,66,46,90,372,
5e91ba74-ec9f-486a-8f48-ddb3e600df68,Kathaleen,7,18,11,26,20,21,103,
3d0f01e9-4885-4d8f-b772-22ff5bbf2176,Kathaleen,33,51,42,91,55,4,276,
20e11434-6652-4b86-b8f8-b64e5849827a,Katharin,83,42,20,16,75,20,256,
f2e0fe87-edeb-4494-bf2f-1e046a4552ec,Katharin,20,72,52,60,6,36,246,
ff0fc038-ad61-4427-96eb-9992d95cdd77,Katharine,14,48,75,32,0,78,247,
e305d6de-46f1-4d6f-9dcf-b52d311dff19,Kathe,33,52,13,77,8,95,278,
24eb9767-39a1-424d-9711-909992059654,Katheryn,30,99,45,36,35,10,255,
485ef4bd-5817-45e7-b521-f01459f4e81d,Kathey,4,83,39,47,27,30,230,
02f979a7-216e-4df5-8bdc-08fe3718fd27,Kathey,44,9,97,36,2,70,258,
2b1c54be-7171-4628-ab23-482d47698354,Kathia,76,75,85,19,82,63,400,
5477705f-8e3f-4fd9-b744-0a7a5969cd17,Kathiria,58,44,70,40,35,62,309,
49a3a170-90ee-47de-ac05-00f7cad3d140,Kathlyn,52,64,85,73,66,53,393,
c55d5ca4-1e85-4156-b0da-9c54bfb5a030,Kathrin,82,92,54,3,4,52,287,
f93e0a66-baf8-47f2-a298-e09ca2689bbd,Kathrin,53,89,32,32,93,87,386,
c233cb71-17de-4d2d-a763-73869d267710,Kathrine,90,8,74,58,16,39,285,
6114c207-6947-48d6-a840-7ed58e8356fa,Kathrine,47,61,79,13,80,34,314,
5c042235-7927-4ed2-a849-c8e1106ce7f5,Kathryn,44,38,79,93,62,100,416,
ba6c47f4-2a8b-4c49-bfc1-d81effe4af9b,Kathryn,30,47,81,11,36,73,278,
9e55c387-ccc3-44c5-afac-720b4a971928,Kathy,59,91,85,47,78,58,418,
27662f8d-8d24-469e-a9ca-fb6dac3aa8b6,Katiana,39,7,23,44,100,49,262,
84488ca4-ccf2-422c-915b-8b16e058adec,Katilyn,66,39,85,18,78,11,297,
af1f34a7-1e3d-4322-9ca4-3d8266fd9f91,Katiria,81,24,26,60,6,68,265,
5272c1ee-d9fa-4aad-b5a7-a03eca4e2c3c,Katisha,99,35,100,18,71,63,386,
4cff73ed-e954-4f7e-9517-dcd958c4d604,Katleyn,79,83,1,80,24,48,315,
5c2c73dc-fee6-4279-8ffb-723128960d83,Katlyn,10,95,97,10,49,7,268,
15948d23-5f33-4ff7-9b1b-ab22df8c2383,Kato,58,11,26,96,80,76,347,
2a7089bf-9941-4f2f-8928-c968ef7ca731,Katonya,63,83,96,62,47,47,398,
3fd673eb-adb6-492d-8851-31e4712a74a5,Katrinia,46,15,85,86,78,41,351,
d3a25daf-a587-4531-a16f-d967f4a16c63,Katrinia,42,9,87,55,7,33,233,
6becd46d-7b7c-471b-a81f-6167e013f651,Katsuji,29,73,41,88,62,75,368,
7dca4b22-d5cf-4659-bb73-6dbb732ce70a,Katsuji,60,19,63,96,14,1,253,
5b0b9582-a828-49c5-8474-868a42e5465f,Katsuko,58,20,53,43,95,15,284,
327a8287-67df-48e4-b609-5ba3bb342869,Kattia,13,20,43,50,10,11,147,
2e668aea-ab0f-4171-ab6b-bf46ff6bd4d3,Kattie,32,6,77,50,37,37,239,
8dde53b5-b14e-41fc-aa24-bd9f54034fb7,Katya,97,41,15,17,90,64,324,
8270005a-7b3c-4602-9e9a-96a2b4fd780b,Kaua,88,82,24,30,46,70,340,
e4b877ad-6d0e-4cb0-9653-7bdb52b5f2c7,Kaula,80,93,70,45,29,65,382,
74ccc3d3-80f4-4b23-a6cf-f1a8ff8970c2,Kavari,36,67,93,69,28,82,375,
e7c9d4e3-437a-414e-a88e-98962f84e81c,Kavi,19,90,55,3,77,87,331,
ad2c3f9c-7c31-4e26-aa4e-5657e9077a6a,Kavya,78,93,77,46,11,26,331,
4d370523-d33e-4ff5-8185-5d83e4cbf532,Kavya,85,67,80,38,79,17,366,
b0bdc8fc-781d-4ce9-9df9-a3aa0311af7a,Kawana,63,83,97,26,100,37,406,
913a9ecd-9922-4a8a-8642-c93b311cbb84,Kawanda,28,15,48,10,52,87,240,
43b76787-342a-4eef-9e66-e1fea6267915,Kawanna,35,58,12,67,93,85,350,
8918d03f-312d-4f4f-a852-13cdba36f80b,Kawika,78,17,0,9,58,24,186,
a7e0d620-63a5-4f2a-8bd6-e53701ff2f16,Kay,29,25,72,10,17,66,219,
99a2b1ce-efee-495b-8a53-1177b982a341,Kaya,28,89,14,96,5,56,288,
3e4be3e5-f600-4efa-a793-bb48a2a0ee3e,Kayah,67,40,53,1,90,1,252,
1b674306-a932-4ab5-a350-2b97757fd9f5,Kayanna,41,16,22,37,97,39,252,
9a9d7f78-9bf1-4318-a1af-3cbe5cd66e64,Kaycee,57,70,20,71,60,81,359,
9d39fb44-bb2e-4769-8f10-63b4e371bee8,Kaycen,69,33,66,81,47,60,356,
d90eb458-b6d9-4525-b76f-038839b5746d,Kayceon,56,69,6,78,80,14,303,
1b55982b-0c5a-4e93-a6dc-82438c4d8ec1,Kaydance,72,64,73,84,12,64,369,
15a3555f-a212-43ce-bf78-e4112266ea60,Kaydee,85,87,12,52,14,23,273,
cd89c7f0-3270-479c-89fc-a0855aa2eb34,Kaydence,65,34,17,80,33,98,327,
dded46e9-60eb-42fb-8746-3f0cf4e656a7,Kaydi,13,56,62,17,46,98,292,
2c89d2cd-5bef-4baf-a290-9a6248b81a07,Kaydin,97,68,83,16,58,1,323,
171d3dad-6efa-4a96-ab83-910446b0af3a,Kayla,64,53,72,92,63,74,418,
54eea4ed-b0ff-41c7-9c07-b083d39f85cb,Kayleah,62,91,21,96,40,7,317,
b8be2a40-0f41-403d-8bfa-f6ba20f049e8,Kaylee,83,81,38,11,7,53,273,
8584fff5-296f-4939-b85d-9eeeaafbf48d,Kayleena,22,68,6,25,12,28,161,
e5c9b72d-7bc6-447a-967f-343df91771c9,Kaylia,76,46,35,96,13,91,357,
3b5fb378-49f9-478d-8a78-be05387b454f,Kaylina,98,77,5,84,99,89,452,
af8e7bde-2462-4ed2-b1ea-673b75fe0133,Kaylob,70,2,47,95,40,44,298,
cc7c6f4c-1575-4fdb-be2f-60e25bd06bc0,Kaylynn,35,75,18,85,100,19,332,
7e6d29d5-2df7-4d41-b6b6-f0059a05382d,Kayon,8,50,3,43,18,8,130,
432908c2-9d1c-41ee-9d25-f2c56bae85f6,Kayron,83,71,10,3,22,53,242,
a275757e-3e22-4c97-b60e-849bc771c7d1,Kayron,83,26,50,55,71,93,378,
989463df-b0b6-4656-8133-e3068565c576,Kayti,58,86,40,70,47,37,338,
1347a672-757a-412c-9f14-29ffeff62c59,Kazue,40,88,54,26,57,4,269,
de306528-7496-4ab8-b5dc-e7c77d3c5532,Kazuko,91,13,23,66,9,16,218,
c5976dcd-f77d-4bab-bf8c-d2b7186adf63,Keaden,45,83,45,90,34,72,369,
5b01b986-8fcc-4237-91ac-c65e7d00a46a,Keagan,47,20,9,67,2,75,220,
c94551e6-f65c-4247-8ae1-a53c6ec3b81e,Keagan,5,75,21,5,93,22,221,
808b65f7-f6b9-423b-8ab9-b6e734f02fa2,Keagen,65,68,41,4,15,18,211,
730e9da4-1144-4de8-8c0b-23a4029d65d4,Keagon,73,10,97,1,45,41,267,
c60215ce-f188-4f8d-b48a-3cbbbf998733,Keaira,56,59,16,67,87,86,371,
31668aac-c7ab-47df-aa06-07a651deea2d,Keaka,92,43,33,38,2,24,232,
a48c985c-e50f-4e85-ac93-635dca3cebc1,Keala,64,90,15,34,70,8,281,
cae7a332-ff04-403b-bff0-20f48bc25d43,Kealii,28,5,57,96,27,89,302,
3dd8ce8e-a40a-4ae6-8f81-fe6fe908b4ce,Kean,60,69,80,73,79,66,427,
a5fcc350-15e9-43d0-84ff-b65bf15afbc8,Keandre,44,79,80,33,13,49,298,
9e5253ff-2ff0-483c-b3c8-ff10138917a7,Keante,82,19,5,79,17,66,268,
fe6a275d-c829-4c49-b7d9-b215b11ac55e,Keara,51,34,59,19,14,18,195,
ee27265c-a2f4-4cae-8d5b-e27a5876cf8d,Keara,30,50,10,15,71,18,194,
fe46a82f-ad63-480b-ab6f-b687d077e056,Keary,38,63,41,76,67,100,385,
b04c6ad0-fa2c-4912-8d85-75cbd70de34a,Kebrina,93,90,55,39,86,25,388,
4e4d36d8-0842-4c61-86ca-cd3a9a1d2df5,Kecia,73,16,0,1,30,89,209,
ec2b0a18-5b05-4d51-80dc-454bd8573c24,Kedar,5,65,80,80,63,39,332,
ead456ff-edd6-4f88-9d28-bbf30179f430,Kedar,33,75,86,74,78,53,399,
a037a2b6-6dc0-4008-8da6-d32f164da1ba,Kedra,11,34,92,15,9,29,190,
6a28d7fe-a3d9-42ce-8a55-f82d2800a298,Keeana,63,44,77,92,39,7,322,
6e8ffcaa-f5cb-4915-9e5c-d54b142a924f,Keegan,77,72,41,77,26,51,344,
48ea05b7-26cd-4b7d-9830-b630e9f70a2b,Keeland,17,18,11,34,52,52,184,
2dc1de36-646b-4764-b452-5601a29895b6,Keeleigh,50,41,34,70,41,1,237,
215261b5-7fb7-4b1e-bc14-960636272de0,Keely,2,15,6,36,16,0,75,
f41d7a29-eb3d-43e9-bff1-699f3b016f1c,Keelyn,37,29,31,80,82,80,339,
2ec0b780-808f-4201-aae3-f7a5ca01cee6,Keenya,4,55,17,35,93,70,274,
1ff54036-3b81-4d57-836c-4139b715933c,Keerthana,44,12,51,47,82,9,245,
cc52059d-2bd9-4c33-be43-d5ee2e1734ac,Keesha,55,86,76,27,69,19,332,
533c4525-812a-41a7-85e4-abf85fb5f42a,Keeshawn,59,48,53,7,8,93,268,
1ccf91e1-ede4-4e2a-9c63-dda9373a4c73,Keevin,57,73,39,56,97,33,355,
d5911752-980e-4ec4-8f57-97377520ee17,Kehaulani,22,23,92,35,3,77,252,
ea8d05dc-4e23-48e4-bd02-dd9f6a9d8796,Kei,57,83,75,51,79,37,382,
9230073b-9eea-4e20-a687-f4dce6dcf200,Keiden,71,76,74,52,84,61,418,
68cb90f0-4dac-4935-be5c-8fe69f9031be,Keigan,65,39,82,88,85,52,411,
73192371-c4e7-4886-92d9-bd33e1d4ad55,Keiko,1,61,90,8,68,63,291,
500940df-e4ce-4074-889f-673a60749df3,Keiko,51,51,96,31,77,6,312,
ac42e56c-9181-4373-8d3b-acdd4cdc810d,Keiko,84,29,40,86,17,50,306,
a1a7e122-e381-4044-b411-142e056ca647,Keiko,80,59,88,69,71,34,401,
974835ea-9b41-4e60-8c2b-32b5120394b2,Keilani,5,89,59,79,35,53,320,
442a8ad2-527f-4082-b15d-c1c723cf4542,Keileigh,17,30,90,89,9,95,330,
68e8565f-6d4f-4971-9bc0-19a1c5004801,Keily,63,66,14,88,69,79,379,
9f1d0514-9ffa-40cf-a185-02a6bb914ecc,Keino,98,35,10,40,8,28,219,
859b42eb-ddaa-4671-8dec-df6a5c0b4ad0,Keino,83,21,15,55,42,29,245,
628cb0ca-7fb4-4bf1-af13-2fb851c7c1af,Keiona,30,53,37,65,34,1,220,
babb6f48-1c2a-46eb-affd-e85d3c8c8190,Keionna,86,58,69,59,66,6,344,
7c565f3c-d432-40fc-a1dd-4ffa553089fb,Keira,6,37,62,94,11,73,283,
ff96f831-2896-4c89-ab02-d0aa529b1af2,Keirra,37,40,21,36,5,13,152,
aac24e86-9164-47cc-a5b3-3587f26ef35f,Keirra,15,67,70,17,8,88,265,
1f045102-5492-40c3-8a0f-d21c3e52baea,Keisean,89,26,24,46,82,9,276,
be12851c-051a-41af-a7da-c98eb6228835,Keisha,33,30,31,60,11,35,200,
9369d336-3a00-4db8-849e-ab4bca9002ce,Keishawn,14,68,26,28,59,30,225,
ba9247d9-3623-4785-9ea3-ed6ae0ed9c1d,Keishla,30,85,80,20,10,22,247,
1ce29a7f-5c9c-4bab-87d0-41e94148e34a,Keisi,66,10,71,52,58,31,288,
9dcddb26-9241-4c64-b68c-11ad96468e74,Keisuke,99,87,7,45,30,32,300,
992989a9-27af-4999-bab5-58f671441ba4,Keita,14,8,34,34,24,32,146,
a8e69006-f7df-4f33-8e9f-3dcf34e08600,Keithan,86,68,13,17,40,58,282,
b1af1b86-99b1-47fe-8391-b321bc18f23e,Keivon,27,40,40,51,28,15,201,
f285afac-2e65-4cd6-80a5-12c01094e001,Kelani,69,20,9,53,83,12,246,
f7d52301-7cb5-4dab-a30b-197de1c3fb05,Kelbie,17,32,23,69,57,47,245,
34f9c0d9-ccae-4af7-a567-d47e4c7eacb3,Keldon,10,41,45,47,4,72,219,
47f26494-b192-47e3-a884-c86bcb2e3995,Keli,79,56,68,98,80,58,439,
2ab9bf3d-996b-4c62-bd3f-ce5664e0bf56,Kelia,15,81,91,33,98,98,416,
57fa92f3-18e2-4c97-a902-b7672020931d,Kelin,79,67,7,50,57,81,341,
0d471391-5c6b-4cc6-a540-0d278d918690,Kellan,71,92,70,22,92,82,429,
09ee4dfa-e548-44ce-874b-96a07bfb7138,Kellan,55,56,55,57,14,11,248,
b83d036a-2d62-4eff-bfe1-c7cf84e6f18e,Kelle,62,92,4,10,13,7,188,
886a0bff-829e-491f-bfe1-2c57e93c1b34,Kellene,31,58,15,11,62,32,209,
97e28f48-86aa-41ea-8799-58465c2f3f2a,Kelliann,56,8,35,79,62,37,277,
33f87b1a-678a-4d29-968f-818458816cbe,Kelliann,48,100,99,63,36,64,410,
677114b1-6728-49bb-bbe8-9a73098a0ba1,Kellianne,23,45,43,56,39,58,264,
f800167b-29b2-4362-940c-d91484372066,Kellsie,36,36,73,14,98,90,347,
5d7eef3b-9ef8-43e2-909c-c9ed0cb887d4,Kellsie,31,89,2,51,79,74,326,
e77057be-94f2-4724-b803-1f97305e3316,Kellyn,20,89,61,68,52,52,342,
6e76bed6-d3ab-4321-b6f7-53130b6bb3e9,Kelsee,74,17,80,98,37,62,368,
c08f5440-a977-488d-ba87-056085d551b9,Kelsey,17,87,1,72,48,39,264,
23661c73-8a29-4ac1-b504-921b6693627d,Kelsy,28,53,99,2,64,80,326,
eeee144a-d7a9-422c-8e65-0d9200e975f8,Kelsye,25,56,100,10,89,29,309,
83e4e77e-3fc4-452f-b0bc-fc40e6de60e0,Kelvin,13,92,63,37,5,33,243,
27870384-31cc-4939-824a-f19f7c5190c5,Kelvon,10,46,95,74,62,58,345,
ac2a62d9-874a-4513-85f1-35250104424e,Kem,2,72,60,87,49,56,326,
c7f2f8d0-19de-43db-8ca5-8a74e7207aab,Kemaury,11,87,82,77,74,34,365,
5bbbaa11-a774-49d4-b6e0-0f2e573e8241,Kemaya,7,49,68,69,16,80,289,
299e0798-c1ce-4b14-9304-bc7e9969ffc1,Kemaya,17,13,45,1,29,36,141,
34778564-a063-44fc-b8be-9cfa26569f9c,Kemaya,14,55,96,99,1,52,317,
e990521c-ea68-4544-b74f-eb6ee209cb09,Kemoni,50,89,42,79,83,21,364,
31e58be4-bc5b-4842-9fcd-90ff6ed517b5,Kemp,64,91,34,44,39,2,274,
d060dce2-d697-423b-b693-404e395a007e,Ken,19,78,13,87,98,87,382,
fb1db0b1-875a-4731-bbfb-c3ee732e73c9,Kenady,54,90,48,25,73,12,302,
99801c37-40d6-4f3d-b3a5-44e948e4a4d7,Kendale,86,82,17,48,90,68,391,
fd1839be-6576-4805-8753-3942d1a5ada6,Kendallyn,19,56,81,7,87,45,295,
9241430c-1fe7-49b2-acc9-179d456422d9,Kendarius,68,62,46,43,51,84,354,
82297055-6e35-445c-b12c-d17d1f0ee397,Kendarius,48,31,40,70,54,52,295,
0a38ba5a-8dc9-4e61-b53e-323772eaf563,Kendarius,12,19,89,60,56,30,266,
0b6dc1b5-128b-4029-bb2f-df43b23ae7ed,Kendell,46,64,7,96,70,22,305,
9dc79ea7-b59a-4f69-9bb1-3fdbdbfb71d5,Kendell,15,56,25,42,61,100,299,
b11a668d-2e17-4607-b04b-3b87576d6103,Kendia,87,48,2,25,83,2,247,
fc0f34c1-0514-4519-a603-44cbc2fd3ab0,Kendle,75,87,23,54,7,0,246,
bb08be52-1575-4fe9-a2e0-d491bc90f4cb,Kendon,9,65,47,98,14,67,300,
13ddb6e2-f1c3-4652-8bf0-e555fd418150,Kendrea,73,78,24,11,91,19,296,
ecbba537-1970-4a28-a63a-2b32daa2d5c8,Kendria,40,61,72,25,45,67,310,
03f9c2e3-b6f0-429e-8846-a2bf4126708a,Kendrix,41,72,2,90,42,68,315,
bcd9f299-9676-49c7-b292-e40398907a31,Kendrix,88,35,27,83,64,27,324,
3f9e1118-c143-48e5-9542-5578b50ce85e,Kendry,44,13,2,97,0,82,238,
e6af1d56-7d90-4079-af41-1c74de26d079,Kendy,75,48,79,20,61,19,302,
c4e40b75-e811-40cf-8a3f-286aefb3bd72,Kenedi,7,85,32,13,75,49,261,
77ebb283-a1c8-4494-857f-43d6c927df9c,Keng,32,36,60,45,83,57,313,
3ecdd253-a7d3-4636-ab61-555dc1621773,Kenji,95,84,54,90,23,33,379,
f8db5330-112f-48f1-8b69-21648a701a6f,Kenlee,14,27,98,51,84,44,318,
2305b85d-7bc5-4e78-b680-dbb69b168c21,Kenleigh,52,42,29,1,93,17,234,
ac05fa28-6c90-4c2f-82e3-413e9f8da3ac,Kenley,80,35,36,47,52,11,261,
1c1aa5a4-213b-4861-a3be-965253682084,Kenli,67,36,0,3,75,83,264,
1b7eda90-1b50-47d8-a8aa-d22ef5214589,Kennia,5,40,25,55,88,0,213,
c670a759-bb3e-45e1-89a9-c5dc01ee43ea,Kennidy,69,0,73,60,82,67,351,
edc66d14-1b79-4a50-8250-cdc596013a44,Kennie,57,100,93,36,15,67,368,
f4dca74d-d7a8-4c27-99a4-540ea1afa9f8,Kennith,31,25,67,1,88,42,254,
e393da64-6868-4416-9a5d-344b60ceb1af,Keno,15,30,100,77,24,26,272,
53f8aee4-49e5-41a6-97ef-7827bc6c622e,Kenosha,92,5,35,76,34,36,278,
9b14cde5-26a4-4f1f-b06a-621c8a773195,Kenshin,96,23,73,59,76,41,368,
3f745085-a2f6-41b2-80ca-cc8f0a41cf8a,Kensi,24,31,62,88,51,78,334,
d2b90f05-70a6-4fb4-ad4a-5c68e85d2c6f,Kenson,93,15,40,5,43,32,228,
f1fa91be-4f79-4a1c-8607-739ffa86eb14,Kentaro,8,73,24,33,85,60,283,
8bd5c45d-04cd-4d62-80dc-8eab26063200,Kentravion,11,26,80,90,7,82,296,
1ec34e5b-50fa-4cae-a4be-d2aa7e8ccc2b,Kentravious,82,86,34,55,26,95,378,
2d7770b6-8037-43d1-807a-0a243aafbf2e,Kenya,12,16,62,23,77,66,256,
984ff850-9797-40a3-a331-45845bfd74e7,Kenyatte,12,98,8,26,27,48,219,
30a306a0-b77f-4cd4-a850-809c632d7565,Kenza,10,87,5,46,13,16,177,
9e78baaa-4a4d-4abd-9571-5b031fb5ac5f,Keona,43,86,4,99,94,67,393,
258207cb-39fd-42bd-9deb-1baa68844796,Keondre,56,43,95,82,44,99,419,
512dc16d-a975-44b2-a2d5-d258dcded311,Keondre,84,63,48,17,58,5,275,
c0c289d5-8719-4559-afb8-dd29eb2ca186,Keondre,52,56,20,32,31,81,272,
47148993-bc19-43d0-a232-0dd6e5dfe9f4,Keonna,13,50,80,11,70,7,231,
02c88ae9-c3d0-4522-b59d-a2fdf13408cf,Keonna,69,48,3,45,45,75,285,
438bb51c-a540-435f-a277-73fe2daa0359,Keonta,51,82,9,49,34,85,310,
06399844-2bdf-4e2f-8514-410b3018a7d0,Keonte,15,86,20,92,79,73,365,
7b0bb264-2b0f-455c-8f4d-6e264cd3da1c,Keren,18,66,75,18,31,72,280,
bd7bf698-ab83-4285-9693-e2ff2334d593,Kerissa,36,41,24,43,76,24,244,
71251956-d99d-4434-938c-95b3301f0d0c,Kerith,38,90,98,20,36,42,324,
8cc817fe-5683-4826-8a65-9208d1b5fe8b,Kerith,19,18,77,63,52,32,261,
4927bc27-364e-4261-aeb2-15f5299dc230,Kermit,87,11,85,32,57,93,365,
a680dacd-92d3-491d-a1a5-ce70ca035327,Keron,87,13,70,70,1,8,249,
d1c4fb17-eb55-4331-8405-ff53e7991c99,Kerrianne,78,1,3,58,12,40,192,
7d543793-7efa-4198-a9f3-f551ed860cb5,Kerryn,3,87,69,34,22,81,296,
0bd1758f-21b5-4f74-aa28-daf63a134b3f,Kersten,28,0,84,27,60,19,218,
7b372e5a-3ce9-4b88-accf-ef4fd7cdcb20,Kervens,6,9,100,94,48,37,294,
84289211-b2d4-4c1d-b089-8df730667a1d,Kervin,98,32,21,66,22,97,336,
df56d76d-02fb-4f3a-a4cc-20a7e65f3f70,Keryn,45,51,28,65,29,37,255,
ec6eac6f-c6e7-4eef-a381-db8727f063b9,Kesean,35,0,48,59,44,46,232,
1ba9eaa0-303c-4e97-beac-dd3ab6b18af7,Keshana,3,33,40,79,3,8,166,
e43c9479-2fbe-4ac7-b67f-f12fd0bc4c63,Keshara,88,19,54,28,89,92,370,
41d37a60-13ec-4577-82c4-97f8ad2194d1,Keshaun,94,29,79,2,29,18,251,
57f48100-251e-4c47-bc33-626ca98fc83c,Keshon,92,34,52,12,25,3,218,
9f780aca-bc58-45f3-9bed-8808859c1e41,Keshun,92,16,35,67,59,7,276,
086ef559-f455-46cf-a27a-d13f8272c8d8,Kesia,61,18,59,71,15,83,307,
f940832c-d680-4527-973e-46b50b1e21e8,Kesley,61,69,52,89,79,97,447,
59564a65-693a-4a55-9588-713944535ed5,Kesley,58,21,30,84,71,67,331,
5840dcbb-85f3-43ad-a4a4-5a25fd0e7685,Ketara,37,24,30,88,52,67,298,
e42c0997-630c-4a10-a338-7fe87c87e3a1,Ketty,35,89,69,26,66,40,325,
4fd07e3c-0bc4-493e-9fba-90ec9d052db6,Ketty,11,17,100,96,94,22,340,
3d0f6177-855c-4cec-8554-4608f62c3b64,Kevaughn,54,89,62,32,57,88,382,
b44ed0e4-a7f7-4c0d-98a6-a40af8df0ec1,Kevinisha,98,82,34,0,10,5,229,
e32d67db-cd17-466f-b755-c51e77708db8,Kevion,38,21,21,15,65,29,189,
c1ec92af-3e65-44a1-9204-92ec390d4317,Kevondrick,87,42,86,94,42,14,365,
1f2687c0-61a9-4b9a-b928-49cf0d57577e,Kevontae,88,97,28,41,31,26,311,
ed3678cc-b498-4438-956f-b738cae21236,Keyaira,28,47,73,99,88,95,430,
086b4b44-fa88-4e93-be7b-03d00ba0b2f4,Keyana,47,33,18,32,98,66,294,
10c2b0cd-c86f-43da-b4c3-286da1f9238b,Keyani,25,16,35,34,45,77,232,
8c7b7af9-4ffc-4b2a-b034-297bc452406b,Keyanta,0,87,54,10,20,6,177,
d03e7bde-5210-4515-95fe-6c7d28e00112,Keyara,80,6,1,95,38,63,283,
aef0e0f5-30e8-4d4c-8f2f-522b8be45d42,Keylan,81,21,16,68,2,8,196,
ae1e933b-ddb3-4e2c-ba1d-0c1b4dee3f39,Keylin,39,61,69,0,49,26,244,
bf8ef83d-a6a0-4b96-a3f4-93255cebd85d,Keyondra,75,38,100,21,44,62,340,
e21c0a1d-8932-4ea3-ab6a-27e5ede3faaf,Keyonni,31,81,8,21,57,53,251,
097d4103-67d4-4bcd-a4e7-5335cf0a4bee,Keyshaun,84,45,92,61,0,87,369,
e7abf86f-6493-4872-9e7e-42d463be1199,Keyshia,94,38,35,65,33,51,316,
b6c2174f-3951-496f-8db4-e6f504dc9315,Keyshia,56,87,43,79,81,56,402,
a7a782d6-b6ca-4a8c-8b2c-8353c323529a,Keyshon,62,71,81,87,7,69,377,
2f84701d-a386-4c18-a853-990e96262b72,Keyshone,44,65,11,13,13,46,192,
5ab7e613-952c-4a47-abe6-1c639a556df7,Keyshun,40,43,76,43,38,43,283,
ebbe9c62-7a09-4c54-a627-7d013ccc6a97,Keyshun,38,25,27,61,14,96,261,
8a56ca64-e437-48ba-97ed-6bb57514d0be,Kezia,27,91,62,61,98,90,429,
908753ef-145c-418c-8bf7-07cac4f07cc7,Kha,42,59,68,32,35,9,245,
981596e0-71e6-4174-9b13-2ce0313b2e7c,Khaalis,83,12,96,27,91,49,358,
9428a013-209e-4bc6-bf86-eefdd7502105,Khaalis,27,85,45,34,37,68,296,
ffd8a419-6ca9-4862-bf15-322ef66669b1,Khadijah,14,59,18,87,44,19,241,
cf53ce42-c3f7-4542-a37e-f5a4cd2abdcf,Khadijah,73,79,57,92,17,58,376,
a9089d5f-e595-4157-b79c-d108bc77eb70,Khady,57,40,16,0,74,15,202,
523fe759-9c56-493b-9736-0cbe64985bf6,Khairi,60,40,26,39,44,1,210,
e15b9e67-e9c2-43ea-a741-55300fda89f2,Khalea,91,72,82,85,44,50,424,
8279ba28-a253-4684-a80f-803b2cc7c64b,Khalea,88,51,51,71,81,1,343,
d6e9f0a2-7d21-402f-9a94-af5baabbc1af,Khaleb,55,19,99,84,15,47,319,
bb34dfa1-2885-480c-91d9-8c520340e696,Khallid,41,100,4,11,14,62,232,
484dc077-5e25-4d14-8900-b3b3d78905bb,Khaniya,12,10,62,64,44,12,204,
11ab946e-d9ce-40dc-8989-46f9ba0f0349,Khaniya,31,50,34,7,41,71,234,
523a6a7c-8e85-4b64-92ee-6eeb6e88fe86,Khary,47,57,79,35,79,19,316,
4190dc31-99cf-42b9-ae2e-75043e18318b,Khayla,73,44,19,73,64,70,343,
e34b2c34-482e-466b-9d61-232fa73e600e,Khayla,59,49,29,54,54,57,302,
bda7cf54-71ab-4b0f-9746-d76ef87e5e4d,Khiry,50,87,81,97,22,1,338,
d93bff4f-c5e2-458a-8486-be6e7dcbbcf8,Khloe,72,47,25,15,86,54,299,
901b118d-b1af-4de1-82d8-2200da1cdc3d,Khloe,32,14,2,72,26,76,222,
e5c11149-e564-47d3-80ee-48c1ee311a11,Khloee,45,38,91,92,44,83,393,
5adce92d-9bd3-4482-8bdd-3e6e9d47e381,Khloie,7,31,54,88,39,68,287,
2438cabd-ea72-4e66-a3c9-a0c632a0cbc5,Khristopher,60,38,27,76,79,81,361,
b22bd9c2-9328-441b-83a9-a045d438ce0c,Khriz,52,98,31,38,22,23,264,
67ae12a0-5377-47f7-93ff-02fafc0a2af1,Khriz,22,9,1,49,2,39,122,
a2165d7c-36cc-42d5-a820-3f523ed19d49,Khriz,64,91,26,50,87,99,417,
274639c8-e04f-478b-b7eb-d539a0e461c9,Khrystal,78,20,28,23,63,59,271,
9672ea16-59b4-4fa5-a078-02d05a157152,Khrystal,29,27,71,87,22,78,314,
55a92af4-d29a-4043-8751-d2ead9817eb8,Khyir,14,74,39,39,35,54,255,
a2d2402d-bc8b-4225-ade6-aa4f2e0177b7,Khylan,15,4,9,71,20,21,140,
76c53a56-45f8-43a7-800a-21b983f4c1a1,Khyree,6,48,98,20,8,69,249,
3de1f4f4-d7b9-4242-bc6e-7861e587381f,Ki,13,47,91,74,23,97,345,
72b6e572-a87b-4b17-b46c-c59f4444627d,Kia,94,52,51,61,26,25,309,
db0b8f41-5611-4844-9f36-a41878e82a97,Kiah,13,38,4,28,65,31,179,
8b8ccf51-9375-4ed9-9ced-dc2a20eafffb,Kiai,6,6,90,1,33,26,162,
a12a285d-b7ec-426f-93a1-f3b75fda417a,Kiai,91,18,64,41,17,13,244,
c7091751-e8f8-4c81-935b-480718a3cb9d,Kiamesha,91,14,88,82,90,35,400,
a05cd982-be93-454e-923d-38f11fa0098b,Kiannah,19,85,0,94,68,66,332,
ffe7c110-2931-4b7e-af39-a3a38764d597,Kiante,95,61,96,87,0,37,376,
6aa8c702-c5ec-4b9c-9550-baffa04dfbde,Kiara,45,77,29,86,95,70,402,
888bb681-7121-4e86-8236-b0066b96fb95,Kiara,83,91,28,24,59,47,332,
ab3c12c0-5900-4443-8ac8-600759a89274,Kiara,65,62,66,36,51,43,323,
68f1798d-4185-4887-8e5b-5e67e35e3b2b,Kiauna,78,73,5,45,23,28,252,
0266140a-e438-4c4a-946d-57508c58aff2,Kiaya,58,63,22,71,14,59,287,
d344febc-91f9-4857-9423-c6e94e655f10,Kidus,35,61,53,3,44,45,241,
aa2aae6e-839b-4392-bf69-d9bce01a9726,Kiefer,69,30,89,72,97,51,408,
f74028a4-aa56-4a47-9205-7c9373cdef1d,Kiele,47,35,6,47,100,17,252,
74ba9959-6ebe-484a-95c4-565f9880edcc,Kien,83,41,5,92,1,19,241,
87d4e3b1-46c4-42df-bf6e-d51b468a94da,Kier,73,69,42,67,96,75,422,
33e480de-df35-4c65-a939-dc461477bed0,Kiernan,41,93,69,39,72,27,341,
806b97bb-83fc-4ae9-b0ea-4ddf111f7de0,Kiersten,96,34,45,98,82,73,428,
0739be9f-3d3b-49aa-90d1-9254f5289506,Kiersten,35,86,42,13,17,18,211,
962f4b5d-a92b-493f-99cc-88dca325835d,Kierstin,31,86,4,87,64,7,279,
1539beeb-e698-45f3-848a-177d7498efb6,Kierstin,70,29,74,1,78,22,274,
eb745210-f65b-4f23-a99f-21a526d35337,Kierstin,20,68,7,79,58,69,301,
a40f38e1-fe23-4889-907e-16089b3acfc1,Kierstyn,24,61,51,49,45,82,312,
b3855cf0-c2f2-42c0-9ced-fbfccf77b679,Kierstyn,66,41,11,66,13,93,290,
c6272f8e-f9e1-4578-8191-c2a7fb97bb80,Kiesha,42,34,32,18,37,37,200,
6313e6e8-f61f-49c9-b47e-c482be01aa18,Kieu,22,88,37,75,36,46,304,
df376610-25c1-4c8a-80f8-fab3dd2a9309,Kikumi,84,5,41,0,94,55,279,
c90a8241-289c-40cd-9c28-3087ac6ce46d,Kikuyo,98,60,28,33,18,4,241,
fb7aec44-af8d-44dd-ba2c-12aaf15936c8,Kile,64,6,98,18,13,52,251,
91eceaaa-3cb3-4721-9554-74085e74ea97,Kimala,63,90,26,1,20,93,293,
43bd9d1a-0a37-4c89-b294-2aa8adef0ad2,Kimani,57,29,21,0,38,95,240,
70cd0d5b-e5fb-46fc-bc8d-e2dc1282a087,Kimball,4,10,57,79,47,60,257,
0f5d295c-9770-4fc0-801a-daf6932cb5ea,Kimber,72,2,81,14,65,2,236,
db451c4a-8aa0-4583-ab78-00fb8ec76439,Kimberely,20,84,61,49,44,62,320,
654b7c11-eb53-4f44-be89-dffb4df18d6f,Kimberley,91,43,64,66,49,87,400,
e405861d-8193-4262-80f7-4ca7ff48f579,Kimberli,48,92,17,70,81,40,348,
abaff4ad-dccc-4053-a7c6-320f8120c97f,Kimberlie,30,80,4,33,71,8,226,
3a128ac2-6ff8-4f96-9d64-4964eed744b8,Kimberlie,88,75,34,7,53,57,314,
5c065e58-0841-4298-88fe-ec1812e21588,Kimberlie,40,70,88,31,43,13,285,
c600317d-a99f-409b-b0f1-a2efccc60193,Kimberlina,23,25,77,52,100,97,374,
5af8f327-b97a-439a-a7e4-af9e15a906b7,Kimberlyann,38,88,70,69,16,44,325,
fb8d15c4-e552-40eb-85f4-9514a9db658e,Kimberlynn,80,52,89,24,62,58,365,
8cb4624a-9491-44f2-8a9f-4607b63ddc7c,Kimetha,88,50,94,9,1,4,246,
04fc224a-b0f3-4799-a95d-0fbc18c57df1,Kimetha,72,42,24,60,37,75,310,
a23897a8-0bab-4f23-939d-0e39baa7d76a,Kimmi,82,8,28,93,37,78,326,
c560ac0c-0735-4f9a-a7b7-ddd7289c4bf2,Kimsey,76,46,36,92,16,5,271,
f83977c2-219b-43f9-866f-42cb988196d4,Kimya,40,55,7,75,84,3,264,
004c2973-3300-4942-884d-ec997354102b,Kimya,14,72,4,46,89,83,308,
8cb1c5c2-9b4e-4fdd-816f-85c04cef1485,Kimya,59,29,15,21,91,55,270,
5b1be3c3-f4a0-4793-b1b2-d69be57f68a8,Kindall,30,88,42,15,75,59,309,
2bc6a522-78bc-40eb-97b3-415e12516fe4,Kindra,28,94,95,5,36,12,270,
a4639848-efc6-418b-a1eb-1d5eb86ede84,Kingston,61,26,17,13,3,85,205,
411b9506-ebe9-402f-98ec-8c44aac60c18,Kinnick,51,74,81,5,8,69,288,
fc4fa732-4dc8-44d0-b06d-a64bdcba7413,Kinta,16,100,55,88,74,16,349,
ad6895ac-acfc-4202-8475-a0fd6b4cd372,Kinte,66,99,64,66,24,20,339,
3fd2678a-eae8-4ebb-b475-d12f579417bb,Kinue,21,39,43,26,20,12,161,
fc05c042-c5f0-450f-a8a7-fa2e2ee2cf57,Kinza,53,31,68,91,23,12,278,
3ea143fd-7980-4d25-b2db-c3005126a35b,Kipton,11,62,97,53,76,52,351,
5dc5e2d7-b649-4930-a867-1110fc96f6bd,Kirah,26,78,21,18,3,86,232,
e74961fb-359b-4c7c-a81b-3bcc980c2971,Kirandeep,29,16,63,67,37,89,301,
d1af06d3-3330-44f7-94e3-d5028c05f4fa,Kirbie,82,20,54,55,51,29,291,
2e4f7dce-a140-44dc-b44d-9581638d60aa,Kirby,28,100,47,8,52,24,259,
1005ec3e-569a-4b56-a548-20ee9729511d,Kirill,8,28,34,69,67,41,247,
5343b8a8-2614-4248-b3c8-b09ebfd616d5,Kirk,71,8,59,49,46,100,333,
9b5511c8-6cf2-4aa8-9f27-ef63b41b153d,Kirstie,19,63,69,83,94,15,343,
cc8f9afd-1b66-4d10-89fe-23ddd6b33e69,Kisha,68,9,19,6,12,0,114,
8175f41a-72cc-473f-b133-de23a6ccac6e,Kishawn,100,83,91,31,58,55,418,
ba0e897c-e79f-4961-bacd-8f241fcbe9f9,Kishia,72,89,74,90,96,84,505,
60c7d707-6f35-458a-82b2-1485dc8ea2f2,Kissy,60,61,48,64,35,69,337,
aa179f35-1f5d-4d81-b604-4cb5bbc6267c,Kito,73,66,30,60,22,60,311,
0e78d245-9ad5-420c-b4c5-4f3868d290a2,Kiyo,66,9,44,100,32,48,299,
c511cc43-3d2d-448a-838a-3a21cedb53ec,Kiyon,61,43,67,84,92,36,383,
cd616bde-eabf-4a72-bd79-5dfd7c9874ea,Kjerstin,89,75,97,37,35,89,422,
27aee9b5-189a-4c14-9fb3-7a4afaa4c4d4,Klaire,7,77,82,84,21,80,351,
0768963c-f5cc-4293-b196-42a618066eef,Klaryssa,58,15,84,14,22,20,213,
8e07c54b-5585-4f38-8457-be3633c3ce55,Klaus,10,14,17,64,65,36,206,
f5ed1d52-e202-4c7e-b8b7-86bd3eee45f6,Kleigh,51,47,15,21,76,76,286,
e05641c6-2515-4eaf-9acd-58f083a98684,Kline,50,78,43,52,0,31,254,
d6a8688b-d90e-4a8e-98f8-2cc94e4e9c15,Klinton,16,8,66,58,28,38,214,
9c72b3d2-d567-49da-a1da-4ec4a5ee9723,Kloee,68,16,65,86,56,42,333,
d3877593-ff01-42b9-a989-c32ffe0e1c3f,Kloey,82,64,51,12,53,65,327,
c921dfce-e25c-4d0e-9f46-6274658fc6c4,Klye,22,97,11,65,32,19,246,
84ea54c8-4883-41cd-86bd-9ca81d9ee0fe,Knox,61,68,46,76,57,98,406,
2efb073f-7645-4631-8fcb-0a11a7702e44,Kobi,25,11,64,53,44,53,250,
fcb2d7f0-2c41-415c-96e4-dc2cfec8aeb9,Koby,10,85,14,18,42,5,174,
a321d7d1-d8db-42e3-87d2-a58c48ea5484,Kodey,8,96,34,17,88,73,316,
b7afabc3-beaf-4f13-8f7f-aac4873124ef,Kodiak,65,70,82,10,97,82,406,
88cba000-23f6-4aff-8c40-a702d555b7b6,Kodiak,27,83,42,18,44,4,218,
f696f1b8-9284-4cd9-a5b1-a4485d29c2b5,Kody,92,22,53,88,37,77,369,
1786a39e-77e7-476e-8e8c-bfbbc5a4e0c5,Kohen,88,88,44,52,20,78,370,
1bd129cd-367b-4199-91d9-429e8ed0df7c,Kohl,81,44,92,71,27,8,323,
fc7e614d-0f49-4cc6-9806-13a48e07244c,Koichi,52,48,81,34,73,14,302,
41d17969-ea91-4faf-8a21-5f249b482f89,Koji,44,28,7,77,33,63,252,
bb7b1c7e-8312-4557-9e65-e8ea28e5e647,Kolbe,29,7,66,3,48,1,154,
14266a6f-bff8-495e-a8d5-aed5b6a60ae7,Kolbe,83,19,72,0,71,36,281,
16d9a4d4-9857-4617-953b-0567741cd8c7,Kolbe,87,4,1,98,72,57,319,
acb2eff0-bada-4f50-9585-023faa006ac9,Kolbie,49,97,53,58,15,52,324,
54a79275-181e-4722-936d-192d34ac1978,Kole,48,87,43,74,83,47,382,
7715b440-5b36-4d4f-b8a6-28078a7a1c0a,Kole,54,100,70,42,45,87,398,
d1985eb2-27a1-4c6a-89af-384248904e16,Kolin,44,37,18,25,37,9,170,
2a52ced4-df95-45c4-801c-af03fddf69fd,Kolin,81,2,53,98,7,73,314,
23f7cf3e-a6b3-4e7f-a83f-2141c118ff83,Kolsen,67,61,72,72,37,79,388,
4b4ceadc-37b1-4a67-9a77-9c0e24647b62,Kolson,100,74,22,32,81,15,324,
9b6016fb-9074-43f7-9c3a-dcf67df1a9fa,Kolt,42,68,92,80,86,98,466,
4fbe349f-6801-459b-a784-ee1b9d277109,Kolt,5,99,21,76,25,36,262,
43046e38-f0c2-4445-ab1d-596156b67c42,Koltin,51,23,19,75,11,40,219,
97bdd81f-e31c-4b76-8b18-d6671e5d8411,Kolton,0,49,22,4,21,12,108,
273081b1-6ba8-4508-a147-e749954f1ea9,Komalpreet,45,75,19,64,100,56,359,
9a9b7299-96ab-4697-9297-20aa47555306,Kona,56,39,38,63,21,21,238,
a14ac563-e4cd-42eb-a119-62feea342608,Koneta,10,30,97,7,45,42,231,
a353b62f-e1c2-4bba-aebd-ff1c20978dd5,Konstantina,41,53,83,6,52,8,243,
14160047-5ad2-4b35-930c-bf32cab5a0fd,Koran,77,25,51,55,17,68,293,
da74f413-5d4c-4762-b980-eb4d54b3d026,Korbyn,82,46,29,87,5,32,281,
0b10849e-c57f-455b-84b7-45f97e8b022e,Korbyn,28,81,42,60,3,91,305,
90403746-eb68-4a73-a149-eb519deb52c5,Koreen,28,57,3,55,10,56,209,
7c57e7ac-1116-4c62-b0dd-7823ace1e9bb,Koreen,41,98,27,1,63,10,240,
f8271097-0a23-495f-bae1-ec739f73f4fb,Korey,45,76,94,97,63,39,414,
6b7ed687-cbd1-4411-bba6-8a0a32cc0b7d,Kori,55,25,23,41,42,58,244,
3d5e300c-b971-46aa-9e0d-104571a09f04,Korissa,71,19,51,58,38,78,315,
ac343920-f157-4b5c-8437-d40f1a89bbcf,Kort,76,36,89,5,80,46,332,
a947edde-12f0-413a-8570-5bc7ceea6b9d,Kortez,3,11,68,81,21,97,281,
c834423f-5611-4f96-89d9-f2fdf58e36c6,Kortlynn,79,11,23,42,68,34,257,
08a137aa-4418-4cbc-a67a-03ce09888f53,Kortlynn,28,27,33,47,8,64,207,
d7681f19-c94e-4a1a-be2f-014788d2fea0,Kortnie,90,66,30,96,48,88,418,
203e775a-f928-4ea9-8351-a1fec132b1af,Koston,74,22,8,84,20,55,263,
dc94b653-a23e-4b1a-bfdc-d72f4c4164f2,Kotaro,32,54,0,79,8,58,231,
d03494ca-43e5-4d12-bcd1-36d1637c0844,Kotaro,8,20,64,8,66,27,193,
39a3d669-9748-4ce1-bbf4-e64c64788072,Koty,88,90,37,78,10,19,322,
c55614dc-0f7d-4fd2-acb0-c24341ec6aee,Koua,42,5,75,4,80,13,219,
f781541e-8f6a-44e4-a239-efeb01e159c9,Koua,92,84,8,53,25,18,280,
952c1655-39e5-4064-8d6a-13552e957029,Kourtlyn,64,82,100,96,42,26,410,
7e7c29b4-8645-492c-bde5-5b9eeea273ca,Kourtnie,11,23,0,26,78,69,207,
fac11e14-bb42-49d9-b4d0-42dbcc865674,Kraig,87,74,30,22,94,75,382,
fd998ac8-8855-4bf3-af86-6781581d370e,Kramer,11,79,60,87,77,100,414,
98aa6306-c91e-47ed-9476-4a018ad30b78,Kree,52,70,26,18,76,4,246,
82955d21-ab40-4711-80b3-de8fcdd8a59b,Kreed,44,8,28,15,25,97,217,
c1dea97d-841a-467c-a762-0ea1ab52ecc0,Kreed,83,8,40,62,49,62,304,
5eca30c3-3d6b-433f-acde-f87e1f9e9089,Kreindy,28,42,95,59,34,89,347,
70144e31-2485-49a9-8775-719ec602c36e,Krish,14,20,61,35,40,45,215,
ccc2a660-c305-4d6e-9775-90ae82e8f033,Krish,92,8,53,50,84,61,348,
e1ece02a-46c9-474b-ba99-428771afa5b2,Krishang,93,98,91,52,68,30,432,
5964f9e4-2b46-43cb-9e7b-fd8a24ed9e2e,Krishang,74,51,65,97,10,58,355,
c2fdf62c-d1b9-4d2a-8bdd-f429156aff29,Krissa,40,35,80,74,58,5,292,
4a06002d-0b73-4328-b31b-acbf890be221,Krissa,43,98,97,63,0,87,388,
897223ad-6f5e-4f9e-b0f7-b2e18892c6a0,Krissa,85,25,43,66,23,94,336,
59fb919c-9f33-4fe3-b863-0fc15202b0e0,Kristan,76,5,66,17,18,33,215,
3c3437a6-661d-486c-b592-7a40d3ce504a,Kristan,43,63,60,36,87,17,306,
e95d72da-6060-4294-a898-f330eea8bbcd,Kristen,80,83,83,6,56,34,342,
3ac177f6-32f0-4bd3-b756-6c371c31be4e,Kristena,100,82,71,0,24,44,321,
d0ea1931-3663-4389-a25e-3d6eab66052b,Kristena,44,97,61,36,79,83,400,
275f3658-5d9a-4006-ad6e-47874eafcc61,Kristie,97,10,9,97,38,97,348,
51573ec8-1183-4142-b458-651d66080aa6,Kristinamarie,29,12,67,85,48,77,318,
6bb5155a-2a84-4844-ac46-2e46960fba88,Kristle,70,6,94,14,11,49,244,
55f12539-11db-48cc-98f4-11173e51ca71,Kristofe,58,19,65,82,81,89,394,
1b99ebc3-98d0-46a3-b6c1-5e3567545631,Kristol,73,86,37,86,80,86,448,
964ef9e6-e5cf-4d9f-b4a0-57bb9bc11f9b,Kristoph,32,47,55,99,50,15,298,
4bb6e086-e677-409a-bd9b-4f82250a84e7,Krithika,61,95,8,57,73,55,349,
56c49b12-e390-442b-bea3-1c9b372f4fe3,Kross,83,21,26,69,38,50,287,
890b46a8-94d6-4e4d-8d1f-aaac9c4cd7db,Krue,68,29,38,30,44,27,236,
1c4696f3-c182-4ac0-80c4-3685681535ec,Krunal,20,63,62,31,62,74,312,
95e54627-432f-4f34-a75c-729b68d3aa37,Krysta,67,47,74,99,54,44,385,
cd94b3e4-96d3-480d-958d-0f748891814b,Krystalynn,38,95,34,54,13,9,243,
ef8e1564-dfdb-4053-93ff-a705b4dabf56,Krystin,77,60,30,28,43,53,291,
9795416c-c692-4cf7-b570-dba19a8de550,Krystle,18,46,20,3,11,12,110,
e6f7f1c8-1669-4ff1-80cb-6318e84410a9,Krystyne,79,61,55,29,18,83,325,
e7271a41-e050-4ecf-9b1b-7e539847dc5b,Kullen,96,15,2,53,65,52,283,
1477f65b-4a1f-4ca3-935d-2adbf5815694,Kum,48,86,97,97,4,39,371,
4be8960e-e5bd-422e-be9c-49a9c23b999a,Kunal,36,83,83,23,54,82,361,
8195d815-cb68-4eed-96cc-2990ee7682ef,Kunta,8,91,7,31,56,33,226,
849424fe-7683-4c6c-a1ed-889529cacc48,Kupaa,17,57,80,98,88,84,424,
195f2f43-fa52-4f91-83c8-3f1ec3d6bb1b,Kupono,80,19,61,4,23,44,231,
92d6fa7f-0c15-486c-a40b-3a4993311520,Kurstin,17,93,100,99,66,57,432,
70fa81ba-5f0b-432a-8d40-a439de0c3619,Kurstin,26,52,31,35,56,65,265,
48600e8e-020e-45bc-b9d2-7fe98b36b1a1,Kushal,82,19,8,71,40,34,254,
8f8faab6-16eb-41d1-94c7-9aeeed84041b,Kuulei,17,13,22,24,38,27,141,
5be46cb1-98bf-4609-84ea-4ed5b4fd5d38,Kwabena,57,48,68,88,99,29,389,
b59a1645-4d23-4491-8894-71912017fc65,Kwaku,80,52,11,24,2,32,201,
bce68efb-cee3-4614-be06-c0dc813eae48,Kwamaine,17,75,25,59,71,8,255,
5c21de64-2601-42b9-88a4-2d2289724b7f,Kwane,88,22,29,10,26,3,178,
8fd18f60-cfbc-4a6c-b1d3-45d65cf86985,Kwanza,72,2,38,79,7,43,241,
e89f46d0-f1f0-4c7d-988a-bb65789abf75,Kweli,28,89,45,93,8,67,330,
4f69a676-c843-4d77-b335-1d11b5719a9e,Kwesi,99,79,29,80,84,33,404,
a39738fc-e9b6-4bcb-88e6-6ab2549feed1,Kya,43,22,83,85,0,68,301,
201de503-9e40-4d0b-9be1-52eceb650a0c,Kyanna,4,71,39,7,99,75,295,
a441cc5b-c688-4ca4-b49c-96df8c90f2e9,Kyiah,53,96,11,97,92,67,416,
1f8b590d-393f-462f-ba6b-23ffb0a35c8f,Kyiah,24,52,73,68,34,53,304,
9236eea2-c25f-47a0-9dd8-efdf321326e9,Kylar,43,88,61,51,73,9,325,
9dbcefa3-9108-443f-9a76-b36a88d93352,Kylar,13,55,37,10,71,72,258,
b4680834-5dc0-4be0-93f2-762fcf67a5db,Kylea,68,28,70,18,55,39,278,
b7d22803-b07b-42a1-8924-6118ca64e2de,Kyleanthony,12,30,66,74,55,60,297,
4f25c488-4e70-48f8-a2f3-24e450dca55b,Kylee,68,38,85,45,50,86,372,
66487a56-44d9-4408-84e9-034b68ffd295,Kyleigh,41,48,17,75,38,4,223,
5904eac1-a49b-4f8f-9a11-9b4a69f74085,Kyleigh,40,54,38,89,32,36,289,
9708bec4-55bd-480f-9a4f-49a69fb04686,Kylematthew,0,69,12,65,62,53,261,
9914278c-abd3-423f-a2e7-e11053fb7011,Kylia,80,18,98,24,22,48,290,
856a269f-abe8-4c4f-9594-294378fe9743,Kylie,57,88,13,40,7,45,250,
d8929b74-3cae-4034-af1c-175ae293d648,Kylie,98,36,56,46,62,97,395,
cfc0ec03-25cf-4941-8952-a7d53621bf83,Kylin,41,37,0,37,17,86,218,
64e1fbe8-c6ba-4306-a1ec-6895499d096d,Kylynn,28,68,18,84,60,59,317,
f4ec3d97-2b14-4f65-bf17-0f696961b66d,Kymari,87,38,86,30,26,14,281,
2b64d225-3868-4eb9-90b8-5a4035ef7379,Kymberli,87,35,6,88,0,68,284,
22b4032e-a74d-4b36-a68f-ec734f305170,Kymir,27,66,25,30,37,4,189,
20fb582b-b5f0-435b-b5bc-10afde426e2c,Kymir,90,96,29,74,54,12,355,
c1e94967-3cdc-41e5-b19a-7df94b16e6bb,Kynadi,49,84,47,43,21,90,334,
511ac900-adf6-4b12-9ed6-40e1fa557801,Kynadi,100,62,33,52,7,8,262,
ec4ac78e-7e7d-4410-ab81-a48cf2dfd9e0,Kyndell,85,29,5,94,20,21,254,
5de4ce15-fbe1-4dd8-9060-a12e4e05b83e,Kyndra,11,49,11,14,83,61,229,
3dfaa400-6b98-4da0-a386-d686e0970726,Kynlie,81,74,44,44,7,83,333,
04b0b31d-0ea9-4e36-97a2-bbb6509ed952,Kynlie,48,46,53,38,16,91,292,
2167f3a2-8de1-423d-82d0-c030b18615dc,Kynsleigh,55,59,88,40,14,72,328,
ac540ae8-31d7-4b1a-9135-49bed3ce67ea,Kynslie,88,9,75,99,2,66,339,
79d405d4-d073-4b77-b49d-aee380652ade,Kynzee,56,46,95,65,53,20,335,
b871eebd-b7e6-4fc0-91ec-febc91efb496,Kynzee,10,57,63,75,11,63,279,
2b58ad95-631a-458d-985b-f87fefb5ce7e,Kynzleigh,25,48,40,98,97,92,400,
b4d67e70-2c2f-40a5-9178-d604fc3594b3,Kyoko,74,4,54,57,40,83,312,
8036244a-8866-45dc-abf3-2720aae7818b,Kyrah,25,63,55,41,8,56,248,
443b994d-e837-412c-88ca-1558450ba15a,Kyre,84,41,98,6,12,72,313,
fc3833bd-fe88-4631-9b48-d276f6d8ca8f,Kyrell,96,3,45,99,64,26,333,
38af471c-7070-4f09-8fb7-3ffa356595d6,Kyren,80,80,74,4,81,12,331,
1ac3123c-15fe-4001-9073-73eb457cd40c,Kyri,51,95,49,21,41,31,288,
092bc1de-6035-4ad0-87cc-f8679d2be2f6,Kyrillos,23,45,53,31,32,90,274,
58dca2ee-a206-425d-aac5-73af2bf2c63c,Kysen,61,40,16,63,76,0,256,
774951f6-3ce9-48fd-bf99-b8fa69a40eb7,La,39,48,19,93,92,10,301,
ca72c231-c19b-4200-a2ea-a2b06a2c6532,Labarron,37,94,27,43,16,72,289,
f9bb62c3-3d3a-4b1c-9b0f-983d864b97d4,Labron,67,76,10,28,7,20,208,
62e87ca1-22d9-45ac-8c5a-ebb32536430b,Lace,52,95,71,32,88,80,418,
a2a9d902-f0a0-4132-ab06-2bd8d24f2f5f,Lachanda,57,76,16,37,23,59,268,
bca820d1-13fc-41b6-909e-a48dcf9a8f34,Lacinda,60,69,9,17,9,88,252,
8ce26f29-45ce-4f93-9031-c200d4c5ed45,Laconya,33,67,55,0,23,80,258,
875a7e83-2280-427a-b6d9-76230af59de0,Lacresha,62,74,92,84,70,91,473,
57e58f27-2fd9-409d-8099-8c0ff8461834,Lacresia,12,51,29,21,72,83,268,
4fa0befe-47e6-4f3d-82cd-829c37907695,Lacretia,88,4,94,15,29,22,252,
1219f300-4b1c-40f5-9011-bcad76f246bd,Lacrystal,1,19,91,90,80,92,373,
637c5fbb-c6fe-4b62-91eb-44eccc634480,Ladainian,22,82,6,76,82,34,302,
aa526b38-3f26-47c3-ba48-7a623fad2013,Ladana,8,74,72,1,95,32,282,
a0cb0a71-0d03-46a1-8229-21035d6bb635,Ladarion,25,55,29,4,59,38,210,
3f4928d5-93bd-4863-bfb3-5a01626d98a9,Ladarius,71,17,21,9,18,3,139,
01ab3037-1410-4a3a-bbd4-a9d2d2682488,Ladarrius,0,43,44,86,79,62,314,
cae7e948-7104-43eb-8375-c8daa65e8e96,Ladelle,20,47,54,22,99,50,292,
b3d342b6-2754-4670-88f6-25e57604ef3a,Ladelle,17,69,45,76,95,48,350,
328c33d0-a440-4541-88e4-0107afbcba02,Ladena,77,85,85,88,10,94,439,
73041205-7f94-4c68-b126-23729ac1d8cc,Ladislav,1,27,26,25,72,44,195,
763d0179-eb3b-40c4-a52c-43b3bba6ec1e,Ladonna,7,19,24,77,29,50,206,
4837ad1c-347f-4ddb-ad48-2e68112603b3,Ladora,58,2,43,97,72,58,330,
31396a13-2b94-4aa6-a333-2262ebd253a0,Laela,10,12,9,30,34,12,107,
18867ea0-988d-452e-8342-3ea25efa86aa,Lagina,51,95,52,78,24,81,381,
22a364ec-1673-4a93-aeb9-584d8f6ee920,Lahela,7,4,86,13,86,25,221,
591b35f9-dad4-404c-9adf-c1bbc44b2337,Lahoma,30,14,35,100,40,54,273,
6a03f719-13d4-4336-b510-7b519a1a4e83,Laiah,36,76,88,50,12,27,289,
b2185aba-84f6-4913-a096-5b5a103ee77d,Laikyn,96,37,55,55,73,17,333,
eda2cd52-22f8-4c2b-8be1-b0f3a5a8b8dd,Lailah,42,50,56,59,69,39,315,
e0894b5d-5820-4f5a-894f-8e3369154975,Lailoni,27,20,2,77,41,4,171,
f2ae54fe-1b77-44f6-a01b-bdede3dcbfe1,Laina,57,14,57,72,82,14,296,
ef508943-3ec9-4221-9b84-09c2d53e6e06,Laine,29,63,16,64,79,53,304,
baad32b6-acf6-4039-8f33-cd092212291f,Laine,67,48,34,52,42,18,261,
000674ea-613c-461c-8161-cf226c83c4bc,Laini,99,81,36,66,87,3,372,
45c40279-0363-4868-87e8-95042ddd3331,Laisa,55,25,48,55,89,59,331,
a9ff2df4-1c31-4df3-a720-eb1212319ad6,Lajessica,87,82,59,15,62,21,326,
73a66872-d327-4388-8d55-5d1be67343bb,Lajuane,77,40,6,8,16,4,151,
4ba65e8c-95df-419c-9da8-9f705062695b,Lakai,96,4,24,72,92,5,293,
cff8e488-dce5-4a6b-a629-450709dd1f82,Lakayla,0,65,46,84,11,76,282,
a54750f6-5509-47ec-9b48-8fd00f6e5d09,Lakayla,71,3,42,38,85,80,319,
039e4b1d-07e9-4cce-9afb-5749d3cad6c7,Lakedra,70,96,82,16,1,77,342,
2eb3fe2d-7fbf-4ca5-bc68-5e1190ffb4ac,Lakeem,36,73,0,98,47,62,316,
04a33a9e-d4c6-4e58-9baa-8cf22e242f24,Lakeisha,90,45,86,64,37,63,385,
e0a22c40-e286-4514-9a44-9a668fb0477a,Lakendrick,45,62,95,10,6,47,265,
8d4a175b-6b0f-4e00-a481-6441b519e672,Lakeria,58,44,67,6,13,36,224,
44da262c-3b74-48b6-8308-9d900cb5899a,Lakeshia,27,88,59,53,87,55,369,
52a488f8-ea04-45b3-be07-bd85a54e54d0,Lakessa,69,35,21,92,70,77,364,
8df6ea58-b39d-4480-8574-0a58167f6ef3,Lakevia,31,12,34,100,75,29,281,
b2818432-6c9d-4943-b4d8-16abe785dbad,Lakia,7,40,89,4,12,95,247,
e672ab3c-4130-417a-93d6-d8c344d4154e,Lakia,67,19,92,14,72,89,353,
8f3b6667-abaa-4f0b-a09e-e74bfe0737d2,Lakia,77,35,69,5,27,1,214,
abb1b2c5-b763-4ad7-9f1e-d9dda00ab1c8,Lakin,39,94,86,20,12,72,323,
66d562ce-4a80-43e8-b7a9-1dba85ee5f0a,Lakin,58,35,12,50,90,9,254,
8235c656-4d44-4720-98f7-c9372ed12d68,Lakindra,59,61,27,24,55,63,289,
6d25b2b1-c4bb-4789-b78a-dc1b069885b4,Lakindra,75,7,23,68,100,38,311,
3767996f-5d0b-432e-92ee-0a4a29ceb3de,Lakisa,10,62,91,66,74,3,306,
b55750c4-4bf1-4e8e-86d1-5ec62a5fb236,Lalia,52,8,39,51,60,59,269,
8f1efb84-447e-44dc-a2d2-f840b5bd5205,Lallie,29,69,77,6,91,69,341,
b48c77fb-5e1d-4236-8e9e-8fa5e8d4ed56,Lamarcus,0,36,26,29,73,59,223,
e9e76371-f8f3-4f46-b9f7-621dae2e9a9d,Lamari,29,61,14,5,49,99,257,
27c409fc-a887-482f-8c92-b25b2ad2305e,Lamaria,63,94,89,33,38,68,385,
df96e93b-d77f-4808-9090-fa86d88602e3,Lamark,29,14,47,21,42,46,199,
86897ee9-cfb1-4883-9a4a-1f78f2d71924,Lambert,84,30,20,67,49,42,292,
3d4ba7f8-9fc4-402a-b9a3-08387882893c,Lambert,16,74,42,88,59,31,310,
750b0933-5a00-4169-8905-541d40107732,Lameek,35,81,99,87,59,34,395,
23e5d8fb-5a53-4105-b6b9-9bdcdd3dd725,Lameeka,82,48,14,40,46,64,294,
68d1d112-6167-4fd5-8263-a4ea5cdc2c92,Lamia,73,39,53,57,75,78,375,
54cb99ca-e493-429a-b031-6a6131268cee,Lamir,5,2,77,20,56,48,208,
49d14971-a510-4bd9-80e5-04781fe3221a,Lamiyah,23,44,41,92,71,95,366,
f4d93976-87e2-4578-b9ce-11ebe8b9edb7,Lamonica,50,61,33,28,55,77,304,
70f7dce1-cd97-4433-b4e1-25d93dc03ae2,Lamonte,36,55,66,37,23,8,225,
e4b8f9f3-da18-4b85-975d-ceb70d08b0f3,Lanae,93,39,37,69,94,97,429,
f93cb962-33a3-4075-a6e5-2596228a9ad4,Lanay,99,72,70,94,94,54,483,
f5641002-05d4-4cc8-89a7-8cea451dc23c,Lancelot,7,19,76,37,27,80,246,
ab8bc82b-6e1f-4990-b7c0-d89bbdcc9f32,Landa,46,66,71,31,96,71,381,
fadfa4e8-5ceb-48d5-a8a9-4a5d34e54dc3,Landin,4,55,4,28,27,54,172,
4aa4043e-64f8-48c6-9dfb-eaea149b4a2c,Landis,54,16,17,62,17,38,204,
79aee89f-fdc9-4b6f-95e8-085a4282617c,Landree,54,40,84,40,68,92,378,
fca89acc-1a88-46b1-8c4e-3358572876e0,Landree,76,48,72,64,99,53,412,
ff3c1555-af2a-445e-bb00-d15395067911,Landri,49,48,46,30,32,62,267,
7d6e32a5-c051-4583-bb74-1db40ab86a4b,Landri,34,67,93,99,47,86,426,
087a9778-9b3b-4bd9-a94d-fffc98d62824,Laneisha,47,95,97,54,19,17,329,
a261f382-30ec-4af8-b8bb-240c3d3c7086,Langston,14,25,33,59,33,23,187,
f5c4c012-86cc-405f-925c-2255ca7ee15b,Lanna,31,25,37,16,64,6,179,
2f836385-43ce-4e20-b014-101f75519b23,Lansing,47,66,58,68,52,11,302,
f7df520d-cde6-4a7f-b9b3-c5c77c6ad650,Lansing,65,94,96,32,84,99,470,
a98fa02f-d5e1-48a4-afba-4fd87172dfc3,Lanya,64,28,9,71,63,74,309,
0163269b-4a34-403e-a0a5-798e1e6a04c2,Lanya,13,12,70,24,58,57,234,
5506df42-8d22-4623-a29d-f512d95c097b,Lanyah,91,98,10,86,71,31,387,
cdf017c4-cd97-48af-be69-a540e3a54f76,Lanyiah,18,19,15,33,78,1,164,
bbef7577-6280-4194-8069-7a0dd5f53da1,Laporche,88,41,93,25,63,98,408,
6cedbfb1-dcc6-4260-b445-68e0d1c1026d,Laporscha,22,16,92,74,17,91,312,
dcc9c729-862c-4c27-b487-f0e34ec92358,Laporscha,53,52,58,24,4,60,251,
504a68e7-bff0-41d5-9b7e-ab8faf7670b9,Laporsche,52,71,83,44,6,32,288,
6b6d54c0-7bf2-447f-b88b-9cc4c54c21f0,Laporsche,20,97,82,1,24,65,289,
e4ed8913-e31a-4af4-8a4e-ca015bbe7310,Laporsche,34,99,53,14,41,74,315,
87f0451c-0c05-45c3-aba7-cc5c0736c35c,Laporsha,56,77,98,34,28,20,313,
a6b6eb40-207f-4b4c-ad0c-d94c88f3d213,Laquanda,77,17,37,10,51,54,246,
4e5fe405-61df-414f-a50a-01d71312add6,Laquasha,76,94,47,85,84,57,443,
7b7c5ac2-9483-496f-9eed-53ce98570a6d,Laquetta,3,58,98,35,82,52,328,
91fb80c4-adaf-4900-805e-2b796391a512,Laquinthia,85,5,76,51,37,36,290,
67498cf0-24fd-41db-80e6-677f58fe7a8e,Laquinthia,43,20,9,95,83,14,264,
e1fe7e44-8ce7-4905-9ecc-100031cd7ea1,Laquishia,77,4,39,34,67,65,286,
63391cb3-4737-4440-b64a-984ea1a81e7f,Laquitta,46,78,95,41,57,85,402,
2f2ea0d7-94ed-41a5-aa77-c77d5487bbf9,Lara,92,79,15,49,86,7,328,
2e802995-633d-4fea-97ea-c01f0ead4141,Laraine,73,90,74,8,12,35,292,
aed7fbb0-6e87-4829-8a57-da03f281738c,Laraine,70,38,49,91,19,76,343,
c0001b64-b757-47d6-a901-93d7fba5d877,Laraine,83,17,21,99,97,31,348,
a8567f97-61e6-4cbb-a8dc-ea1a88bb00ee,Lareina,80,60,6,70,39,5,260,
9953f0d4-a7a5-4d66-8a92-e3f74a6f964c,Larence,2,74,57,22,42,21,218,
a340c183-bdfb-4f63-8edc-e50c81e321ae,Lariah,13,70,92,57,30,9,271,
3c253f3d-2934-46c2-bdca-d9e519a5fabe,Larissa,73,60,85,57,68,46,389,
f5779d1e-5dee-4f7c-b443-ac0e918deb93,Laritza,83,39,2,94,17,97,332,
2d13c860-312d-444f-89f6-a1edf5214c91,Lariyah,62,35,1,77,35,57,267,
660eaea6-4ce7-44c7-93e6-6f4cc66c51e2,Lariyah,2,83,69,94,43,49,340,
272d2c75-aecb-44a9-b606-e330bc7504be,Larrie,7,100,25,26,18,60,236,
79479ea9-b055-4778-98d2-034b7afe8009,Larson,100,21,3,8,90,54,276,
770bb32a-569d-488e-8441-30d8927b9195,Larue,59,10,5,56,10,17,157,
8d3dba93-e5cf-4324-a345-cf161f1e4439,Larwence,64,59,55,87,53,99,417,
724225b8-b806-4f30-b946-40c24c664475,Laryssa,93,60,93,83,5,32,366,
4d13489c-c38b-462b-a4a6-fa0c937b3c65,Lasalle,77,72,32,68,33,0,282,
d4dee512-4b69-4809-964d-d39c21ac4ce0,Lasaundra,0,26,77,61,23,0,187,
27b3cb8c-5f80-4bdd-bd76-1397d2bea489,Lasha,64,40,88,23,45,40,300,
5fa798d7-21a4-46b0-a9a3-a08d19ad7f28,Lashandra,70,68,14,32,67,50,301,
73cb163c-1097-486a-a6f3-945cd898b08a,Lashannon,99,52,63,95,99,54,462,
18f2a90b-c8af-4e83-becc-8385e754322a,Lashawn,26,38,74,82,64,18,302,
96ee1f85-ce9c-4e12-b2e4-1facc8f60769,Lashawn,34,9,58,36,14,42,193,
fc0bf051-2c96-4043-a5be-1ad61c65ee00,Lasheika,13,69,53,83,21,61,300,
a7a85900-3130-4094-997b-199979019902,Lashona,54,65,26,94,76,26,341,
7116471c-88f5-429c-8747-63d865038882,Lashona,83,97,93,78,79,20,450,
7b323e71-3af9-4486-ae6c-bf2eefd9f852,Lashun,17,32,44,38,0,86,217,
51dc5dbf-a0e5-452e-ab95-79cebc13902a,Lashundra,98,42,95,4,85,38,362,
f00969ff-8bb4-4a68-8133-4ad1cf5ec5bc,Lashundra,56,55,56,33,29,57,286,
cca467e6-a99a-4eab-b73c-f65006e86127,Lassie,55,79,92,22,67,72,387,
331b5776-f248-4f90-ab2a-0f695feaedc0,Lasya,19,17,38,22,11,54,161,
49de21f2-c369-44ab-81fc-2ec21cdedf99,Laszlo,66,34,52,84,51,44,331,
19b538f4-fc0a-4814-bf3a-151c675417a3,Laszlo,78,57,87,65,31,74,392,
23298d09-8dae-44e3-8c92-675ac32cd573,Latamara,41,93,70,43,43,24,314,
2616bc25-913a-4af4-91cc-f2f17c0c174f,Latamara,48,14,6,60,44,23,195,
9ec9878e-7162-4e85-936a-0b4f419adaaf,Latangela,70,57,62,70,1,11,271,
c19ba15e-1189-4a80-b145-703d97fc77e6,Latecia,3,66,91,43,96,44,343,
4fd1cf90-8e6b-4567-b2a2-b2fdf54a2e48,Lateshia,94,64,91,64,11,13,337,
6ca2e10a-a84d-40d8-84fb-8b289e213249,Latia,2,2,58,9,57,81,209,
ce07b699-3065-492d-9345-beee602ac8b4,Latika,22,81,89,40,34,15,281,
014cb0bc-f47d-4446-a782-3132cbce2734,Latika,93,60,59,84,78,2,376,
28880cf4-18ff-4785-9d33-4b24422cb01a,Latoia,31,68,97,27,47,7,277,
d1b6412c-280c-4774-a60e-c9b9783cbb8a,Latonga,44,14,19,1,93,80,251,
64b933fc-4be7-42af-a53a-afef62b3a44f,Latonya,13,50,85,47,45,52,292,
d672b745-dde4-42b0-92d2-aa44cf484669,Latoria,41,11,2,60,19,43,176,
25e47449-bff3-4217-af0e-da1174b5d80b,Latorya,50,57,94,60,58,0,319,
a9fd8401-5e4c-43cd-bb0b-4b17a4ec9825,Latoyna,62,26,94,30,73,15,300,
d06570a7-620a-4d3d-a77e-a0124e37902b,Latrece,87,70,48,39,6,8,258,
4c054f01-170c-4874-aade-c87494ae07de,Latrell,22,50,76,28,99,49,324,
87bdeaba-797f-44be-9692-4fa2f6dda685,Latrelle,28,27,9,61,34,69,228,
39feb41f-9bce-4a12-acf9-2bc85212af82,Latressa,49,98,79,0,89,100,415,
6c787129-aa76-4c00-b149-a53d05ae5602,Latressa,58,13,25,6,13,68,183,
2f5381e4-5977-43c4-9cab-9315bae1869e,Latrica,46,70,65,24,49,63,317,
a2021f50-bf8e-45ab-973c-6a6cc1211264,Latrica,33,18,63,7,37,81,239,
f6c86571-516d-412d-af70-d6ae58ba5bdf,Latronda,11,79,82,27,49,41,289,
170489c0-5207-4ebf-9f30-faa0d44672a6,Laurance,84,45,22,87,81,78,397,
775a46f5-79b1-4861-b59e-550c2e04e753,Laurene,29,63,100,41,22,69,324,
72ed53fb-b623-4336-8fa0-4f1aafc5f573,Laurene,80,24,59,13,6,71,253,
caf3aff4-250e-4611-84a1-b53006c0ed46,Laurent,3,6,7,66,3,58,143,
6a281948-a2db-49fc-b567-5808e54b1a90,Laurent,18,20,72,43,13,79,245,
b376db91-d3c4-47fb-aa05-26b67c6e06c7,Lauri,54,72,76,39,56,31,328,
837da63f-8bf6-4280-8e04-c8b603fbba87,Laurice,36,71,73,48,25,23,276,
75475f68-b7d3-4f92-a41c-e1ddb7f73877,Laurieann,81,53,56,85,36,0,311,
aabbf17b-1a20-44b0-b767-41bc77519367,Laurien,40,85,62,7,63,2,259,
61f759f9-d784-4fda-858a-76b20b38f1b3,Laurier,52,42,76,21,77,45,313,
f9c217ea-fc59-4f09-89e3-13b72fd6ad20,Laurin,81,82,95,30,0,35,323,
c0469371-de69-4882-bfa5-3702439e9902,Laurita,71,100,44,22,73,93,403,
dd63b659-447d-4872-a836-9b3a2c5dd105,Laurita,54,60,50,82,18,7,271,
389c50ee-42ad-4754-9a3b-ccfe0b50afc4,Lavada,65,18,40,43,29,8,203,
fde33263-6e81-488b-9fdf-21a4ad144a6a,Lavance,5,9,24,33,44,12,127,
3b522689-c861-489f-b82f-3157a83bd29b,Lavance,54,97,32,8,27,89,307,
18e017ac-00fb-471c-b486-0e529033e5d7,Lavance,97,92,44,21,97,70,421,
ed2a9760-42ff-4b6a-bdf4-609086423307,Lavante,63,65,14,17,55,39,253,
81093571-2c74-4a70-b6f6-2e482644490b,Lavante,63,97,70,86,85,55,456,
ca993ffc-54c6-49fd-855e-2104c6391ccc,Lavaris,17,16,12,30,17,13,105,
1ed94487-70f5-4858-9e9d-25924b2e9ea3,Lavell,24,44,19,29,97,13,226,
ef9f6c76-16d3-44b7-9a22-5aaaf2523197,Lavelle,92,79,45,89,32,37,374,
37b1667e-0505-47e3-8131-7983e1e95098,Lavelle,97,67,37,63,54,44,362,
61d4269b-d107-44b0-8c5e-0b5a6a415bae,Lavern,26,54,85,13,31,89,298,
1fd95693-b086-47d6-814f-60edf6ffbc9b,Lavinia,65,9,99,18,62,3,256,
9075084d-f116-4d10-96df-8bb7f65747bf,Lavonne,70,27,18,75,6,38,234,
4dae3040-555b-4574-ac37-60f06692a217,Lavonta,29,63,83,34,70,24,303,
588d97a7-113b-44a9-9156-2b16008c6f8a,Lavontae,87,63,68,85,53,81,437,
78afa6a3-78c3-446a-a1e8-bd5a6a4894a6,Lavren,10,80,45,90,92,12,329,
73b2999b-dde0-43d6-a0e6-737ec0e80df5,Layah,64,82,61,81,91,22,401,
2fc6ee32-8545-4977-ae46-2461888c704b,Layah,29,60,61,12,58,60,280,
51a23fd4-50e1-47a0-a934-b917ac8f4260,Layah,86,22,93,77,69,9,356,
1fd594b6-a128-4b0c-b350-5f8e2edb3ac6,Layal,41,54,75,64,63,21,318,
56c0e34f-1f44-4093-aa5e-3c378de1b990,Layan,99,99,33,53,12,26,322,
096abdc2-f641-46bd-bc44-8ea815b64baa,Laycee,98,31,72,42,7,17,267,
6a568658-e520-4c44-898d-7e6335c345b6,Layla,24,5,13,58,93,54,247,
3321c660-606a-4203-a9f1-9081e7e074d2,Layleen,19,42,59,37,27,13,197,
faa5ea6c-bd8d-4075-a2a5-064d696036a8,Laylene,86,12,60,69,44,86,357,
99dd0de4-8da5-4a4c-8af3-5887f26baacc,Layloni,82,96,7,7,3,27,222,
59eadd4d-24be-4e44-bde7-cca16541b6dd,Laylonie,39,55,96,99,23,17,329,
65086f12-790d-49fd-aafb-c087a881a978,Layni,21,61,72,43,14,70,281,
70d4bb81-3241-4f83-8bf3-3cfb60622965,Layth,8,78,30,1,6,89,212,
e0c65b66-2147-4001-aac6-4bb341c1463b,Lazariah,65,79,44,57,29,53,327,
89e80987-01eb-4d96-8e85-5d81d238bfb2,Lazariah,89,69,48,99,84,62,451,
ccdb5211-d3c6-4c6c-8ebd-45267b1f9413,Lazerrick,31,13,90,23,7,74,238,
853937b2-3b7c-4021-8052-76bd6d773f98,Lazlo,86,63,57,91,96,48,441,
c6d03d0a-d460-4a2c-b64e-7b44f5d82972,Leala,90,42,40,55,100,50,377,
4c3b3ee0-2eb1-47ac-8d98-c116afd6a665,Lealon,7,7,78,12,19,26,149,
55235c80-7853-467e-ac04-441cd60657f7,Leandra,91,12,11,84,63,68,329,
d0beecb7-0fa7-458e-bf58-d1cdc2891f05,Leandra,17,89,23,3,86,98,316,
97158d68-2a48-4a85-9dd2-54a54492b19c,Leandra,10,70,88,22,78,60,328,
af8d245e-2970-4498-a552-36437d44b9b4,Leandrew,80,74,37,73,80,21,365,
0cc044f7-56a9-4c87-a2fc-262592cb24df,Leanore,23,37,25,84,75,43,287,
3b2ac5e3-416d-42dd-b186-b178a0b29115,Leanore,25,49,6,44,50,71,245,
71e0c6b6-13c6-4151-8727-d0ae33a7d149,Lear,51,60,63,77,18,93,362,
d998e88d-dd03-47e4-bc50-c8e7590bafd6,Leasia,23,60,49,18,14,0,164,
cf217444-65d8-4668-a5d3-d9db430d87ea,Leasia,18,12,73,52,35,41,231,
44a4f130-bba7-4da7-a63c-c90d6222b13f,Lectoria,60,100,29,76,36,65,366,
3a7698f8-c7dc-472b-ad0d-5a62c3fb47ec,Ledger,74,79,34,76,49,23,335,
830fe7d1-8826-4183-b37a-fc2a505d9ed0,Ledia,1,52,18,9,2,75,157,
cecad92b-b0e4-4f87-9c6a-670ad15d6156,Lee,10,97,60,12,64,67,310,
0b5ef304-bc87-4065-8051-2bac095ed5c8,Leeana,23,75,67,10,40,88,303,
ac6923a3-d839-412f-90d2-77e92ed28bc7,Leeandra,98,70,11,78,50,71,378,
5d224049-ffc8-471b-99fa-30bc5e796e34,Leeasia,97,41,42,45,19,78,322,
57748f8f-48b0-4a9d-93d0-6ec542c802e2,Leeasia,13,57,95,26,77,61,329,
afa32286-bd94-4d14-b99c-c0af940c2fcd,Leelah,66,19,67,37,1,17,207,
a39bd773-6f93-4d82-9417-55b0cb7a213b,Leelee,53,49,38,55,24,24,243,
13c6006d-da95-4873-b9ec-871753564cab,Leeya,55,15,21,82,30,12,215,
8cf8eef2-1cff-4663-8000-cf0f5043e453,Legend,41,61,90,53,41,20,306,
4f05e91a-5c6a-4c17-997e-016249a8c5ac,Leiah,52,94,97,55,39,28,365,
ed24f0a0-972d-499f-992b-7367a3a788f7,Leianna,0,75,36,22,61,87,281,
e6a7ac15-0d61-4bee-94de-f82945587480,Leidi,98,5,14,11,65,35,228,
ca95ac5c-4eba-46a4-99b0-b5e548fbad3a,Leigh,50,86,8,96,63,7,310,
6138295a-4ab3-4f1a-9b96-31ca93ccf91d,Leiland,71,3,30,28,3,63,198,
4848798d-3962-4a44-9d7a-9bcb32c8538b,Leiland,43,94,38,21,82,70,348,
29d824c6-fcb4-49fd-be27-2f81e9ea12ed,Leilaney,95,38,93,60,22,35,343,
bbd45028-9875-4b39-a65e-087af14a29fb,Leilaney,65,9,86,55,8,36,259,
2712f8da-ded9-4ba9-92da-1f3cd174447b,Leilanie,64,18,12,25,51,45,215,
12db827e-872d-4462-a7c1-c5147a6cdfb9,Leilany,61,1,22,18,9,40,151,
72938110-3528-47e8-9db8-eda198647476,Leileen,51,2,42,20,7,53,175,
606c1995-92f9-4d70-a155-690b5ef312d1,Leira,31,18,89,0,57,36,231,
d9dc5f1e-b643-4f53-80c8-ec46ba2377b0,Leiya,13,93,4,41,28,87,266,
9d60e82a-47ac-4481-b481-1f01c599d7b8,Lekeisha,51,80,63,22,54,72,342,
199c93ca-15e5-450f-81c3-ea9805ead501,Lekeshia,94,2,65,57,38,43,299,
9a8b5598-b8ed-48d5-bc20-351d6611f697,Lelan,0,19,31,36,12,52,150,
b511ce93-338a-4fc4-888b-4aad40de76a1,Lella,49,41,44,13,41,99,287,
3b5f1b2d-35e9-4244-8563-75050e9e919e,Lem,95,95,42,97,40,61,430,
30da0284-18ae-4b74-95f2-66b19f7d353d,Lem,6,69,0,99,0,23,197,
bda4fdf7-dc88-43f9-afc8-c37dc6932dc9,Lenell,4,7,77,70,80,69,307,
99c9542b-5ecb-4aac-b730-2e2e62471602,Lenina,16,13,52,88,53,76,298,
9fda065b-9f40-4964-a4b3-4a1f61c201f1,Lenna,58,39,50,89,78,65,379,
3703ebcc-d4b1-4f0f-b7b2-356db9adef1c,Lennox,92,99,30,4,66,56,347,
d7f6a780-ffdb-402f-9f0a-3d3a2178bba1,Lennox,0,31,20,31,36,7,125,
ccb4224c-a90f-4b20-adb6-0021e95bb761,Leno,47,27,12,80,48,72,286,
5fee0e69-8d05-4c03-a0c3-98ff292527b3,Lenora,42,58,26,35,10,29,200,
fccc9e77-a8bc-4a51-8893-98f30c5abc52,Lenore,15,28,35,100,99,2,279,
e2e0b9ad-ae04-436c-857e-f306edfc6326,Lenwood,13,6,22,20,26,6,93,
7f6dd023-38d4-47f2-83ae-09bba09432da,Leobardo,21,84,72,47,18,69,311,
a9825264-e9cd-471a-87a8-c9b8885fcd30,Leocadia,50,16,89,6,13,63,237,
98597947-5f85-4279-9516-6d133ffe4e13,Leocadio,26,8,70,44,83,71,302,
b9c44d26-584e-4f6e-af66-b226af3b792a,Leodis,2,29,45,6,21,43,146,
b6860200-3bcc-4b9f-94d9-ba45859bcb83,Leodis,11,49,88,22,84,38,292,
0a332b89-c71d-41b9-98b6-41d30a77258a,Leola,82,53,0,68,33,94,330,
b35820e6-3aa1-4a4b-bee4-9721392673e5,Leonarda,50,49,83,61,47,49,339,
9c6fd80f-8608-4dd5-9dec-45e2ae3e01f8,Leonarda,66,24,55,65,85,80,375,
17ae3255-e163-4a04-bd3c-c377f4e93ae0,Leonela,30,71,83,12,5,11,212,
a5b63d1d-30fa-4451-8295-9dee6505840c,Leonide,39,12,34,41,91,87,304,
da7fc6c7-a188-44dd-9e41-68cec53b37b6,Leonide,96,24,29,54,40,82,325,
86fba73a-5832-445c-b002-2db4233608c9,Leonora,93,75,58,69,83,27,405,
bec6d46b-1737-46c0-8d53-15e796653098,Leonora,79,76,23,5,94,24,301,
672c303b-9806-41b2-ad6c-b50f3f618c3b,Leonore,39,42,94,70,67,76,388,
815320c6-b6c5-4437-a008-09165dddec08,Leonore,70,49,82,88,83,95,467,
6c3fa541-c631-4c48-b6fb-fc491b871443,Leopoldo,55,88,43,53,40,2,281,
e79a4ba0-aba2-4de8-8c40-e6533ede1203,Leora,22,73,96,73,74,8,346,
853b5c20-fe51-4c19-96c5-0ba4a35cdac9,Lequan,83,34,65,94,0,21,297,
5f59936c-49db-4e3d-b9db-1a06a6712714,Leron,4,76,28,51,38,49,246,
ef9e999e-6226-4713-9d45-2ce21ded8776,Leronia,13,17,73,50,0,48,201,
19946016-d5d7-4159-9619-99e28ffd802f,Lesli,92,49,51,77,18,70,357,
fd00379c-eb5a-4834-a38a-e6b3e35369ef,Leslieann,85,97,89,61,82,46,460,
1def71c2-491f-4eb2-9508-1168dc067518,Leslye,55,54,85,30,65,36,325,
b6b62f0f-f465-40c0-bb33-36862a6df3fe,Lessie,22,74,89,88,8,59,340,
17f97814-edc2-4585-b3d4-585203ebab13,Lesslie,2,80,34,75,8,46,245,
1d20947c-688f-4be1-93e9-80f9d99d9276,Lesslie,80,67,65,53,62,54,381,
82645269-b47e-4a8e-a26f-2dd8e8ab31f9,Lesta,29,22,95,2,59,69,276,
f48261c5-2415-45b8-9c12-5ce294fa710a,Lester,87,88,48,91,77,5,396,
15e4d235-0167-4f9a-838f-17fe2f09a6d0,Leta,65,97,22,11,36,50,281,
ef51d496-1d8c-4593-bab0-76b9d21492ca,Letetia,71,80,33,28,72,88,372,
d06fbd82-3b47-4992-8782-e15b8e21af93,Letha,57,38,1,36,20,8,160,
633726aa-57c3-4566-aad1-e796f5c4c388,Letha,89,84,27,71,12,50,333,
63eae47f-fc40-4f40-8e57-2b5d4ab507d6,Lethia,58,13,8,93,75,24,271,
5ae86650-0837-443a-9726-cf55d77d9283,Letica,23,82,39,51,15,98,308,
e54df5b8-26af-4910-a0ab-da300d546855,Letica,31,100,12,88,52,48,331,
371d0175-4ab6-4f8b-8a0b-bff1667b9dab,Letitia,45,81,30,46,77,89,368,
78ae43ae-5d86-4de8-be0b-894caf392f0d,Letizia,97,40,90,65,81,3,376,
4c2f4394-df65-4e14-a187-aea23c9d0da6,Letta,48,90,83,5,80,59,365,
c9b16d04-9669-4697-995c-4882108a9946,Letty,95,52,17,54,76,36,330,
eecdd74f-3bb4-4dc0-8182-08af9a593645,Letty,33,90,46,70,15,30,284,
cc43872b-e605-43df-b91d-e31fb3508710,Letzy,62,50,34,75,47,44,312,
06cead29-59ed-4e5c-9473-8b58ef986d23,Levar,56,8,69,20,96,40,289,
bd03c145-9450-49e5-9196-a6fb10006153,Levert,64,8,1,10,2,62,147,
5d84b89b-a8a5-45c4-92bc-647e846bf7e6,Levester,95,0,15,51,65,93,319,
d9c829cf-8964-45fa-8ec3-5cb7c6ae413a,Levester,65,5,74,13,0,9,166,
5ca17168-ea00-4f2e-b50d-5f5c76b16033,Levon,21,22,45,30,12,45,175,
a1ac9c76-83e5-407b-9d2f-7ba92f932b6f,Levy,90,58,60,84,15,14,321,
9c3d52de-2f0c-4c39-9ec7-efac3ac4e4e5,Lew,67,11,37,81,55,69,320,
84a3c52a-33ee-4fc4-87cf-ab31a14382a0,Lewie,38,75,75,62,60,5,315,
31716fdb-71a7-451e-b4b8-85802e51f0c1,Lewis,84,47,10,58,14,11,224,
178d5fad-a819-40da-bebd-5cb160d5bb7d,Lewis,7,44,25,25,73,74,248,
f0589981-e790-44c0-b1a4-a39c23511b83,Lex,85,96,88,82,82,29,462,
cf253b60-4021-4d26-b7af-0c715b7403dc,Lexie,52,91,10,4,30,90,277,
52b55783-896b-43ed-9356-0c7ca2c84b92,Lexington,93,32,40,81,8,100,354,
f0678e4c-40ed-4b0b-98f9-6d18cd7a582f,Leya,88,13,13,78,34,15,241,
572a654c-bb83-4f3a-9466-33023c90255d,Lezli,12,30,94,79,1,21,237,
5e52f23f-4ed1-465e-982c-f398db1fafa7,Li,73,18,88,92,63,11,345,
90566d2b-7716-4aa2-b4a7-24994f78c7af,Liahna,98,45,7,18,49,10,227,
74aaa19f-589f-452a-9908-455c675241bc,Liannah,16,26,56,79,37,11,225,
be1e08cf-a7af-4582-b5e7-43a7738ec022,Liannah,90,89,30,44,56,21,330,
ce9b8ff4-dbf3-4065-9e3b-6eca69c89134,Lianne,15,32,2,85,28,76,238,
7bffcc51-fd03-4b48-a00b-d27340a09343,Lianny,47,45,71,41,13,68,285,
31af7028-89cb-4434-8c4e-ff17b13322bd,Liany,77,38,52,64,89,22,342,
80ed5a41-e4b8-4e5e-9166-e0ee6228a5d6,Liat,39,12,72,33,17,45,218,
b089eb1c-c4c6-4204-9a7f-d0cbfc7c5432,Liba,61,45,19,21,13,48,207,
7814a0fc-e300-42bb-9b63-337f88b65caf,Liberato,63,54,77,86,37,37,354,
392a0eee-b0fe-49d8-b68e-87260647de3e,Libni,85,64,22,63,92,46,372,
e8fe84cf-9636-47de-824d-99eb04e8de98,Libra,65,46,86,68,69,70,404,
4e7b5597-5d34-41e5-b2f9-9b571baeb523,Librado,17,84,45,94,46,66,352,
30183f7b-6e9b-4e4f-826a-c49040f17f7b,Licette,35,55,51,1,3,92,237,
8d0207b6-35df-4049-adfd-a491266137e8,Lida,16,62,6,72,73,50,279,
b731346f-32fb-4739-b70c-78ac597827bb,Liduvina,38,100,59,52,68,71,388,
8a5dda1c-2725-46b4-9da8-20744d453eb7,Liev,75,34,64,62,48,84,367,
f0a1536f-48da-4797-8105-3201639ad294,Ligia,76,9,60,75,8,88,316,
ed9d6d5e-ef44-4a55-920f-445d64faf416,Lilah,62,21,32,71,1,99,286,
e1ab9d2f-824c-4483-9328-bf34d11bd606,Lilas,64,29,61,87,88,92,421,
ba16a2f5-8a8e-47d5-b761-4f3d5f0fa485,Lilian,76,91,48,76,40,71,402,
86b54164-f589-439d-ac2a-7062af929cac,Lilianna,100,96,33,1,89,42,361,
e3a2a900-4c4b-4477-984f-a5168ec85812,Lilianne,67,23,39,60,75,46,310,
6e7d4b10-c236-4b77-a43f-8e68dc0b1319,Lilikoi,89,74,94,68,9,39,373,
24319507-c3e4-4e7d-b8aa-714cbb624223,Lilit,62,66,26,28,57,97,336,
665cd5e4-f31c-48da-9570-b4805513ff69,Lillee,76,87,39,28,42,23,295,
4bcbc896-b63a-402f-9184-0b40098cdee8,Lilley,81,16,98,32,1,99,327,
5ec3e3d3-fd42-46ed-967f-4e2cb4dec97b,Lillia,13,0,54,53,97,38,255,
641f4588-385e-4aa4-8261-e0a76edc64bb,Lilliam,33,12,83,42,65,62,297,
63e6d9cd-8c00-4106-8369-df8945d82dff,Lillith,15,2,96,75,81,56,325,
12dc65d4-86aa-4f3d-b1b2-81babdcf8c1c,Lillith,83,4,47,48,25,94,301,
81bbbd44-45a5-4d51-84e3-f5f71094497e,Lilly,43,23,77,8,60,3,214,
6d021ce5-8707-486b-9d7d-27e1a3e2af12,Lilyana,87,31,95,34,0,4,251,
86ce738d-7469-4fde-b730-60f3bd8e18e8,Lilyanah,27,26,24,44,4,8,133,
2d5f962f-61b7-4d0a-a060-0ede5f4d7826,Lilyona,26,78,87,70,30,36,327,
10509823-ba9a-4cf5-ac49-13f0aa770d4d,Lilyrose,23,41,12,31,70,86,263,
1e26dcee-9927-4f2c-9840-71b1cfae3ca0,Lilyrose,66,41,47,90,94,49,387,
ab6d70cf-d8bf-4747-90da-05ac6cb4db22,Limayri,100,77,22,14,36,23,272,
7e735c89-3f08-4cf7-b47d-7f5014f798f9,Linda,95,24,14,59,62,25,279,
ed40baf4-363c-498b-a691-2a27f44b1c42,Lindalee,26,39,77,27,57,19,245,
17f6cf6c-946e-46e6-bf48-1c2f3579e225,Lindberg,35,47,88,18,22,47,257,
4b83deb9-f504-4c33-9665-d7b9cd7106c1,Linette,98,74,20,18,40,75,325,
94ac6e01-2485-40e3-ac9c-3050bf0d299e,Linford,1,71,20,8,37,64,201,
47d02510-3323-4ba7-a09b-6789b85871ca,Linh,74,53,4,67,95,76,369,
1a02321b-a400-45ac-ae83-10c221eafafe,Linh,93,72,49,25,50,11,300,
c14e29f2-261a-4a48-b8e8-f719af1f86f2,Link,85,12,83,67,11,24,282,
a8c9d126-2511-440e-a6bc-f61a9a1429ff,Linna,14,71,1,21,87,21,215,
7fede183-14f8-4698-af7a-e2577b8ceaff,Lion,77,46,92,17,55,20,307,
31d52d56-5e7b-4e3d-abe4-b397aedda82b,Liora,97,26,16,1,41,46,227,
852a0f9d-03aa-4828-8d6c-f8eeb518d26d,Lipa,18,67,64,4,87,29,269,
65dfb414-e844-4495-991f-2640d8b98afe,Lirio,30,57,57,85,87,8,324,
80095c10-dbaa-49d1-aebe-9aef4beda18e,Liron,47,5,74,1,19,72,218,
10e75c7b-4c27-4382-8ced-b806532e5bcd,Lisa,6,30,65,43,94,71,309,
4cdd7420-7774-4a5f-bf31-ae837772e333,Lisania,40,74,32,1,3,0,150,
c7592bb4-d0d7-412d-8c7c-26cd00f34369,Lisanne,5,60,11,27,3,52,158,
1d45728a-f3a9-49fb-9377-d689231790d2,Lismary,57,66,27,64,11,27,252,
f1b0a059-c8dc-445f-8518-49e00a491f3e,Lisvet,58,33,9,72,27,1,200,
17b60290-b4a8-48d9-87cc-fac0fa1802f4,Lisvet,78,91,33,78,66,30,376,
43289c05-9750-40be-bd91-883a16b954a5,Lithzy,18,27,87,54,74,25,285,
4f2aed43-1b06-4281-99a8-878fc2d40730,Litzy,30,33,57,7,61,5,193,
cc5b8999-b932-4824-a9c9-f2578c602207,Livier,39,52,6,57,52,9,215,
7528dbcf-0e87-4d96-bdfb-3ea0c845d61d,Livio,59,67,53,80,45,42,346,
cfb2a1f6-6c78-4dc5-a037-70a9f6d89b7c,Liyah,72,49,49,85,51,75,381,
8557ddd1-79bf-434d-928e-a1e0a8014157,Liyah,18,58,16,0,35,30,157,
2600a789-3a77-46b0-b96e-fbfc63c61fe3,Liz,12,15,13,72,74,73,259,
2b2048a8-5886-4751-8563-2329836539c0,Lizandra,71,93,43,26,67,9,309,
5eb5272a-6fd2-43ff-ab2a-5fefe984303e,Lizania,23,89,7,38,3,32,192,
a2e3caa4-1b43-4603-a6fc-12041213e303,Lizanne,5,72,100,53,90,99,419,
f3a9f702-ffb8-4534-bad1-3185ce6f549d,Lizbeth,17,24,50,62,36,21,210,
b49fb172-e685-4bd7-b226-7aa8f6bb5966,Lizel,82,71,16,25,82,6,282,
76285ffe-e881-478a-9c4f-de7870d2f8d8,Lizette,23,99,61,32,98,81,394,
759627ae-729d-4f16-9778-26451c51143f,Lizveth,95,87,57,31,52,31,353,
cb81c0fa-9e78-4c9c-b92a-c0d42e40d2dc,Lizza,3,100,55,47,48,12,265,
81f499e3-2e37-4242-8eb3-8e265209b956,Lizzet,40,7,34,46,1,6,134,
07b6a401-7f85-4318-b871-8724fff5bacb,Lizzete,34,42,94,45,33,62,310,
843faee5-b16a-4d2e-b8df-70d10b2a8680,Lladira,13,61,67,34,56,13,244,
7af8eca3-4ed7-4103-8474-39b84acdc478,Lluliana,58,48,95,91,98,5,395,
742609fd-ee66-4566-9395-60f9b896cf26,Loc,93,84,54,42,24,11,308,
d3ae6d54-781f-4010-a59f-9d3cbcdcc6ca,Lochlan,98,75,43,43,73,45,377,
97239f3f-af42-4b8c-9204-ee096b7b6117,Lochlann,54,83,84,82,97,55,455,
f68e8568-f153-4dc4-8fcc-d0fddeb000e5,Loeta,80,24,31,88,39,84,346,
a9ccf855-28c6-43ab-ad35-9c5d1bff787d,Loette,89,8,83,83,80,83,426,
0e62357e-96d0-4b19-b47b-d36c55b4f786,Loghan,39,2,92,75,89,62,359,
ceee4edb-413b-4eb8-8504-038adc51d850,Loghan,41,3,66,9,100,49,268,
0505abe3-bd2c-4a8e-96fc-f69f6f092dfd,Loghan,66,22,86,75,50,85,384,
3b170386-2b16-4985-8fae-342b2c4bd92a,Loic,69,33,29,26,83,97,337,
ec4e76a9-bbd9-47a9-9443-6a0f5db98f96,Loise,90,49,94,97,98,21,449,
4b243db9-6e90-4864-97c4-8f612b965445,Lolah,25,70,26,70,100,42,333,
7b3089ff-40e8-4b2e-bcfa-e9f9dfeaa217,Loleta,36,84,29,21,29,64,263,
bb323853-bcd9-4928-b9b6-fb529dbff6fd,Loleta,77,92,97,29,79,55,429,
2eefd714-e0ad-4649-bbbb-71185983c397,Lollie,90,34,20,73,57,98,372,
e0fd82f3-879b-4ca9-b47e-16a4d1a75e5a,Lomax,13,97,23,60,38,15,246,
9d715e09-2684-4c67-b91d-c1fdc786ea33,Lometa,39,84,85,11,14,68,301,
18bbaefd-46a3-4182-968c-9d72c4ebef9b,Lona,32,79,93,83,20,26,333,
06ceb1a4-9ca7-4539-bf39-d60d2a3f6c1d,Londa,23,9,48,17,95,72,264,
902976f7-0921-4faf-8799-64cd7854d85b,Londynn,16,98,99,42,65,53,373,
99ee0b70-1f78-433a-aeb4-b3f297e11529,Lonell,42,83,5,86,38,12,266,
c2dfc884-be28-462a-81f4-bdbec67c6307,Lonn,22,31,96,89,90,16,344,
977bb57b-3a03-4a99-a373-873cc57bd35a,Lonna,88,27,28,69,25,81,318,
b0af11dd-99ba-4ed0-b8dd-23722faa34fa,Lorain,70,93,59,51,39,96,408,
a9f25f38-4340-4903-b898-a0088b08fd83,Loralei,48,25,41,9,39,5,167,
541c6d24-3ce9-4284-b2f3-0072136a6d98,Loralei,82,9,97,25,23,25,261,
81fb67e3-3853-4539-8fa6-bdc06138f44c,Loras,72,42,10,67,29,24,244,
88c4ee35-11df-4613-a87c-d58b939ef797,Lorean,68,94,35,20,89,19,325,
31d18179-02e7-4841-b442-63501b7b154e,Loreen,12,66,65,10,55,32,240,
daac9848-e7f0-48fa-a170-c83eebba61e3,Lorelai,15,84,73,22,40,71,305,
7f9a94a8-b20b-442e-85e8-45f687d57467,Lorelei,15,93,66,68,95,5,342,
b419c83e-3afe-4824-aa64-4180e18e215c,Lorella,30,36,47,65,16,81,275,
7854d1fd-3989-4dff-a7f9-fb73ecfdd89c,Loren,26,66,51,33,100,63,339,
8d32f90d-b838-4571-baf7-e66e9808bc67,Loren,8,63,7,25,90,75,268,
e532a2c0-1daa-47cd-a8e5-31e24a6176cc,Lorenso,96,74,94,67,91,17,439,
25ebeec9-ebe4-4345-84af-7c7d6a72a3ca,Lorenzo,77,9,48,60,88,78,360,
4d118192-49b5-42e8-91f7-790b9c29f743,Loria,37,38,79,8,89,55,306,
a2968003-cd47-41d2-9e0b-7fb9662c4b6c,Loriana,46,94,7,68,90,64,369,
5b223df3-89c7-469e-af46-4c3ce0aa0448,Lorianna,45,99,42,82,49,66,383,
2965cb30-defd-473a-ab8e-280fe21b417a,Lorianne,3,23,23,29,0,96,174,
fdc38d55-f475-4e4c-9120-2eee7d3cff9d,Lorie,48,85,43,41,41,46,304,
95c67697-84c7-47d3-adcd-097f1707d735,Lorie,79,71,91,74,15,58,388,
df1016be-400b-418d-91ac-22de17a7c056,Lorik,29,24,35,58,47,8,201,
1d012ec5-dbb5-416f-af1e-68a3bf2eaf3c,Lorilee,85,76,39,34,85,33,352,
6272fd3e-7408-4ba3-94ed-c63232f45ab0,Lorina,22,51,47,79,59,83,341,
a1e2e9de-0fd1-4a62-bbd8-969550038b25,Lorinda,16,14,31,40,31,6,138,
41af0e25-cca0-4b5e-88b8-42470027e605,Lorine,20,1,70,6,40,91,228,
43b07b82-8598-4e0d-8a49-517b8a1e89b0,Loring,47,77,68,43,62,21,318,
3a216ce2-2bb8-45a1-853e-3743da4cfd84,Loring,20,17,87,68,9,25,226,
2464fc32-1fa2-41e5-8503-39c926f309ac,Loris,29,30,31,39,6,2,137,
5f59c327-dea0-4467-8efb-756679b57b2c,Lorita,16,10,18,29,19,86,178,
39a4f095-e655-46fe-8bf9-c4b2a319d33e,Lorna,86,19,26,9,49,47,236,
2abbf419-37ea-4ede-b3b8-4204882a1433,Lorra,13,87,36,59,76,78,349,
e8ac5d0d-0a93-4cfe-8fab-346354acc77b,Lorrain,30,99,5,68,66,73,341,
2f0f7bad-5a5a-47b4-83ab-aaaec9f1c70a,Lorretta,51,31,57,92,49,4,284,
3793349b-3754-4666-a528-fa922d373061,Lorrin,70,41,6,92,23,30,262,
96242271-4984-4b7c-a684-ba75308a3280,Lorrine,75,12,100,95,50,86,418,
9ead8fde-09bf-44d5-bd90-041303d6ddf5,Lory,77,99,15,40,2,84,317,
1bb4e827-0c2e-446f-9790-848b423c399b,Loryn,74,16,39,56,53,23,261,
f3fe8fbe-9be6-489d-a508-8e474bf1471f,Lossie,91,60,58,97,61,74,441,
09b7ab40-e99f-4f79-8a74-6ecfda57d080,Lothrop,21,82,73,64,33,13,286,
a46400a2-7578-4ebf-a906-78ef12f8c60d,Lotta,81,56,58,19,7,0,221,
2529f9cc-ea79-4812-84e7-0fefa9d01db0,Lottie,100,24,34,8,84,10,260,
84ac102e-3186-4f0d-8edf-1c8a869ce052,Lottie,57,59,21,85,82,100,404,
3763bc5b-589a-4817-adad-d494992c0948,Lotus,39,4,33,59,91,38,264,
7b5f00c2-1ab8-4ba5-a190-472628964af6,Lotus,93,40,45,29,82,24,313,
f4f7ae70-0d90-4e97-bea0-f3af52cf1f87,Louanna,4,48,6,89,13,67,227,
568a9373-c64d-4978-9b75-7fa424e16b5d,Louanne,51,22,26,29,31,21,180,
4a6a5af4-8a04-4a02-863a-342848ecc0a8,Louella,94,86,8,13,18,5,224,
92db4abe-8826-458f-a842-e05474b9c46f,Louelle,39,65,17,91,38,6,256,
c78fb7e5-cda3-4d65-8251-12f12c30213c,Louetta,54,52,60,79,36,91,372,
dba6147a-098d-43a2-a7ec-a9d6c343a152,Louis,21,25,78,96,85,92,397,
8491a0f1-c718-48fa-9f7b-c6ed137c5647,Louisiana,10,98,0,72,81,4,265,
c901089a-12f9-4276-841f-af28b30ee506,Loula,22,18,19,5,7,5,76,
8c7ba45b-771c-4838-af8a-43e33ff83fde,Lourdes,22,12,78,23,89,23,247,
99dbb042-9efd-4576-9ed3-abaf36d6c39f,Lourdes,55,87,40,99,92,92,465,
ca900b46-8799-4a71-9aaf-ca134ae83c86,Lourie,79,85,69,64,40,11,348,
ef55ca22-5b53-41c6-ae4f-11e1633ceabc,Lousie,69,39,94,47,54,74,377,
4a755740-b0c4-493a-95dc-cfedebba2bcd,Louvenia,70,50,69,0,90,24,303,
062ee1c9-6353-4eb6-9d39-0534de5d6e06,Lovelace,58,86,28,51,35,36,294,
df19d1ed-c038-4ae8-a13d-04fd55ee783e,Lovenia,52,69,94,11,99,42,367,
c1873f9a-bfa7-4ed7-bddf-91602d320950,Lovett,8,24,1,89,78,55,255,
bc266301-2a4c-4148-a5a9-02caf2ba3233,Lovey,99,62,43,10,36,41,291,
48e0ccb2-bb23-4b03-a7f9-92e235e78e80,Lovie,18,19,11,62,44,56,210,
3a1ae99b-b6ca-42ad-a7b6-644a2860e3a4,Lowery,8,61,24,22,21,30,166,
8736eec4-5ec0-4f87-89a3-31a87a2219cd,Loyce,45,0,12,47,26,29,159,
c62162cd-a9a4-41d2-bada-d1a6a232b9d8,Ltanya,82,56,60,14,79,21,312,
c5e30d92-8f4c-4163-a21a-98409406ee6b,Lu,31,80,97,93,20,2,323,
ddc0ba2e-3953-4e66-bee2-01d5e195a1f8,Luan,39,8,57,30,69,52,255,
c930589d-42d4-4e27-aa35-8132217192b3,Luana,7,96,66,69,10,0,248,
cf8fe12f-e754-4c20-b982-e03726e0d41a,Luann,90,46,73,17,90,62,378,
ad9b0e47-33b9-458d-abd4-fe3a7dc9ae08,Luanne,97,20,41,36,44,31,269,
a4f667ba-bdea-42c8-a8fb-8f9b545d6c18,Luberdie,67,86,73,33,54,59,372,
29f35e7f-7dfc-4ba5-bdd3-fde69db2efed,Lucecita,40,37,27,89,63,17,273,
d93a9554-fe7d-4431-a6c7-65c9b5dbbbee,Lucero,86,63,79,24,52,17,321,
8ced627f-1927-4fdd-9a52-9c2a80b3d4d5,Lucia,93,49,16,72,7,24,261,
fcccaf14-e2da-4e1e-8df9-365c196c3b0d,Lucia,1,98,42,40,26,55,262,
45930798-c636-489e-8d99-f32daa5371cb,Lucian,85,43,50,16,10,25,229,
4ee26030-cc0e-4b8a-a439-c6ab846a8bd6,Lucian,96,66,64,38,41,68,373,
c93758b1-964d-4bba-84c9-5b501658723c,Luciana,32,2,80,39,37,36,226,
03a97cb8-3768-44a0-a051-0ed17302c6fb,Lucianna,80,72,11,17,10,71,261,
c9eaa696-c537-4a79-b158-d825a5f4cda4,Luciano,12,51,60,70,43,3,239,
a5f3c02f-43bc-4bc4-b5d9-79bae0cfc955,Lucienne,17,62,46,29,48,98,300,
a30fa05a-344a-40d4-bb4b-fc79de70e5e4,Lucila,55,63,98,35,55,37,343,
db5d14c6-9078-4dea-b1d6-224437c4c47a,Lucille,94,38,56,61,70,2,321,
9b89da8e-ef07-4adb-b327-737a3a337e1d,Lucina,96,31,77,18,78,1,301,
7db6123b-adcc-4b24-8014-046977bd5e5b,Lucious,54,7,94,3,62,82,302,
850df6f5-a0ac-46a6-9303-ccd9bf4813df,Lucretia,83,94,1,30,72,75,355,
c87c2b22-979e-47b8-81c7-21de04c38cb2,Lucrezia,96,80,6,3,78,66,329,
2ff3584e-2990-433b-97cf-50285034b62f,Lucyann,58,45,0,42,46,28,219,
192a1a9f-281a-4a68-bc07-8407281d29ab,Ludmilla,94,30,84,21,54,15,298,
75f6ee69-b8e4-4062-9fc9-02bd65bf1a12,Ludwika,89,84,68,40,54,73,408,
04a1f96a-7152-43a6-8528-dfe7014c53ae,Lugardita,50,57,97,22,82,1,309,
4bfa2d45-11fe-4f75-ac29-c6bb7e3d169f,Lugenia,44,61,84,48,45,59,341,
cb2d1c3a-1d7f-4081-a802-b1e0895f5e82,Luigi,78,51,66,30,10,74,309,
0e4fc4a4-f563-4664-b49b-e92e29456338,Luisana,80,16,67,1,86,64,314,
26f84af8-5405-41ef-ac89-469bff294e3d,Luisantonio,89,32,58,100,49,39,367,
701ae1df-0739-4aef-bbc7-6017e0509e4e,Luiseduardo,10,45,58,21,78,98,310,
5fce70bd-e9c2-4c84-a5fd-06ab1ff3f4d6,Luisenrique,11,29,23,30,81,82,256,
e197df32-4d47-4416-a903-2f55994004b3,Lukasz,5,3,9,91,77,49,234,
b319701e-7141-4399-b498-b6dddd401b86,Lukasz,100,49,44,60,4,14,271,
ecf9e6c7-0a20-45f2-9cf2-a70a1383949d,Luke,45,43,63,1,86,5,243,
3961fd71-bc2b-4860-9853-cc24f8db9ebc,Lukus,75,59,37,75,49,38,333,
7a022343-d64e-447c-98f4-01ed9b4fe98d,Lular,57,81,50,63,91,56,398,
8790a91f-b782-4a47-9caf-1f6bfef0d52a,Lumir,50,88,69,85,49,2,343,
742130ed-0c1d-4f9b-8436-cfd0e0dd24a8,Lundon,24,76,57,81,99,90,427,
db8374f4-44b2-408b-a145-2571530dad99,Luqman,69,21,87,75,52,33,337,
114b6a75-592d-410b-83d8-9914c9b690da,Luretha,14,48,32,10,16,57,177,
2e36b5ff-87bf-4bc5-8634-3a4abcf9c234,Lurleen,16,76,60,52,84,67,355,
e2e870d6-a8b6-48d2-bbcb-014e7c8fa84c,Luvender,20,86,96,20,42,31,295,
6d529101-c5ee-4581-a84c-4d8e6cdea9af,Luverne,96,1,48,47,29,46,267,
2211559a-6eea-4754-be64-59789d563bc3,Lux,37,35,78,22,7,13,192,
999d49b5-3b1c-439e-ab74-11d41bd4c3de,Lux,60,3,98,31,81,55,328,
bcb119da-e04a-4a6f-b41a-2951c4fa9743,Luxe,75,22,32,74,54,42,299,
e9c54d18-39be-4463-b9af-25a44fae74ef,Luzer,79,25,96,7,38,85,330,
e3f740ce-7e31-44e4-9e1a-da09b5f0ad39,Lyam,80,65,30,71,60,75,381,
19016443-1527-4204-a269-bb45aa4df881,Lyana,26,78,75,33,24,10,246,
97f36f54-8abb-4ba3-a06a-29495dc6fbd3,Lydell,18,48,70,14,44,60,254,
9e95c2fb-1c51-4e58-bd37-63b511497c38,Lylah,63,91,70,30,63,3,320,
8acad2e1-70b3-433e-b77a-e24c3ab8ac2a,Lyle,18,3,3,23,59,43,149,
ba678255-f1ac-4371-809c-3d1f62e49478,Lylia,21,55,56,91,27,50,300,
d2bd9673-b4d8-4af6-b806-08626c6227b1,Lyllian,69,84,41,68,83,38,383,
86bcfb4f-51cd-4af7-8e76-7dba97d7cc6f,Lyllian,54,26,97,45,18,65,305,
6f1f2009-7a29-4705-a28b-7b8042c03d35,Lyna,42,88,18,52,45,51,296,
8c8795ef-cea6-4bd7-a81b-9e92c77fa96c,Lynae,38,43,66,28,34,9,218,
b4bcef38-5124-4e45-b45a-4a3fb445bf22,Lynda,23,41,64,6,69,98,301,
be8b1d3b-4332-4330-bb28-ca484e53f97c,Lyndal,14,14,69,8,28,86,219,
0d956d32-f6db-467f-a51f-3c971fb06355,Lyndal,45,37,91,33,57,38,301,
0b78ec32-3c78-488f-9835-3eb452c90dbb,Lyndie,74,37,31,95,11,51,299,
0b443646-7aa8-4b60-a9b9-d95fff3a59b2,Lyndle,9,75,52,17,90,10,253,
026dc682-69ec-472b-a652-52aa66b96879,Lynelle,81,19,48,53,81,64,346,
9f215c0f-f31f-41f0-b8fd-a0faa95b352e,Lynetta,38,97,60,14,71,8,288,
c3a17edd-d84c-4a33-b965-d0fd1e09523e,Lynford,82,7,41,29,78,57,294,
f62cc0e6-a7ba-4ada-945d-ab85586a6331,Lyniah,3,47,95,32,49,41,267,
ecd54dfb-598d-412b-85c9-c43227fed5fc,Lynlee,81,76,91,69,19,1,337,
26a214eb-3129-44ae-9682-cb40f580d941,Lynley,3,9,48,1,41,72,174,
0db41623-1a23-4d06-8900-cef9dd42b9dc,Lynn,9,83,10,80,14,15,211,
f4c4662a-2d05-48aa-9071-3f01d9a4ce7d,Lynne,37,79,27,48,10,42,243,
b30b3b24-3e13-46e0-ae81-754ac1988af1,Lynnel,17,64,10,5,39,6,141,
5753a3fb-bdd7-477e-bcf4-8fb1b23da59b,Lynnel,83,66,22,12,81,78,342,
ab01ed70-3cf2-4f2f-ad9d-eae0b5c846f6,Lynnette,81,70,55,91,32,36,365,
48591dc5-1d7f-4c3b-9339-4d81b52b79b0,Lynnlee,22,57,97,38,62,55,331,
9edbe2f3-8481-4810-bad9-df95340d0666,Lynnmarie,60,79,91,88,41,69,428,
25275868-445c-4695-9c95-35bdfe1c9632,Lynsey,20,80,20,53,28,65,266,
6022d007-454c-4c30-b0e3-f924e19952e1,Lynzi,87,69,30,86,77,34,383,
9ef6f1b1-46c8-4ca3-9cac-19a7acebcde7,Lyrica,35,5,80,37,34,91,282,
dad2caae-e8b5-4cc8-8eba-a4f70b613538,Lysa,20,78,26,5,45,31,205,
25c1d45c-ed61-4183-b926-e431898feed8,Lysle,78,12,63,53,29,49,284,
83574ed4-3499-44b7-8fae-b1b7e7154ec0,Lyza,86,66,28,100,57,50,387,
a58149d4-ad65-49e7-8a1e-eadb778ed434,Ma,27,68,53,42,0,70,260,
1ef9ddae-6b86-4f3b-b739-b83c2d607955,Maahi,81,31,45,32,29,43,261,
1c2de6af-329d-42e5-bb3b-36e3762ab18d,Maalik,92,61,97,13,89,47,399,
a028b99a-3a70-475b-9490-e84345c6e0da,Mabell,74,69,6,12,42,95,298,
24032661-6b59-4063-a09b-77a886a8e0f7,Mabelle,10,27,61,17,68,51,234,
d1fd79e2-f5f4-43fe-8ea6-7915f4510aec,Macaela,8,58,77,80,49,65,337,
65a7c37e-7eee-4bd3-ab7f-caf41aedb622,Macala,100,87,31,0,63,55,336,
104b3bf8-501d-4840-9bd5-33976bd3d11b,Macario,77,38,89,87,18,59,368,
57b4a018-0e37-405b-a5c1-6c3df48bb2f7,Macario,14,72,29,9,5,97,226,
c879c51f-372b-4384-ba3c-07d49185c5a4,Macarthur,35,5,100,86,64,2,292,
192609a3-16fd-4ff9-9b04-f03a362a7f83,Macarthur,3,83,51,62,36,74,309,
e4c57f65-07af-4896-a9e4-dbb6da1ccfaf,Macenzie,73,91,71,8,75,73,391,
19b826e5-d8d5-4b96-aa03-00714038139e,Macenzie,65,2,85,43,8,66,269,
73667688-6639-483d-96cc-7af29739a4cc,Macey,14,24,79,45,9,73,244,
26a8054b-0e7f-4c6e-82da-9e00782e930e,Macey,67,9,76,20,63,84,319,
79b92cee-d40a-4928-8985-8b08e627f2a4,Machell,48,89,64,86,18,81,386,
48883346-4821-4579-8cf9-924680d91597,Machell,17,95,12,66,41,25,256,
2c36a24a-6da7-4dec-b5ae-40eb68b6489a,Maciel,17,18,36,12,11,84,178,
b554c2fb-ca12-44aa-90ba-56eced8a6aee,Mack,60,78,55,10,12,82,297,
a66e6e7f-a97a-4c88-b613-14786277175e,Mackay,50,35,45,63,38,85,316,
3174755f-0104-4bac-9abd-cdccbd87d5bf,Mackenson,98,58,61,13,35,37,302,
a9a8a493-c74e-490a-938f-7d21db339374,Mackey,92,26,33,44,51,21,267,
c251a2b4-ad72-4bd0-8671-55fcee7aff34,Mackey,32,7,47,38,87,12,223,
daad51c0-7f2b-4f88-b307-936a98b2f43c,Macklin,42,36,36,78,11,36,239,
3c0b7a21-6310-4bd6-ba43-254a1274d150,Maclovio,94,67,57,83,17,25,343,
6a0172e1-f7a7-4754-b6e0-119da2f4c9f6,Macon,66,51,41,60,85,31,334,
04a7d19f-b07e-4683-bbde-dda15af2706b,Macrina,11,69,60,6,62,44,252,
30e22b6b-4473-4679-b27a-ec34ecf192b8,Madailein,17,31,14,65,79,46,252,
e03b68a0-73d2-4803-a180-b791b6ff5a15,Maddax,98,91,66,8,47,28,338,
07759c71-ad19-4841-b108-4e54581ed2d3,Maddelyn,99,52,83,78,73,82,467,
df227ea6-ee24-42df-9e1b-cbf85cbf06ed,Maddisen,67,44,51,5,72,15,254,
9c25c7e9-dcab-4f13-a73c-5778280154a2,Maddyson,60,5,76,92,98,86,417,
4929a22c-d2f3-491a-a3fa-b5d1f82378df,Madeleine,87,29,58,48,44,82,348,
ca6bc85b-5901-447f-a3a9-00a4f3f4df19,Madell,18,83,44,76,30,90,341,
bb78a15b-d76b-4ef5-9a5e-2352ff954f0b,Madhav,6,53,64,1,0,87,211,
27359317-9e29-4c50-a716-e8f90e1de6b2,Madigan,45,37,96,95,82,54,409,
2ed62640-b011-4eb8-9152-516c5e4f6761,Madilynn,46,34,25,11,72,56,244,
0517d010-27ac-43cf-a77a-edea5c0bbb2e,Madisynn,18,98,88,91,29,25,349,
3a372665-32b4-4b93-8781-443c173f2de5,Madlyn,54,7,38,90,10,13,212,
116bd278-b8cc-44a6-bc37-e20488fa69e7,Mae,86,36,95,85,15,63,380,
1d70bb90-8bc7-468a-8406-6eb44b6372d1,Maebelle,72,91,96,98,96,76,529,
5aea9e73-b27a-4697-af90-625d45a32fba,Maedell,51,1,19,87,12,85,255,
37d4e21c-d424-4e2a-b51b-9096626860cf,Maegen,46,71,43,88,61,41,350,
11b8592d-72ae-45eb-801a-a847068ed3f6,Maelee,57,63,40,55,78,72,365,
3ea0db83-19cc-43ba-8043-b5b09b2a4e13,Maeleigh,77,18,75,64,35,44,313,
add3b600-f9b4-4b20-9619-840185d2e524,Maelie,52,20,63,7,1,86,229,
feb159e3-19e3-406b-9ec4-3d4c7421408d,Maelynn,46,62,98,91,64,69,430,
14304568-35f2-429e-9f81-b3e206fb3f47,Mafalda,21,90,87,33,53,91,375,
b6651b21-3db0-4638-b9f7-f5012fbd8cdd,Magaby,95,77,51,46,13,4,286,
0d393aae-c721-43c3-ab80-10c0d9cdb0b0,Magalene,26,31,15,72,73,72,289,
7fe816e2-f9e7-4830-809f-1a4660a3412d,Magali,28,28,14,76,100,72,318,
73b16145-0b54-4b0b-a379-c1ad232f2f75,Magaline,57,41,28,19,18,4,167,
0921b1b4-57bc-4f1c-87fa-8ec452335a9a,Magaly,78,9,91,82,76,100,436,
06634857-f5cf-4093-8c5e-49464fbce87a,Magan,86,5,56,64,12,44,267,
b91f4e83-7b79-4b17-9351-bdff7d1f3574,Magan,42,77,56,58,84,32,349,
04180bb9-6ffd-4ef4-9a05-f56f7f8ef3d1,Magan,24,73,97,44,49,80,367,
560e0f8b-c3aa-4125-9732-9e419c9bda86,Magdalen,82,47,85,97,49,71,431,
497383d0-c200-4b18-9089-1a94168227ca,Magdalena,90,83,80,73,26,94,446,
8b15d51c-4255-46a0-832a-cc81ad8d950a,Magdaline,21,13,27,9,28,95,193,
1b3d0632-4260-49c1-b500-40147a83e208,Magdalyn,11,87,55,75,98,95,421,
e37e06c5-1231-480d-abaa-89da0d44e28a,Magdelene,30,20,33,15,3,57,158,
2389fbd2-859e-49e9-8157-0d6e82895c76,Magen,12,40,56,21,84,21,234,
d7218b60-b10c-47ea-88ed-41cc1a0983e3,Magen,88,92,26,57,89,10,362,
eb9a7e3e-0e7a-446d-b886-b2995e1a95af,Maguire,96,89,30,15,86,63,379,
d120bac3-2721-4bea-b1d0-f6666649a50e,Maha,46,3,93,10,4,95,251,
1b0e3247-6e25-4743-a96e-f5614190d4f9,Mahala,46,60,1,37,7,92,243,
ec20dc60-4e8f-45d6-b0dc-63e6ad8d8e86,Mahari,83,4,48,5,30,34,204,
056d036d-3620-483f-8ff4-1cf32b6edd20,Maheen,3,68,16,35,95,54,271,
ded1a26c-2ffd-454b-970b-1d65f3b3b36a,Mahesh,85,35,49,73,17,23,282,
d0fbd104-7d66-491e-97a8-5a442f62a627,Mahima,87,24,87,86,97,11,392,
e6df1ee6-7708-4b28-b693-dffd15150f65,Mahin,33,60,4,47,44,98,286,
007995d3-2f79-4e44-a838-075cf2a9219e,Mahiyah,70,27,61,66,6,46,276,
23206015-4d7c-4a6e-8df2-2b1044e8d595,Mahki,57,12,53,35,46,4,207,
0fab2c31-75e6-4469-8aac-b637d77a3472,Mahki,88,79,62,25,44,4,302,
826de56a-675d-49b6-8004-71ba17b17c35,Mahlik,64,26,35,40,89,68,322,
e29c2ca9-3ed7-4953-b4dc-0932ecd64306,Mahlik,35,60,53,46,29,27,250,
6b358866-d1b5-4ef7-b187-6bc096e15c79,Mahsa,46,5,85,74,86,29,325,
3c8118ec-e224-497f-98ab-673db9cf66af,Mai,39,34,23,36,13,47,192,
f7228c87-376a-4f41-aeb4-b36154814c36,Maiah,26,65,99,95,4,17,306,
d73584bb-3cf1-48ba-a9c4-e74a0883616e,Maie,81,73,32,47,42,33,308,
e1a4f692-447f-4d4c-9135-2eca49a4b415,Maija,37,73,85,22,10,12,239,
54a547e0-a779-4003-8d8a-f72a6bf02957,Maika,38,53,30,69,22,59,271,
a3991d52-1200-4628-bdc7-c5322f69886c,Mailey,7,64,13,33,44,27,188,
0c857149-777b-4511-b8e5-98ee58478da2,Maili,96,57,24,9,42,94,322,
d6650aaa-453b-42ec-9df6-79cb60cd9b37,Mailin,86,88,32,75,30,6,317,
94a9a458-2707-4590-a618-e6cbc1694f13,Mainor,91,74,53,12,45,72,347,
965646e5-8586-4db6-9433-4cd5ce00aa42,Mairani,60,45,67,5,48,16,241,
391d0582-5d66-4652-8b7a-4dd2a738ab5a,Mairin,42,60,99,16,61,95,373,
ad72158a-0a50-408a-ac19-43cbe703b2c8,Mairin,5,28,9,78,37,100,257,
1774de2e-2c73-4234-9e98-27198eb60186,Maite,92,45,50,32,37,2,258,
04947dcb-01e1-4082-a7d2-0faef67a58f2,Maite,15,36,18,79,33,74,255,
066596db-f2fd-408b-8031-95823baabad3,Maizie,100,77,35,77,62,60,411,
862bc1e3-c2ed-4113-b9af-98dad607f8b0,Maja,39,78,32,56,79,51,335,
4d8ce60a-323c-4785-b39e-571a32c6df6d,Makaila,17,23,45,54,22,31,192,
348c4e7f-7fd5-43d6-9060-f3154d74eaa0,Makailyn,53,23,80,25,50,69,300,
67842718-db7b-4fce-b868-7f578e4d1631,Makailyn,93,32,73,68,73,17,356,
4ee565d5-42a2-4d97-9660-d141f46914bd,Makailyn,60,75,15,52,64,46,312,
91e81c30-815a-4212-b2b9-f281d5c7f0db,Makalah,90,76,30,16,16,58,286,
8f80c56d-198c-4764-9350-4eb96db79f11,Makalia,65,98,49,9,17,66,304,
a4235883-16b9-4364-a301-7c0d1caec31a,Makalyn,46,30,5,98,11,26,216,
8e287e1f-eaa4-40fa-bdb1-3280c607fdfe,Makalyn,27,52,17,82,65,82,325,
79d5641c-37f3-4bc8-942b-4057489124c4,Makalynn,5,93,38,21,74,16,247,
1a4856b0-b766-4587-9813-fd2a033dd418,Makaya,16,56,15,69,25,3,184,
75b6bb89-8a0e-4923-a82d-6f1c4a828dd2,Makaya,65,35,62,34,15,88,299,
5840d4ef-5a94-48dc-b75d-b9ee2ee350b4,Makaylah,25,13,19,30,92,9,188,
d626537a-d70e-4637-8c34-afb598a1d81f,Makelle,71,21,31,9,27,68,227,
7ce31fa5-b6fe-4d8b-99a6-7a2dd1b02a01,Makenzee,25,91,57,70,16,49,308,
0c930f14-9e7b-4c92-8da2-e79fbc7d0d5c,Makesha,47,5,26,0,29,94,201,
46de02fe-30b0-4d2e-bea6-16c4686a5917,Maki,59,53,71,23,94,52,352,
e91d50e1-fcc1-46f4-8c83-f5e72b337fe1,Makia,51,48,82,33,2,84,300,
c9622228-ad03-48ad-a37e-0fb925a824fe,Makisha,20,6,75,0,0,38,139,
ff587a5b-c451-4140-909b-621df5bfaa23,Makiyah,26,86,68,95,31,24,330,
2ca530b6-052f-49dc-9511-0f883e47a77a,Maksim,11,37,67,23,55,1,194,
925e21ac-e52d-46f5-8c65-5c426e3bc529,Makye,48,68,85,69,17,61,348,
d8cf0b98-7fc2-4f5d-9201-a2ca85b2f5a8,Makyla,64,62,41,80,11,92,350,
bf7ed008-aff3-467b-9cc8-9a254bc7014d,Makynzie,21,25,67,19,13,33,178,
fc8570b4-8f68-4167-83d1-62f6871f2d5e,Malai,57,6,100,52,0,51,266,
26592e64-9bf7-42f4-9a18-9feb73631376,Malaika,17,31,17,25,38,64,192,
cdfaf3d0-b7d3-4441-9818-36a79c3cf037,Malaina,78,19,56,2,60,29,244,
b33d54f5-5912-4e44-a4ac-79bade69cb6a,Malakai,70,53,75,30,66,21,315,
940af22e-23f6-43d6-8acd-1ded1d6cd733,Malakye,10,28,85,44,66,19,252,
82c0b03b-9bbf-4737-90a3-c9e675a949cd,Malana,67,22,1,86,1,57,234,
ed078490-0576-4095-a0b2-85e9f289d6d2,Malanie,85,10,83,69,70,10,327,
4bdfeb7c-f95d-4b4f-9d46-b075589076e5,Malayah,75,47,97,6,8,61,294,
32d1eef1-0c86-4b19-a82c-e205e202cd55,Malayjah,96,6,26,98,29,31,286,
ea23c9fe-1de5-4415-9912-9e861ac4edf6,Malayjah,97,93,90,52,63,17,412,
5b868db5-6a1f-42b1-aab8-c0e275884e23,Maleah,28,14,74,92,41,5,254,
9d48644a-2dbe-44f1-af1a-22ac130a1d73,Maleek,65,52,86,4,92,86,385,
d6d43348-79cd-44e5-9639-9eb66fcd5694,Maleek,0,26,42,70,96,56,290,
91072a46-2541-41da-90f5-38998c79ad41,Maleeka,91,60,34,47,78,80,390,
c299120e-ac2b-42cf-b0e8-25e1851a51ef,Maleia,97,83,49,22,41,79,371,
0aae1613-9933-4a1b-aa81-fccc53b5d1d8,Maleigh,26,29,47,99,98,15,314,
750d944d-ff22-443c-b8ac-da57be3ec01c,Maleik,26,59,3,13,38,80,219,
e30ad13c-634e-46d5-977f-695bc43f50ba,Maleka,88,19,24,54,47,38,270,
876f9572-714d-4da8-8d42-15c243ed3e6a,Malena,90,82,65,60,8,54,359,
8c47f4da-21a0-426e-8060-d8f66b507614,Maleny,39,39,82,84,46,82,372,
ee24ae74-2556-49fb-a6e1-04883747ef32,Malick,75,9,92,33,92,58,359,
e0de9bae-645e-4015-a878-129ce92adc1f,Maliek,50,8,18,13,70,38,197,
edea19ce-6ec2-42d6-99cb-07a75c8811ba,Malina,55,65,96,8,8,99,331,
0c9258c2-bd8a-4edb-9c7e-6720152a1ebe,Malini,42,92,10,12,89,87,332,
e3f3568d-1191-4fde-8a1d-822f9d8fff53,Malique,9,92,94,16,37,49,297,
7c4054b4-d15d-4e35-abdc-7a4475d3a710,Malke,95,27,63,70,94,60,409,
7a5521f2-e076-48ed-97c2-99c96141ee3f,Mallary,71,4,65,26,43,20,229,
5998bf60-560b-471c-aff4-a801496ed2e5,Malo,21,53,88,74,92,81,409,
4f847856-a9c1-4380-a87a-a62975072dcf,Malvern,89,52,43,27,6,33,250,
889f3a40-4102-49ff-ae8a-844a6710716e,Malvern,91,18,75,0,33,50,267,
15118533-6a2a-4708-917c-b87a57bc884b,Malyssa,95,5,55,85,33,51,324,
2f2b4326-abc8-4a93-8760-38076bf85a50,Mamadi,20,53,56,46,77,98,350,
de58891e-b530-4d69-ad0f-aa1544cfa632,Mamon,97,100,31,57,41,9,335,
b613a352-7552-46fb-a2fe-47e973139aa7,Mamon,40,26,44,5,14,18,147,
d6b112fc-a827-4365-b712-8519680e6188,Mamye,63,16,99,0,54,24,256,
41ea5700-d3f9-40f8-9add-e91983b0900f,Manahil,32,76,28,53,29,77,295,
f32fe0a6-77b6-4750-a958-4396a5452afc,Manaia,91,71,54,96,77,83,472,
cfd52145-c354-4857-9948-9472d0c61a6a,Manas,48,11,27,82,32,3,203,
12d2f7d6-ca77-46ca-9bdb-393ca9b0bed1,Manasvi,11,51,41,7,97,4,211,
2939501b-5e86-4fd1-a83d-49f10f38944a,Manda,18,43,94,12,43,24,234,
038befbb-da6a-4c14-a65b-7e53d8493aa9,Mandalyn,26,22,42,67,49,13,219,
a168b90a-4a1b-4c42-bb60-f2e9a85e26b5,Mandee,22,40,71,15,43,37,228,
7789f2ca-804d-42c3-b7b9-07a69c4a6e77,Mandel,24,100,30,88,75,73,390,
7beb120e-1e0c-466d-ab45-6ed791a493e4,Mandisa,84,5,100,90,84,52,415,
0b6e5d48-de43-421e-8d1a-40d1e7e2c692,Mandy,80,83,71,88,76,24,422,
11bab044-18ba-4487-aeb0-635acab31dff,Manish,40,58,31,42,19,36,226,
73a9cab1-6ef9-44f9-9157-4d36f24f9055,Maniya,87,57,53,9,58,26,290,
335e5478-c2d2-44ce-93b2-a15cfed25cd7,Mannat,31,35,38,86,43,98,331,
c3a30445-8fba-4944-8035-6f5536dd41a4,Mannie,99,50,85,61,89,57,441,
ae03fe80-2073-4ad5-b0f3-9e74c8bf3678,Mannie,56,43,69,25,46,45,284,
e7f516e4-fd8c-430f-acfd-8615f87956b5,Mannie,18,63,82,8,51,37,259,
e910e4a1-9136-4aa2-97e4-70e2b50c3481,Manoj,16,6,11,86,66,27,212,
97299614-a84c-42dd-9ece-e21ca0b791a4,Manpreet,15,59,6,12,76,100,268,
9b835971-9396-48ca-9719-de32db15d78a,Manpreet,83,12,79,18,19,11,222,
d1ef06fa-bf7b-47cf-8bf3-c40e6c863aff,Manpreet,56,43,73,59,53,34,318,
975e210c-0921-488e-8686-56726250ecb1,Manual,91,93,77,4,68,63,396,
58e08d8b-ad41-4af4-be54-6b5d992fff9f,Mao,55,23,30,81,93,77,359,
69ac77cd-220c-4ab7-ab6e-141b1bd0c300,Maple,16,43,77,33,31,33,233,
10d588cc-8ea5-4d9f-aea1-093f805dfe50,Maple,61,28,69,36,83,56,333,
c34c4dd4-eb1d-4e33-8ff0-01a8a8b82d50,Maral,84,62,75,92,47,62,422,
674cde54-0745-4fd4-9133-415447044409,Maranda,59,19,11,3,4,78,174,
c14d5da0-3473-45df-99a4-fa03e922cadb,Marayah,42,78,17,92,29,98,356,
8df3184d-b9d4-4606-85aa-690af5e7a160,Marayah,2,96,76,16,6,12,208,
05f607e9-662e-42b5-b0b8-4e2b9e2b281a,Marayah,81,70,99,69,88,76,483,
8d863660-182c-4784-b128-8aa4ff948c6b,Marcea,78,58,69,70,59,1,335,
405c0cf7-d924-4203-903f-ed185b16d60c,Marcedes,69,55,31,26,99,74,354,
5afd7ef5-07c6-4a6c-9f99-4971810061a7,Marceil,78,78,13,32,98,74,373,
c4b87636-3b9c-45bc-ad94-1f04f7661934,Marcelene,97,25,17,51,85,61,336,
f54ef6d0-af16-4a19-806f-6f3243805b48,Marceline,2,64,89,56,87,9,307,
7959a839-846e-43c9-86a6-ca9d3f3c3d9c,Marcellino,82,50,9,47,11,23,222,
c0136b79-0f1c-4d55-98e2-37624559fb15,Marcellous,54,19,67,70,26,6,242,
78d9b09e-4985-4d29-b759-9d2d4d82c8df,Marcellus,13,7,73,0,95,73,261,
0ccc66ba-b56e-45a1-ad74-d4766d94c786,Marcelus,5,26,85,76,59,13,264,
f4563f67-e2f7-4098-b697-5bc33a1fe619,Marcene,35,77,28,74,13,11,238,
7ac93d4f-832d-4eda-b1d8-57eefdefc854,Marcene,36,6,1,79,53,85,260,
07561df3-4f33-4178-8063-0ccb0737c625,Marchelle,35,60,26,17,67,58,263,
57a7c0b6-d3cb-4f97-8c35-f07868903491,Marcheta,11,6,93,7,11,43,171,
536577fc-4ee3-4de5-a8e8-1cdc261ee35e,Marciana,75,7,34,16,39,70,241,
5cf2d0b1-6204-4f75-8d7d-ba82c996a05a,Marcille,83,61,6,53,60,92,355,
11d9f511-0b9a-4107-a1d5-514d3b5c92c5,Marck,3,54,49,50,38,38,232,
3ab80b0e-0903-4034-a740-2a38d51f120f,Marcos,95,9,27,88,22,50,291,
1b82b260-6657-46d3-88a2-f0d1c3ae8933,Marcy,3,85,13,14,34,44,193,
296357ce-f5df-46af-8e84-9c122ad07e25,Mardel,94,13,50,11,47,4,219,
783a1898-4046-4dbf-8e4a-dbbe0222b635,Mardel,89,28,41,79,28,73,338,
48568bf4-cfc4-4eb9-8d37-ff21348d6ff9,Mardella,20,9,83,55,62,7,236,
a987c03b-4303-4f28-9a62-de7cc3b520f8,Mardelle,86,37,97,1,92,78,391,
b54f6605-173b-4f6b-853d-4c2b7dc1d10d,Mardi,34,89,22,35,9,30,219,
5534d247-d704-4abd-b576-f2eeb4d94885,Mareena,58,9,21,51,53,62,254,
08cbe951-9337-43c5-bcf1-6f2bcc5ed000,Marek,0,26,10,10,39,90,175,
1a3bd513-6f76-4214-b7b2-c7ac740c5153,Marelie,28,23,79,64,82,66,342,
868a8af0-e1b7-40c0-8f5f-38d5d7dd5fdb,Maren,32,5,81,15,76,85,294,
14155485-0f80-42d0-bc0a-fe30c9844d41,Margaree,38,74,5,73,50,81,321,
39e1b6bb-c8c8-4de0-ba49-d15a7afc5781,Margaret,66,77,74,12,51,88,368,
b53ae604-2106-4671-81ad-8ff9d5cce5cc,Marge,16,25,18,56,60,27,202,
c84ac69f-d13e-4558-80fe-d94e241d4789,Margene,27,55,94,79,98,10,363,
e18967c9-fbc9-4320-8329-2872e6d73032,Margene,40,42,4,1,83,39,209,
b9bf8ca5-f0d1-457b-8665-eb3dd63a30bc,Marget,48,40,74,33,50,14,259,
9dd13dbc-7b0e-4c73-917d-17e37ccdfb0a,Margie,75,13,54,43,100,95,380,
110b9103-acb6-458a-b319-da60fc756731,Margit,22,73,93,82,41,74,385,
06423dea-5ab7-4237-82c9-6b1a842a1767,Margorie,75,23,62,23,54,94,331,
3195adde-9bd4-4db6-907b-4a8640150f82,Margret,44,59,54,90,32,24,303,
abafb0c6-5c37-404d-aaa1-3f671c62761c,Marguerite,72,74,88,69,57,61,421,
c4a7810e-14ee-4e79-baa0-436fe090db97,Margueritte,8,16,92,31,22,13,182,
20ac6af7-3515-4783-9048-ad9eea1cf0b1,Marguis,31,61,38,24,60,92,306,
15f52011-4905-4fbe-a904-2fb7cc2ea7df,Margulia,3,28,44,84,56,57,272,
2d177682-14d2-43f3-910b-238fddd0b8cd,Mariabelen,15,86,56,40,31,55,283,
9b9ba6fd-5a20-493d-9436-60209476e5b0,Mariaclara,68,89,59,98,54,47,415,
d80e0501-5afc-4036-b94b-a28c7d1a25bb,Mariacristina,40,9,37,5,2,51,144,
b24c841c-df62-4738-820f-ae3c3703fa8a,Mariadejesus,93,98,63,24,64,71,413,
2eaf48a2-6faf-422a-9046-df24d0391797,Mariadel,24,38,35,18,40,60,215,
7d2b64fa-9cb1-4a4b-9648-e6a1cf0ee6b4,Mariaeduard,18,85,16,95,5,24,243,
56671e4b-aaf1-41b3-ac1d-ee64abaa3dce,Mariaelena,9,12,73,92,1,2,189,
63f573f6-b103-4720-8221-0176174aa79b,Mariaguadalupe,91,1,15,59,13,17,196,
85a83a6c-120a-4a73-99fb-f643f0e13f3e,Mariaisabel,70,48,66,70,69,89,412,
54e281e4-65c8-4e5c-b0e0-ae33ec1f8b71,Mariajose,10,37,86,44,86,62,325,
1078a898-8768-4217-a6ae-60f30d719cb1,Marialy,38,69,76,47,71,96,397,
0e4034cb-f412-4ed1-80a6-e7d0cab217fb,Marialy,30,16,12,39,27,80,204,
87ec6059-a80c-4ac0-a526-4bfef43a7e2b,Mariame,81,1,15,88,53,81,319,
707f2a48-330f-474a-bfb9-4c142ab29189,Marian,46,25,65,59,91,11,297,
cc89d981-c943-4003-a4d5-79b494ab20a3,Marian,77,3,45,72,79,15,291,
d5a9ac84-8a93-4382-bc2c-81e2669c1be1,Mariana,33,46,2,19,27,11,138,
604283d9-d492-4536-baa4-ebd96df38706,Mariapaula,30,67,85,59,14,2,257,
d0cf3095-d26a-4116-bd41-5cecbae65fd6,Mariateresa,71,42,69,54,62,92,390,
b424d248-b1b7-40ed-bc80-dc6eb99f8cb4,Maricarmen,16,6,90,34,53,5,204,
135bc0f2-6669-4d21-b96c-23f8aee1fd33,Marice,1,14,71,64,40,42,232,
8ca42a76-f791-451c-bdc7-3f6cd3c60ace,Marico,75,84,55,10,42,83,349,
4a8fabf8-f9f5-4217-b93d-7612185d180c,Maricruz,4,99,89,21,23,30,266,
5e2efaa7-f24d-4ec1-a943-90ffed433539,Maricsa,12,27,62,95,94,81,371,
176c9545-de2b-4ca1-a1f4-c3a68ddbab26,Maricsa,89,27,10,10,17,69,222,
4234c28f-ef46-4c41-8112-b65926841480,Maricsa,93,11,84,37,59,24,308,
28f66e7e-c9d4-4a55-8028-f79fcc87b136,Maricus,30,85,100,45,52,52,364,
e71ba472-5854-4dac-bd01-fa90ea00f186,Mariel,71,97,32,23,50,41,314,
a0d267a8-7853-49f8-ba78-0811fefd9a42,Mariellen,41,8,93,86,5,1,234,
9c7e82cb-9fa3-45d0-b78d-cb3322c8ed64,Mariely,57,13,28,91,73,6,268,
9e72cd52-b877-478a-8f43-17d6507d4647,Mariem,5,55,96,69,79,96,400,
8fb8dfef-c964-4609-99f8-8097e1d441c9,Mariem,47,98,64,61,65,4,339,
6c44206a-8778-4ed4-bba2-d1bbb6adb095,Mariem,5,50,13,43,14,82,207,
71efcbea-49f6-4211-8f31-8ed3ac6344a7,Mariem,33,31,32,27,6,45,174,
4170d0b5-75c8-46be-a1c8-90fe7b69ab5c,Mariette,20,93,75,86,34,94,402,
48bf95be-cc53-47f7-bde8-a44226a7300a,Marifer,71,41,80,16,50,23,281,
00dc7eb1-38e1-4be2-8e4b-0cea012419bd,Marija,29,18,8,32,44,25,156,
25c6e3bf-f7bc-4405-8f05-26ab9b6840fb,Marijose,91,62,16,69,63,93,394,
a01cf5bd-dff1-46a8-af31-1425f70017a6,Marilin,84,39,79,75,21,83,381,
5c7fd9b7-433b-44b0-a504-d7a0f910f1d5,Marillyn,83,14,70,81,53,7,308,
edc3137a-08e5-407d-aacc-501aca777b05,Marilou,16,34,45,53,40,98,286,
6b867256-9ccf-4c2b-9095-da249cfcfc18,Marilou,71,84,94,70,45,43,407,
7d07deb0-0819-48bf-945c-73e5faedf6af,Marilouise,43,39,2,3,73,29,189,
02750dec-259d-4b3b-801a-2dfda139e361,Marino,27,63,97,61,32,28,308,
a3122131-882a-4ba0-96ac-4d99e393fb05,Marino,93,98,70,96,95,82,534,
f677d846-e0f0-4e58-9ec3-33df44a36d30,Marionna,79,10,80,61,32,63,325,
ea3a3748-0b7c-47ce-a8eb-0b702ba3a351,Marios,33,13,95,85,43,77,346,
8d073975-2d28-4891-84ff-e81612422fbf,Marisel,12,92,91,22,73,51,341,
8e4787d5-a49d-4492-ac37-5921d5536276,Marisella,21,32,96,30,95,34,308,
8a6470d8-29d8-4be7-be60-ade9a1011e98,Mariska,91,34,0,88,61,19,293,
ddbd2fae-b29b-44ca-b0f2-e43c99ce353d,Marit,65,55,56,2,54,74,306,
303e711a-c9c3-4295-a9c2-438a6321b972,Marium,14,28,7,88,0,4,141,
3305ac9e-cf33-431e-bc65-445fd3e4dc68,Marius,46,19,57,74,59,85,340,
d31a1bb9-22c6-470b-8d03-be95dbdca932,Marivel,15,86,45,84,10,80,320,
2840c125-5b37-4034-9088-d19191937fc3,Marivic,77,70,34,51,5,35,272,
7edf8823-e755-4667-b5bd-317d4c28db1d,Marixa,73,1,85,20,51,15,245,
091aa7f9-e664-4f7b-92b4-561ba5cd11ad,Mariyah,12,73,93,58,92,86,414,
555271e4-1fd7-4aef-8419-4f492277f4ec,Marizol,74,29,60,42,67,76,348,
927f82d9-ac83-4c8a-8f51-4af72f097420,Marja,92,91,37,82,3,15,320,
062b7d4b-ae7c-48fd-a71b-11fb1ba9b53c,Marjean,55,9,99,42,36,52,293,
6ce7c2b2-e4c5-4019-a27b-87108e08f539,Marji,74,78,72,27,58,64,373,
e66d81cc-8ffd-4441-ba7c-b575d403b6f4,Marjie,38,62,7,0,7,9,123,
004c47cf-55b0-4b22-9d0b-dcd31c1a3033,Markandrew,74,64,94,64,87,64,447,
56e09129-4d07-4707-8f70-22e8cea53292,Markella,98,4,90,100,23,82,397,
8630faee-5f7d-44c6-909b-17996a2703ce,Markeshia,28,25,87,68,32,58,298,
c0586bba-378f-476c-9c93-578892629a51,Markia,29,66,89,81,46,55,366,
1a707376-4bc8-4cce-93d7-817cdfe4ad0d,Markis,4,54,35,86,98,29,306,
a91bf305-b100-4ff2-92a9-47c31921cd10,Markisha,34,65,10,96,46,27,278,
c52a0a05-c961-4d11-b2cb-3de0c04a7e14,Markisha,82,60,56,12,31,35,276,
88371c5a-17f1-477f-9143-a37a3c08e06b,Markjoseph,22,53,7,67,19,24,192,
80d8f0f1-e663-4194-8f08-5cf3f23fb9c5,Markus,10,95,29,63,5,33,235,
8f79a5a3-567a-43ae-9925-4eb3beaf6067,Marky,46,78,41,15,75,87,342,
296b385f-d006-4ab9-b582-44111e6a0d5d,Marlana,31,8,54,98,51,9,251,
5d3bd89e-3d1d-4eea-a6ba-2113a1872345,Marlana,56,73,25,60,18,47,279,
7d2ea9c4-281f-4a15-a1e8-ce8538ed0c18,Marlea,9,76,93,28,35,2,243,
3200a845-7456-4f63-9591-cf25b8917c40,Marleni,90,48,32,99,0,7,276,
663014b5-262d-499c-a432-2500ba1f6b1c,Marleny,31,26,62,68,53,4,244,
025a3010-53b5-4a43-a541-3ac6003abff6,Marlina,52,3,6,88,91,52,292,
c92e5968-0c82-4bf1-a3ba-204385073676,Marlina,62,76,61,69,54,6,328,
f7328ce2-fd1d-490d-a832-899c82e23f67,Marlisha,12,33,19,99,93,67,323,
0a9572b9-bcc0-41d3-99fb-478689ba696f,Marliss,5,39,37,57,16,17,171,
4c3459fa-8f5d-4d24-ae07-dc969319622c,Marliss,54,16,17,23,37,87,234,
07d0a5b2-acc3-422c-8bdc-c83ed63d170f,Marlow,49,62,14,79,93,2,299,
a3db78c2-7c2a-4aaf-8a14-99a0f9c60c09,Marlyn,37,85,58,47,65,16,308,
a3487c4d-842a-44aa-89ef-32bf81b938ce,Marna,32,1,6,37,35,11,122,
1d4340e7-9f72-4442-8855-0176a2018b10,Marney,93,97,62,28,65,89,434,
429d614d-086e-4c62-8aca-fb0d428404cc,Marnice,34,23,35,32,52,97,273,
d21a9950-24cd-454b-bc99-57a2441b011a,Marnie,73,63,25,7,1,46,215,
845c8f88-251e-47f9-a830-35e2d3008621,Marnie,52,13,1,39,30,31,166,
8c54c47c-d52b-43ae-ba3f-f473473c8e4d,Marnisha,54,80,83,50,87,62,416,
4ecfa6c2-63a8-4faf-b57a-595e24433164,Marnisha,6,29,30,22,53,30,170,
fdd30930-52a8-4d2a-ab39-fc186a661dbb,Marolyn,40,22,34,13,96,22,227,
2720d36a-4705-49f1-b991-ccda48f07d69,Marque,3,29,67,68,77,47,291,
228f2b00-12c5-457e-b6e0-c590effcd08b,Marquelle,85,76,3,19,19,52,254,
b1cbb322-42d0-4a83-8e07-55e2cb8c3287,Marquese,98,54,73,63,72,31,391,
4277eb68-6c46-4fe9-9bb4-01a1cb3dacb3,Marquez,84,87,11,37,37,100,356,
f9fb5652-08b0-4405-a550-76f487b8f236,Marquies,14,63,22,62,49,73,283,
44e38696-618f-4424-9720-6b8996b78e96,Marquies,25,24,0,77,80,86,292,
998dd88d-bbc5-42d2-be56-ec698040bfc3,Marqus,3,13,70,39,75,20,220,
400bdf5a-cee6-492f-a112-128f69e43572,Marriah,74,32,1,86,96,95,384,
66781020-c653-4f46-9e6e-95312937674c,Marrio,93,44,36,73,52,96,394,
07c72890-0daa-4e5b-a050-0899c60e6b42,Mars,67,76,64,17,68,44,336,
3eeebb64-b295-486c-8460-c919d63872fc,Marsean,85,14,64,36,96,83,378,
40874764-03cd-4f61-9617-3bbee1961b3d,Marshaun,23,16,28,69,98,82,316,
9a391bea-eba5-4455-bb0f-447dc217fa8b,Marshawn,4,33,0,99,62,97,295,
db332c48-aeaf-4686-9f2d-00ccfeaf8523,Marshel,94,72,87,85,28,20,386,
65f9c9d8-a64f-44ba-b824-c95a042661ed,Marshell,59,38,31,80,68,54,330,
8eaf6758-7f9e-46f1-81ba-d0a0f2167f91,Marshon,69,62,7,63,41,99,341,
70fe1434-bc07-4ec9-b1f1-9e7053f829e8,Mart,77,45,34,81,49,96,382,
0d846c85-bfbb-47f1-ae68-e1b4e8676d3f,Marta,44,63,61,5,74,74,321,
e8feede4-6c72-4322-bbef-ba67ee8c5a54,Martell,67,98,85,2,91,8,351,
1550cf86-a697-4125-aad7-cb658ac1535f,Marten,11,0,61,55,91,17,235,
f49a7c12-0c5a-4ed7-b7db-03580dbdd811,Marten,5,26,87,25,43,33,219,
98efe918-c769-4ce5-b034-6a64edbb0956,Marti,18,28,68,75,51,43,283,
0b11143d-168a-435d-aaa5-ca6575a42f69,Martina,49,24,81,91,97,62,404,
a082eb78-0871-41f9-9bb2-d3b51df5af5d,Martine,54,99,3,53,51,14,274,
0719c0c4-458b-4361-a107-763347bd2563,Martinique,35,37,8,57,64,27,228,
59003af1-f731-4771-88a6-0ab62472e2f0,Martisha,8,39,77,5,63,53,245,
379c81e2-3f32-4e0c-8356-19e6442b7687,Martrell,92,78,100,99,32,34,435,
f918ae72-c69f-4698-a467-39af29a128d3,Martrell,24,70,77,71,25,88,355,
b076c05a-245d-4243-949d-93be4e05826d,Martrell,73,40,54,17,2,39,225,
c7e0238f-34e7-47eb-8808-e26e23f54cb2,Martyna,32,50,30,34,7,61,214,
f1508893-d49b-489b-9696-409bf8cdf7e1,Martynas,97,53,71,4,84,48,357,
538f1c3b-74ab-4df4-b40d-0d19505e9cff,Martynas,81,14,79,14,50,40,278,
9f21b527-d831-4915-a1c5-4b7cf953cc3a,Marva,98,25,78,98,12,73,384,
48a68f5c-5aae-4289-ac38-c6646e2bfd21,Marveline,8,35,69,43,85,1,241,
53e46c5d-4cb1-4399-9879-0eaa0c0b5db1,Marvie,37,42,20,30,92,0,221,
38a91a05-90ca-417e-b621-1706c79fa204,Marvin,41,16,78,66,96,5,302,
3d0e60f1-2e4c-4aa6-9c78-2f32282838ac,Marvins,6,1,19,51,59,74,210,
2d0626a9-87b8-40b4-bcba-d0b22c442e90,Marvion,32,96,61,69,62,96,416,
e17a5bef-2603-4728-9c96-c3627ffebe1c,Marwan,8,59,62,78,65,50,322,
35f1eba3-8331-442e-8267-88d46f7ee6be,Maryalice,30,0,87,65,45,88,315,
b3538341-25a1-40a4-b4dd-c4d2610df909,Maryan,49,36,7,67,43,5,207,
c85d3ac3-5f9b-46e9-a7cc-98076e69356a,Maryana,64,52,76,54,19,3,268,
f2026727-0b91-4094-8a61-c0eef150d51e,Marybell,8,56,44,37,41,51,237,
a8aa31cc-00e2-421e-b77c-1381bea7532f,Marybeth,80,6,90,57,13,30,276,
8e320190-506c-45ed-a5b2-7e6998d30be6,Maryclaire,53,5,73,89,100,70,390,
0f2063cd-735c-4a28-a2aa-e852853bb770,Marycruz,92,5,88,80,90,86,441,
521a74c4-6524-4d90-9a23-8cefb2ca7673,Marycruz,61,41,91,48,20,96,357,
0295c4eb-1bd9-48b2-87d1-e5285e931949,Maryela,64,5,84,51,30,61,295,
90a44174-62dd-47c7-a402-77e78171317e,Maryfrances,45,88,8,97,88,12,338,
6059341b-a83f-4874-97fa-a686e77e4455,Maryjean,84,34,81,66,98,99,462,
e91d3d12-1b91-40ef-934c-7b56a0d67ccc,Maryjean,20,90,39,48,15,13,225,
6d7f7425-c91a-423d-9423-ae8b19e925eb,Marykate,19,0,0,77,18,99,213,
f7f00222-fd9f-4c31-beba-a8de576450a3,Marykatherine,46,88,2,64,94,67,361,
06aff212-1f50-4346-a6bc-e31de5e93e1b,Marykatherine,100,45,61,66,67,70,409,
aaca6343-c41a-49d5-856c-feeb748378ac,Marykay,68,97,5,9,14,75,268,
ba40cba0-51c8-49e0-87d9-e339047a8836,Maryl,59,93,78,73,90,44,437,
e03a9618-2bdd-4633-805f-a97dd1ea2bcf,Maryland,25,71,38,37,76,55,302,
64adba75-9f8e-411c-9396-e90ca835d80b,Marylouise,29,84,43,91,20,52,319,
b84165de-89e6-4772-8e65-71569ca884de,Marylu,81,80,27,43,72,70,373,
321a4735-3133-4e02-88d4-77ef72cf24cd,Marylynn,63,16,90,21,66,70,326,
d8f3a845-9a99-4138-8e83-3223a6ad8731,Marypat,53,89,20,68,57,47,334,
07e5a5be-8a37-4563-8012-440bef9d2c56,Marypat,97,55,43,77,54,47,373,
53104c47-180d-4cbf-8727-89e201916f51,Maryrose,65,41,2,50,44,18,220,
81ca2971-5f8e-4ffd-ab28-276e216505fa,Marysa,52,92,64,10,22,100,340,
5d054dda-d042-4a27-a378-1ccb08a5af9a,Maryse,81,45,26,24,18,100,294,
d515ee1f-091d-4867-bd64-7f6897ee9c32,Masaaki,78,92,8,1,71,17,267,
8874f1b8-4a9f-4bc7-992f-a05cdd6c72fc,Masaichi,73,46,66,79,10,85,359,
4727862a-dc58-4cd1-94d1-49ff98e59ce0,Masanori,18,88,67,38,61,12,284,
38f5bea9-2867-4442-b79f-df734f7f9542,Masaru,47,52,61,88,10,66,324,
36a8761c-9b3f-4c37-939f-fddd421812f9,Masashi,29,54,62,79,0,87,311,
7f57a324-5b24-4dbc-bcb4-f6c40d7c5a15,Masayoshi,26,9,56,98,83,62,334,
dd4e203e-3eda-452f-b5b1-9efbfd888d8f,Mashawn,83,90,5,14,6,6,204,
eb8889e5-e11e-46ab-8ed0-0ee5b9954030,Mashawn,85,65,81,18,91,57,397,
fe29bed4-dedc-44ae-8c45-1a932df7881e,Mashayla,85,60,65,16,73,96,395,
df3c5d8c-a1e8-480d-8ccd-17de77d1ed7f,Masiya,80,98,42,87,98,15,420,
c9525144-e968-4ca6-88a2-de6f5a9e572b,Masiyah,31,45,45,44,75,71,311,
278e9ce0-8e07-4c65-b5c9-6630fc0fc2a7,Massiel,82,55,42,86,35,100,400,
7cccd131-664b-4e85-95d4-faa863cf91fb,Massimiliano,99,37,37,6,59,2,240,
87adefb7-e638-4823-b7d7-949e5bf3e6d6,Masyn,56,40,10,55,36,22,219,
7861d0c3-3d63-4eae-964b-f23b0405d7e2,Mat,2,94,23,86,26,30,261,
2d8e3642-8824-4a89-9583-c46ce8f51bf7,Matai,90,19,98,54,54,67,382,
2c98dd61-374d-4bef-8c15-645be43ac64f,Matai,29,5,77,21,62,64,258,
8a79875f-4ac4-48a8-9830-2b5782d3eb8d,Mateo,19,58,70,94,34,66,341,
0b92800d-6341-4a47-8a9b-1f267955f49d,Mateo,10,10,29,81,69,33,232,
e7c59c51-60a3-42cb-bd17-32d2cae9d489,Mateo,52,8,39,99,76,74,348,
fb47bb03-2fd2-41c2-bc31-b1fc44235302,Mather,71,16,67,70,33,49,306,
02f62be3-1bca-41d4-8590-e5030832ae90,Mather,69,38,72,60,2,40,281,
8812adb9-05ee-4e74-9cd6-cb0ee410ee2a,Mathilde,27,42,62,80,21,44,276,
d4c3b7b4-ce3b-4e95-8855-31b90fb4794a,Matilda,48,48,97,2,34,63,292,
67032755-8d9d-4333-86f6-67da7ec5d1c6,Matilda,92,90,7,100,54,63,406,
b638f42e-f87d-425f-928e-684fbe319726,Matisse,11,66,35,80,20,49,261,
c6572ac7-f352-4019-9fe5-fb5afc2fb01f,Matline,33,28,49,33,100,97,340,
09c85af5-0c78-4945-87c2-488c248ecceb,Matt,24,85,22,26,65,22,244,
04e4ca79-54a9-411c-ae3b-e07d2fcc751d,Matt,51,75,88,16,53,29,312,
d750e5dd-dc20-4207-bc8e-af6c6027957d,Matteo,65,70,11,71,86,3,306,
b88716fc-79b3-4155-a0ce-0d2840b7da5d,Matteo,72,66,12,99,13,85,347,
54c3bbe4-c378-44b3-957c-de2667d0c988,Mattheus,10,14,89,26,34,83,256,
8274a158-5214-46de-aad2-eac6fb4dcb78,Matthewjoseph,0,24,44,26,17,28,139,
3ed5fa20-dd21-4921-aa3b-4429f091f871,Matthias,42,56,49,31,50,0,228,
a797f68d-7140-4f55-82c2-ba5574536c05,Matti,0,15,44,85,45,98,287,
d7901c1e-85f1-42d0-bd36-2dfd4b9fb2b1,Mattia,11,42,98,77,43,2,273,
5b35f1bf-3abf-4f73-94f7-0c64cafdeffa,Matvey,43,82,18,70,29,5,247,
a0bb46ee-aadf-46ec-802f-b5f2faef32f6,Maude,61,27,65,74,64,79,370,
847f205a-1798-48ac-aab4-b2ce17063f1e,Maudell,91,5,39,92,80,35,342,
d935d986-a196-45e8-9511-c291d20e35cc,Mauel,26,7,91,94,32,47,297,
1b85d2b6-b0b0-4756-8c84-fcc6ed568643,Maureen,20,50,75,34,71,4,254,
32dcf654-8978-4969-99fc-5df395ecbeef,Maurine,28,96,69,63,42,49,347,
c8fb988b-3636-44fe-b7b8-2e3e019e8a3f,Maurine,8,11,76,94,2,50,241,
19754e87-5ab3-4f86-b821-78e28cb8cd8b,Maurion,14,5,97,79,16,15,226,
d6cb2b9e-30e0-4d3a-9da0-cf9bb5c1687f,Maurion,50,41,48,30,65,36,270,
cba71bdd-3ac7-4f23-b50e-ec551de98712,Maurion,60,49,79,73,39,70,370,
b5174873-de76-4587-8660-c0de61423481,Maverik,8,39,28,48,62,32,217,
98919426-b004-4e16-b85a-700c132e22a8,Mavis,74,74,19,60,8,71,306,
c19ba4c4-4291-46bf-b0ac-0aa4346a6cec,Maxi,92,38,49,59,52,24,314,
ce14bf5e-2b03-4356-9aa0-d98224940426,Maxi,0,40,90,49,43,49,271,
22939ce9-57dd-449b-8c0a-5a9fc2d162d1,Maximiano,75,53,51,64,24,44,311,
84014324-d1a7-48f5-9eae-c56a0887910f,Maximo,77,89,73,67,19,81,406,
f1cfcf2e-31bf-448d-9e34-7cae48ba6206,Maximus,28,97,77,70,30,81,383,
f58571ac-8c8d-40ed-b8e3-4bece59d1c2e,Mayar,14,71,54,62,4,33,238,
f6365697-14db-40aa-b201-6be310798b84,Mayara,76,67,13,26,7,85,274,
d89e6ded-b41d-4008-8db0-870eda1228ea,Maybelline,42,28,58,86,64,92,370,
a261ade8-3b80-41ca-ade2-a771debe5237,Maybelline,7,51,36,39,12,11,156,
c639b3c5-a68d-4564-b013-f992afc26cc7,Maycie,14,89,99,88,99,70,459,
f2a0f39e-153f-436c-b041-62a033cca72d,Maydeen,18,3,67,35,49,23,195,
a1edd98f-6931-45ec-8bd8-b058eeaedbd2,Mayerli,58,62,63,50,28,72,333,
1e72ce59-84f9-4bb3-b0e9-38aff5b76525,Maygan,45,34,52,82,6,48,267,
c9968299-a573-4d2c-8f70-8e2cb69cf3cf,Maylea,2,3,69,99,29,72,274,
9bc2c331-2cc3-4704-8c9e-443d5de8901e,Mayleen,91,18,89,12,15,37,262,
60540286-9e8c-45fb-836e-f926b686c3aa,Mayleigh,48,31,7,0,12,23,121,
9c4e7274-da25-4215-a136-0b6cbc43183f,Maylene,18,23,62,27,38,55,223,
a41c93e0-a000-4baf-ae38-ffdbfc599b49,Mayli,18,22,33,62,77,24,236,
22c776f0-4566-43e8-8182-f7dc9215daa0,Maysa,15,3,92,80,7,16,213,
2186b70c-da02-4dcb-a35a-57ca8cfc72d2,Mayzie,71,5,56,2,12,85,231,
33d5c4dd-1ac7-4332-8a29-163aca657a1b,Maziyah,67,0,16,32,78,65,258,
1c8cb900-a6b2-4f9d-9772-bfbfc235fb21,Mazzy,23,26,86,97,46,13,291,
4058c6b2-3da4-4871-b3b6-cdd7d5932333,Mc,83,52,92,95,79,73,474,
de74671a-23ab-4788-b2c1-cd91d3e44838,Mcadoo,80,44,81,73,6,34,318,
1dcba79d-67eb-49ef-850c-be25c1552efd,Mccoy,82,15,55,97,14,66,329,
94f6b5aa-2b91-4c74-89d7-926037150e00,Mcgwire,26,5,37,60,21,99,248,
3d03cc14-2c25-4b76-af69-a4b4cc901438,Mckade,6,45,12,14,74,94,245,
7c4f5635-6b0d-4eef-a9c3-044f16c0668b,Mckayla,98,38,15,16,81,23,271,
45476ddf-3344-4839-8cac-363ceb104b6b,Mckensie,17,57,98,96,5,73,346,
04ac31fc-d127-4467-a0b2-738ea30d263f,Mckenzi,28,84,31,71,15,25,254,
8d87ccd8-9b8f-4db7-b710-ff6c76cec36c,Mckenzye,78,9,12,88,92,63,342,
5935765c-324f-449c-94c6-c60cd8a56ec6,Mckinlee,0,17,45,46,3,73,184,
b42bdc7d-99f3-4fd6-a038-8cccf1949cdd,Mckinley,99,9,26,49,10,47,240,
4229105a-223c-4358-b6bc-0cf45d9a740b,Meagan,2,72,91,49,4,99,317,
f1750e14-028f-4364-a1fc-4098a99114a4,Medgar,90,35,3,76,62,22,288,
8265e618-0b8a-47c1-a9dd-3e4f86971c2b,Medina,77,69,34,58,65,100,403,
fc29acf5-bb68-4b86-a6d6-d11c647f9706,Meela,27,23,87,5,11,26,179,
347ef214-7d60-43bf-a7d6-a368cd2cecf5,Meelad,22,83,57,43,33,12,250,
c6cd4f17-a282-4118-aee8-f4ac81821a0b,Meenakshi,14,64,12,48,82,36,256,
ef1beed2-acc0-4fcc-9a8b-8d02d79d6eb0,Meesha,80,97,76,92,70,53,468,
024f79fd-f767-4368-9c26-a3d85207c660,Meeya,90,51,20,97,68,20,346,
0f29c775-4a7e-4f93-90af-a215425c5492,Meeya,73,47,19,24,61,75,299,
2d7932a7-354a-4110-a698-31a61be8901d,Meganelizabeth,50,53,80,18,41,59,301,
03b64e8f-cb9d-44e5-aac0-8abb05f847c5,Meganelizabeth,79,74,94,35,68,86,436,
82815299-7c1c-474e-82e1-d79804448fff,Meggie,74,4,72,0,2,54,206,
fce75491-782e-487f-9e63-e53be17c1334,Mehar,52,82,40,25,93,52,344,
bd766e4e-478b-4b80-8621-6faed737952f,Mehdi,37,22,84,79,86,71,379,
73715253-aeb0-468b-8382-82982541bf8b,Meher,19,48,54,77,19,64,281,
f5530992-8d6a-4e0f-86fa-c821b2db3793,Mehran,22,96,88,38,90,23,357,
de159f80-2acb-43f0-b199-313ed192767d,Meichele,74,95,94,67,93,79,502,
b09259c7-6b81-46a5-9e2d-655e4ae4e5c2,Meilich,86,47,21,24,31,62,271,
5879aa53-b50e-4155-aedb-3c16e3449050,Meilich,54,19,55,81,44,91,344,
8e83b17e-89cd-4402-9a2c-96f677a6bf3d,Meira,93,58,99,53,48,34,385,
75242395-7568-4f9c-8f82-3ccb26fb49ce,Meka,98,6,21,91,53,15,284,
3a9444c6-7865-4985-b39a-b3ed6e871312,Mekenna,49,40,15,64,67,98,333,
dbe73147-74c9-4df6-9141-9351a1feb9c2,Mekenzie,60,65,70,52,27,71,345,
dedbc427-1380-4ec1-8081-b8e1d922cc06,Meklit,52,83,48,80,0,8,271,
628076a2-abc1-479c-bf7c-2861e939d40a,Melaina,77,70,48,9,6,96,306,
053cdde6-b216-45fe-8774-c442a4d4ef93,Melaney,93,56,91,46,41,88,415,
15ab0950-eb08-4cdb-bbe6-21f709d90635,Melany,78,92,19,50,66,65,370,
80d918b3-3e91-4bac-92b0-cc51e0a4a265,Melaysia,98,22,99,64,41,72,396,
67a7211c-8836-40a4-909a-1de5f53d39ca,Melaysia,62,59,25,47,40,12,245,
db55c4a0-309e-44c4-ba69-1f765a27f966,Melbourne,58,9,83,24,53,77,304,
99b47e4f-a781-422a-b2fb-01419ba076f3,Melbourne,2,93,78,19,24,0,216,
f3b32caa-afba-4f9a-8872-12f249a7b270,Melburn,63,85,5,62,34,5,254,
9890106a-deee-4eb4-8c70-ed629ec2e60d,Mele,81,39,95,23,0,54,292,
1e8277d1-cdfe-4aaf-a69f-d8e74e2dd41d,Melea,78,44,1,5,18,4,150,
5de888f2-f2c0-471a-b0ad-6513de68ffd8,Meleah,62,31,69,53,9,7,231,
35cf314e-d85e-4b19-95b2-ce07f2b09e84,Melecio,50,21,88,46,73,27,305,
fd4e0021-72f5-4850-9244-8daa30dbb875,Melecio,99,42,53,28,13,48,283,
c291e7a4-2058-4107-8b9a-3805e98d4558,Melford,21,8,99,20,38,73,259,
810f0c9e-0f17-4561-9273-dea0784d98e6,Melford,18,6,36,69,31,95,255,
73ab0eb4-604e-4d8d-abc2-330c381c6e28,Melik,30,99,27,8,18,37,219,
60e9802a-98b8-4795-9ab3-530941107aa2,Melinda,6,93,67,18,39,55,278,
26437010-3551-4e63-8510-3ac35419cd50,Melinda,4,90,81,55,60,98,388,
34a28dd4-79b0-4b18-b58d-9d7ec50d896e,Melinda,3,6,34,87,94,2,226,
1057d0f9-f0b3-402e-87c9-64411686d1d2,Melinda,73,64,44,14,86,60,341,
42e3e511-5a1b-43a1-9de5-03de75538fbe,Melinna,50,34,83,9,18,81,275,
bcaff12d-7156-4d2e-bd76-fa5e0daeae85,Melio,94,51,84,81,21,6,337,
f4634063-96a4-40ab-8b3c-63d8dae33141,Meliss,13,5,75,13,89,3,198,
2e1e5bf5-9ce0-4370-b64a-5323ac4d14c9,Melissa,49,50,90,67,23,29,308,
79aff991-fccc-4ddd-81a9-54b941985afb,Melissia,22,66,58,29,82,52,309,
dd867376-a567-4ed2-b115-b933fc48a16d,Melitza,20,91,45,79,6,97,338,
f8b70b2e-6eac-450b-a758-ab11d9b7521a,Melitza,11,92,52,82,51,3,291,
a925687c-b454-450b-a78d-8257d04b1b9a,Mellanie,12,28,16,30,23,92,201,
9fe14a72-be69-49c7-8a34-b797127ac556,Mellisa,45,40,89,61,74,97,406,
6af1822f-b11e-4e6b-aeb4-70264eddcc3a,Mellissa,73,33,44,40,13,20,223,
3666a719-2788-4614-9edd-a6128feefbca,Mellissa,26,59,39,20,96,10,250,
54d6b9ae-e0b4-48c8-a7ed-320fda18d6f4,Mellissa,86,43,67,33,74,79,382,
b548b87d-c128-4115-95e3-c96790e55a09,Melodie,14,95,54,63,34,36,296,
d707d139-f172-4fe7-be46-cf7eadf2b4b3,Melodye,97,51,46,2,20,64,280,
1fe67f9b-bfb8-4174-8e02-85e5011fb1f7,Melonie,74,13,20,78,10,35,230,
2f5bd247-74f4-4df6-9b1c-8a64c00c09ed,Melrose,96,71,17,17,93,16,310,
fbe8e246-da79-4499-be9e-a59047e220ca,Melrose,94,83,48,4,19,48,296,
7a554f7a-b807-4fd5-847c-50b0b6b1c275,Melvis,5,48,20,88,28,82,271,
746117d2-4706-4545-8c12-d8d6ab658f05,Melyna,75,27,45,90,92,21,350,
e7c3ba67-1902-45ff-80a3-f9f7b0baac6d,Melynda,10,99,77,100,12,75,373,
4f43bc0f-8ee1-4ddc-a66b-9fd16e40e889,Melynda,67,33,97,63,82,37,379,
a0f61123-591d-43e4-9888-a5236065017d,Melyssa,82,45,43,42,36,16,264,
aa83e856-8bb3-45d9-a783-86b2669aa292,Mendy,92,45,55,31,49,69,341,
b17bc264-92cc-4b84-b359-8fbe5c1e8bf4,Mennie,80,9,29,76,52,99,345,
80503750-9b89-4641-8430-c5e60f1c2958,Mennie,5,4,22,0,72,95,198,
3caf7ecb-75ca-4cc8-9878-3579cfb37684,Menno,84,32,100,7,94,65,382,
272c83cd-aeb9-4188-af2c-cb712730ac32,Meranda,34,58,65,53,60,86,356,
bf4f3e58-d592-4aa0-87a3-c61aec811dac,Merari,24,88,21,79,97,2,311,
2784fb39-c290-46ea-a78e-a3924114b852,Mercades,10,78,89,51,38,15,281,
79e76143-1e69-4d60-a61b-110b3cd0bd07,Mercadies,78,28,55,29,30,30,250,
a9fa8770-9280-40cb-8c03-80dc4a99b5f2,Merced,95,29,98,56,35,38,351,
69610869-7b8c-49e5-a0ef-33dc317a91a6,Mercede,12,57,41,47,28,68,253,
b6dfdc38-6389-43ba-b4f3-4d75f20468c7,Mercedes,22,27,88,23,34,25,219,
256831d4-3423-4a15-a555-7bd457d20676,Mercedez,97,84,4,81,35,90,391,
dfa12786-a471-4967-ac69-b0bc9e1197f4,Mercer,64,98,12,62,55,97,388,
8be4c624-60ee-4723-9c1a-8c2a578cf133,Mercer,3,58,53,67,46,8,235,
5e3c63f9-a0e1-4548-a136-57628cc1c09f,Merida,7,7,7,78,50,85,234,
1ac9158c-3699-4587-af68-4ef3760773a9,Merida,39,1,22,83,28,98,271,
ba1b720a-ff83-4577-8c0c-dcd7bea1a9e8,Meridith,87,45,69,36,13,48,298,
66f99c32-6450-4875-89bd-0978ee6bdc9e,Meridith,5,82,44,60,65,2,258,
87b12a43-c497-4d46-a916-11d5ac97a7c0,Merik,39,71,86,63,89,25,373,
2342026a-4a83-49f9-9be5-49043079e9b1,Merilee,2,80,64,71,93,8,318,
24332521-d94e-46cb-b1fa-2d66662bcbb2,Merilee,99,9,1,99,35,67,310,
523241d1-a077-4183-9601-8a0547492dee,Merilee,60,43,34,37,7,73,254,
42d1f19b-4db3-4e52-b73f-0e27877541c2,Merilyn,17,89,69,19,62,32,288,
0e3dcfad-25c7-4383-8756-4de142383442,Merisa,28,68,99,43,39,45,322,
9187a02d-531c-4fc3-a720-eb0d7040dfa6,Merissa,84,17,73,53,4,21,252,
2d0c7a68-c6c6-4d24-b4a6-036ebaf3b83a,Merita,97,47,22,50,0,55,271,
fd63f0cf-64ac-4d51-b2cb-6824d0f341d6,Merle,87,55,54,68,79,51,394,
704cab7b-2290-4d8b-a0e8-83541fbedaa5,Merle,24,13,27,67,40,26,197,
a0a12a3f-8cda-41ed-8314-f215524fab2d,Merlene,45,40,11,32,89,9,226,
7ce6917a-5f1e-49cc-a442-6529cd446c0b,Merlie,73,31,48,80,5,1,238,
7bc0300c-9953-4fad-b2d0-effa7a29f782,Merlin,73,55,68,25,40,67,328,
5b59d3cc-3797-4267-85bf-8f914bc1e0be,Merlin,20,57,93,47,59,72,348,
4cacb1ff-dad5-42e7-b372-227f92de1085,Merly,16,88,52,15,41,68,280,
9cd6663e-f2f4-40dc-b54c-6833fbfc30d8,Merlyn,8,16,89,51,34,4,202,
bef9419d-6904-4f38-8d96-695c30139d14,Merlyn,61,1,32,19,16,51,180,
d23f53c2-e2dc-46a5-8fe8-dfa86f5573d7,Merlyn,35,2,68,20,32,3,160,
0ecc3b78-2fe4-4d8c-a0a7-1e6a82de808f,Merna,46,81,15,80,18,13,253,
b0514a7e-5cbe-4528-a3b1-db7cbae79a29,Meron,39,33,31,9,29,11,152,
39064bbf-8fc0-4194-b18a-17c2c629a466,Merrick,39,27,67,80,68,32,313,
dd78c70c-4bcc-49f0-abe6-60e899379757,Merry,83,47,43,33,80,27,313,
816ee2c6-a4b5-4453-9b56-64061fab1ad0,Mersades,9,36,91,71,3,78,288,
7e9aa5eb-a008-4110-b681-90919acdc3b2,Mert,80,69,60,15,72,98,394,
515ad642-4174-4bf9-bbfc-e0032aecea65,Mertha,78,87,34,24,82,75,380,
b5cd5b8d-b127-494f-821b-b19013c307e3,Mertis,51,55,45,6,80,0,237,
580d44b1-4b97-4107-9292-e05e47f18b2e,Mertis,84,3,44,17,63,86,297,
9ce8ff57-b743-4078-977b-4e3d597f71d2,Mervin,30,35,41,41,43,77,267,
ee7b23e7-5180-46b9-b05c-48c13b195ce4,Meryle,53,54,81,53,66,40,347,
3272567a-0ce3-4157-8147-487c6a430cb5,Mesha,73,36,17,18,90,68,302,
36e37541-a9b7-4f3d-aa47-6f0df8962764,Meshelle,25,44,66,11,97,28,271,
be8e37bb-99e9-4790-b0bd-c468dab50d6d,Messiah,57,94,75,17,80,94,417,
5cc1e29e-a644-4b7e-9cf9-3eb9b12dcddd,Meya,73,75,89,17,40,88,382,
af439cc9-5d5c-484a-a643-38a50063fe8e,Meya,29,0,95,27,94,85,330,
f6564040-b5e7-46c3-bc07-bc86e147172e,Meztli,38,4,2,79,77,48,248,
ac2fa39e-5397-434c-b6d9-cdb39f64bfd0,Miabella,84,69,36,32,10,83,314,
7507f82b-877f-485f-9560-bd7dcfadefd2,Mialani,51,5,17,78,55,20,226,
d485ef4d-16cf-4a55-b452-8c1245c93d37,Miasia,2,93,71,52,54,86,358,
42eabc62-8cb7-445b-b8e5-fd77e7faf057,Micaela,68,47,55,53,95,93,411,
a1250c4a-2339-40f6-a46e-9838bb25f11d,Micaella,94,31,44,95,73,61,398,
012c4b2a-79fe-42c7-9e11-29741f9dc7c6,Michael,44,0,9,98,14,79,244,
1e1ed61d-e583-4cae-9c55-575c7874d435,Michaelangelo,56,66,68,24,31,66,311,
9878db9c-96ab-4b95-aa07-17d6cca12589,Michaelanthony,77,94,40,22,87,52,372,
2df7a55d-77e9-4b5a-9610-f6d23454baf5,Michaeljohn,62,44,78,16,26,35,261,
1f38a95e-306c-485c-aa8f-31b8e78877bc,Michaelvincent,42,30,59,45,9,93,278,
c9e569ed-e9e6-434d-9946-9fa64766887b,Michaila,68,55,100,25,12,95,355,
d95ec7c8-ec98-4ab1-843a-074d55889365,Michela,22,33,70,89,32,13,259,
f14955f9-d1e0-4430-bc03-6042de9ce22c,Michelangelo,47,2,76,10,5,32,172,
fa2004ca-44fb-4fba-a267-529afd3c498d,Michelle,6,54,98,43,91,43,335,
19ab8528-acfb-4bb7-874f-ba7ca29bb05b,Michiko,46,22,66,39,44,4,221,
05e6b965-ec28-4976-a4f7-ef9336aca519,Michiye,82,5,99,62,44,84,376,
b6b8a9eb-6e72-4948-b919-c5e035fab358,Michon,78,80,70,47,36,82,393,
9c3a789c-898e-43de-b567-bd89be7c7deb,Mickaela,75,8,32,56,92,61,324,
4c54bf9a-9663-40a7-8eb1-0a3014585461,Mickaela,74,17,1,34,77,7,210,
370a208a-f64b-47f2-8960-7fa0a8c0af44,Mickaela,57,47,75,76,78,40,373,
e846a24a-ea8d-4460-80a1-675f42c479b5,Mickala,28,12,23,13,99,82,257,
01d769a8-237d-4932-8630-311fedc1a5dd,Mickayla,4,31,11,65,87,11,209,
70cc110f-4175-4f2c-8b42-b84cb04bc811,Mickie,84,17,27,50,13,79,270,
40b73183-9a11-4f34-8fad-e6e20a127a1f,Mieczyslaw,11,0,45,88,50,57,251,
b1279610-8fed-4564-96c1-44a8b26b483b,Mieczyslaw,47,59,38,73,38,56,311,
918ca889-f76d-4aee-b389-5078ebd0d955,Miguelangel,18,64,18,31,7,26,164,
316f16c0-7ab9-4834-96af-44a6dcd884b6,Miia,55,20,90,93,84,32,374,
ae1d4f65-124d-4a44-8d38-94eb9e098834,Mija,40,74,13,48,73,30,278,
042da6cd-f101-4989-bb5f-d57f3c9c172d,Mija,58,50,7,79,26,5,225,
29c7ad7a-a800-4e7c-b278-a11486bae270,Mija,4,65,30,95,31,89,314,
f9129be9-41b4-4a01-a031-f9909326488e,Mika,14,96,23,26,17,1,177,
adcaec5e-2c34-4c94-935e-5e70ea0fcc01,Mikael,19,50,55,16,76,80,296,
67028c29-4fc1-498f-a162-5434f0336a6b,Mikaella,47,21,18,55,51,4,196,
a6b428df-e13a-4e34-8f47-0d80f6a4fc0a,Mikaila,27,67,31,56,60,45,286,
9fc82e28-74cb-4988-bfef-a79bfd4abf70,Mikaya,57,62,86,66,19,91,381,
82a0e95e-bd50-453e-8156-99dd21ca5251,Mike,4,85,36,25,80,72,302,
9543be0d-47dd-40bc-aefb-2f80c61a3f0b,Mikeila,7,50,47,1,90,44,239,
942c0a77-cce6-495a-b4b1-50335433cc29,Mikel,3,66,87,26,72,53,307,
ec0229bf-aa4b-4554-bb93-6cffdc4e1fb4,Mikesha,45,68,73,1,4,18,209,
29b48401-6916-44de-9434-d352d0e234bb,Mikiala,32,61,96,96,34,78,397,
2237c301-ff49-4f68-b53b-4f646a4cc414,Mikio,88,39,17,7,62,75,288,
e375d205-91fe-4c46-9051-7ab53538fafd,Miko,30,17,30,36,25,44,182,
33829311-76fc-41b3-9991-deae7ab19843,Miladie,11,6,18,47,97,68,247,
c73bc695-28a0-4ff5-b7fb-5863ff8b74e5,Milagros,56,38,94,38,40,91,357,
61beb151-6114-463d-99eb-bbc8665ddb94,Milana,11,68,97,71,51,1,299,
876def41-766a-47e4-be59-50ad0f783e66,Milarain,84,83,62,79,24,38,370,
0bdafe8e-adc4-4b29-8fa9-134ade4d2950,Milbert,78,74,75,69,20,28,344,
537284ee-f2e8-4743-9888-a7fe3eff52a9,Mileena,77,92,97,99,16,69,450,
6b7cea33-4fa3-43f3-8874-03998075ae2f,Mileidy,86,92,75,39,92,37,421,
0b49198e-6e44-473d-bd63-478d6ee4ff17,Milenka,47,4,33,53,24,49,210,
65c47d34-072f-43cd-bf13-ffb1025c0174,Miles,34,55,23,69,84,77,342,
234b98f3-400e-45e4-a517-0efca662773c,Mili,7,87,6,28,94,69,291,
a7bd7519-a1a3-4525-be39-394e9e83737f,Mili,60,71,2,26,41,36,236,
721422a4-ea52-4e50-8b53-848f1569b5da,Miliana,55,65,4,26,57,81,288,
c05ed8e4-771d-4bff-af1e-c4adf55af65a,Miliani,89,88,71,60,20,54,382,
f2e941ab-8081-4de4-b0d1-e4e6b27600ca,Millen,64,1,18,60,6,59,208,
3424a8c1-c983-4261-a899-4dc4f73a2c91,Millen,30,33,2,73,45,35,218,
6c32508b-a13b-480f-9138-eda511589d79,Millen,95,36,95,35,9,58,328,
e6548534-8ce9-47f1-a177-2b582ede2cc8,Millette,13,5,77,94,20,18,227,
7aaafcb1-17d3-40af-b00c-882d4cab634c,Millie,14,85,27,20,25,76,247,
0431fded-91c7-4fc3-988c-11dcccffdfdc,Milton,53,10,28,67,5,22,185,
8b48778e-1091-40d0-8731-0e4f1cdff453,Mily,18,44,32,73,66,95,328,
1fef2a5a-83fd-4891-9d3f-1ea722b2f105,Min,34,71,5,13,71,59,253,
38bb1154-540c-41a0-92ca-0d22af0ce3d1,Mina,20,33,49,65,46,26,239,
12fa52e8-b2ed-44e8-a18f-be61d1073e9a,Mineola,25,87,25,81,34,79,331,
f7ba975a-2993-483e-beea-ea5e1594fb08,Minette,68,1,59,55,99,7,289,
64f3d068-4fb2-470a-b3ce-c79433356429,Mingo,68,64,77,39,100,27,375,
860a4d1e-c35a-482b-b694-8a513804803f,Minh,58,2,0,27,48,69,204,
4fac8323-561a-4849-a142-1b055bc2930b,Minha,100,72,33,6,91,59,361,
6e26e2ac-ce07-40cc-aa82-1a0b0f2cc38f,Minnette,73,63,75,57,93,61,422,
52c915e7-f117-44db-b165-7d95b432a1f9,Minnie,86,77,48,45,44,66,366,
5e3b6ac0-2144-46e1-a8e4-0e1b4dc616e8,Minnie,56,72,23,43,43,0,237,
085be245-c647-4f30-8cb7-7a46daca02f2,Miosotis,77,64,42,61,0,11,255,
67ac7179-37b8-422a-a3f2-696237d2525d,Miquel,84,23,29,100,37,3,276,
cd07487e-391c-4906-9094-ee30c0a22b8b,Mirabella,54,26,30,98,50,23,281,
92360355-32de-48c1-a468-1fa457c9e6b9,Mireille,22,16,23,93,7,71,232,
365f74c1-6449-49d2-98d3-c2d689c11496,Mireille,39,53,65,59,34,95,345,
16debe75-bac8-45cc-a819-5cde388b4400,Mirely,86,52,54,90,35,56,373,
02eddbbb-77b2-4b82-88c3-42e4edb0f9b4,Mirian,72,19,64,1,81,23,260,
d5967285-5bce-45d6-9d88-4b603daef6f9,Mirna,32,95,83,75,13,69,367,
090dca57-8f97-4e4a-a7cf-ab56baecc10a,Mirta,14,75,100,38,89,9,325,
f164ac86-5b2b-4f33-b3b0-0545276fc05e,Mirtha,50,27,76,33,96,90,372,
f0012549-695f-4978-8475-8ae3ca9cd949,Mirza,2,88,50,76,82,80,378,
7d72a177-3e09-472d-9c85-a70845977e3e,Mirza,32,69,26,95,38,41,301,
f3d0234e-7845-4e61-9e1f-f698bbd46b07,Mirza,56,81,51,85,99,43,415,
9079a3fe-bf44-4658-838c-dbc8b076f12e,Misa,69,2,58,91,76,35,331,
3c2c7a74-b32a-406a-94aa-a12edb920ae2,Misa,82,38,54,19,10,8,211,
dd258be2-9535-4e55-bf72-cb50bf8af2a1,Misae,7,58,12,61,40,10,188,
89af87f7-81f2-4770-a1af-fcc2e0446133,Misae,35,79,16,48,86,54,318,
14d39452-11ce-4dd7-a6c4-5d518ff44b43,Misao,9,100,0,22,8,95,234,
08d623b0-db5a-42b2-9e50-249417dabd40,Mischelle,48,75,37,12,77,46,295,
b54c0021-402f-45e1-8d0b-2d666df6315e,Mishel,73,91,24,62,10,80,340,
d20531f7-3a01-4245-9025-ce28fd964bd8,Mishell,56,9,19,38,48,84,254,
dec973b6-1fa8-4c04-b4a3-6da93a7bb81c,Missi,46,53,20,65,2,77,263,
88047376-f457-4bcd-b396-bdf54d06c10e,Missouri,99,16,36,17,94,3,265,
04f5fec1-78a7-4c77-a729-5efb676cb2ed,Missy,56,48,54,18,55,67,298,
16a8c7d2-affa-4a7b-9c9e-eb37ec7b9038,Mistee,99,57,93,22,86,29,386,
c041cfc3-7ac7-4485-b87d-7d202dfa0be0,Mistee,33,51,29,51,40,84,288,
292fd476-db18-45f7-8268-6a9e2a33703f,Mister,29,50,33,37,63,41,253,
3b541840-64c7-4c4a-82ec-fb9f8d9b5a0c,Mistica,15,70,81,12,62,2,242,
9140fb34-403e-427c-8e15-c3ce2f0da498,Mistica,0,70,74,56,48,7,255,
b9742c0d-dd1f-48e4-9c13-ace27658548c,Misue,1,27,84,94,33,94,333,
844d91df-a991-47cc-b3a0-01860bcf18d4,Mitchell,45,49,95,97,19,7,312,
0eeebdd9-c814-4982-8762-24bb1338b400,Mitra,40,43,12,24,31,63,213,
902beac4-3acf-4a91-ac32-4f934034e410,Mitsuo,91,75,12,53,85,54,370,
b1d9f13d-5342-4137-baf7-cc8188cc211c,Mitsy,51,74,51,96,76,36,384,
ecfd2292-09ce-4cec-8153-7071c04366e1,Mittie,62,80,92,54,50,30,368,
d599d149-cf74-473e-9b27-c20d48562373,Mittie,81,18,72,36,35,64,306,
d468929e-cb20-4e24-9359-4fbd81b9ab20,Mitzy,1,51,79,49,11,78,269,
b1ee31d5-16fd-4a2f-9296-c78b3ccb4c08,Miu,65,31,74,89,38,69,366,
ea93694f-54e8-410e-82c1-4fbef26f3613,Mixtli,77,98,56,70,12,47,360,
9e28baef-fa97-4892-8d98-9635a1832d03,Miyana,40,78,80,38,87,94,417,
bcf73abc-8a82-4275-a3af-bd1030ce6b2c,Miyisha,84,80,20,83,53,64,384,
85935b5a-261c-4a3d-b0ae-a4387ead04cd,Miyoshi,77,53,23,89,0,80,322,
110efe25-a550-4a63-9c74-18f81be24ecb,Miyu,86,96,61,83,72,5,403,
ca97c4de-c78d-44f3-bbfa-f083f3affc76,Mizuki,58,33,96,68,73,62,390,
c8c53953-8b19-46f1-94b3-428a450bb158,Mj,87,95,47,25,79,40,373,
c846e73e-bc42-40cd-b053-81b50602e6c7,Mkayla,50,4,42,49,92,4,241,
26144e93-92fa-49d8-aac0-925e3b10402d,Moana,89,59,4,25,42,79,298,
51492b82-27bc-44ec-b4fa-6ed5aadf34f7,Moeshia,10,91,18,59,37,60,275,
e47900aa-2c59-48ec-985a-f7a2f32534da,Mohamadali,0,20,38,33,98,96,285,
3cb6d32d-4d4a-4ba8-b471-2f53c6d1780c,Mohamadali,23,81,40,16,11,22,193,
25db8c0f-91e4-4904-a6ab-205fcfec1a49,Mohamud,15,43,97,56,34,52,297,
5431ac6d-8419-4203-9494-660ecfaf540b,Mohid,32,89,76,20,7,47,271,
083eadc6-f5aa-46a2-a5fd-f5a58bead464,Mohini,13,79,22,76,4,39,233,
9e785add-d38f-4599-8abe-3dd022490ee7,Mohit,0,45,5,9,93,18,170,
743b387d-f380-4804-9a14-74184748f231,Moishy,32,8,51,3,93,30,217,
5e5d6f28-5fa8-4934-8390-09f34067b2aa,Moishy,48,82,76,8,80,38,332,
228d2a7a-19cd-481d-9aec-b29c9abc4be2,Moksh,24,2,9,9,73,77,194,
dc136d21-17e9-4155-bc09-867ebd34af22,Molina,62,10,76,55,8,100,311,
18a283f1-8dc1-4040-80c2-f3a6fb8c34a2,Molli,5,69,16,92,33,69,284,
520bb866-2a87-4811-a796-466d1c91522a,Molly,96,60,2,25,46,93,322,
8207dd86-af9f-4dd0-a0ff-46658a8ab051,Mollye,41,59,3,21,34,84,242,
7dba5e14-8254-4bf5-bb3c-719e309e44c3,Moncerrath,24,18,32,6,18,76,174,
1be5d2ad-98b9-4a6f-a5d9-cf16e0ade090,Monchel,50,63,12,74,48,32,279,
7860a54a-3793-439a-a521-03196669e311,Monette,69,20,89,25,4,3,210,
db08f29c-2142-44f4-819d-30413d0785bc,Mong,9,32,6,20,7,8,82,
98465ea6-cf94-436d-bdf4-a2348af1368d,Monica,34,16,90,9,38,81,268,
be9437f0-8ed5-48c1-8beb-6fef445b3aab,Monigue,10,14,36,91,96,49,296,
65ada742-bd8e-40eb-9c60-da96c41629a6,Moniqua,74,73,84,25,38,72,366,
adb7d36b-a4f6-40d9-9ff3-d8e5a4fc35da,Monique,5,84,42,84,34,42,291,
e56b3661-c3b9-406a-a4ed-bb07932d31b5,Monita,83,39,3,20,37,83,265,
50a06ae6-314c-4610-b9f1-059b60210738,Monson,22,89,35,9,5,1,161,
1bb94096-2cad-40fc-abe4-421ec47568b8,Monson,62,33,47,29,54,1,226,
f9edeb39-1fde-42e6-9033-46fd4e9057de,Monte,85,70,41,22,62,59,339,
bfec427a-36bf-40a9-91ac-ba288513ed74,Montez,89,86,63,66,30,42,376,
e3a21141-d676-4422-b4fd-4ea555a2bf9f,Montravious,4,12,91,6,69,90,272,
fab2f9bd-2c5c-4f05-ae2d-ece2c38c8a8c,Montray,80,17,0,17,80,68,262,
bab94761-6fac-4f56-a251-bda4377ea63d,Montzerrat,5,51,27,6,81,78,248,
945204b3-edaa-4e71-88cf-61d513b4bed2,Monzelle,72,54,91,85,88,35,425,
f0908f37-cba4-41f4-9536-deb222dfcbbe,Monzeratt,0,25,74,56,50,64,269,
124512dd-069b-4154-80aa-a58748afe90b,Monzerrat,58,14,24,27,62,6,191,
01a0dd53-6dca-4b39-bf3a-51bc99cda79b,Monzerrath,38,35,97,30,20,13,233,
b21478af-3a9f-46fd-ba08-4923ed3fc19f,Monzerrath,79,94,75,46,39,78,411,
81ec5afc-9327-4183-8eb0-c682ba34ec95,Moraima,89,54,16,53,72,11,295,
02052261-e230-4cb2-968f-6b0fa9cf367d,Mordcha,41,91,22,95,22,67,338,
4a562aad-91c5-4415-954a-88fa9e6688d6,Mordecai,90,6,24,6,31,52,209,
0d40245e-c234-496b-8df2-90b271c69b9d,Morghan,48,94,19,25,52,88,326,
a84f7e49-b7d4-453d-942d-b0c78a682a6c,Moria,67,35,61,79,38,28,308,
0c46ca8d-548e-495e-85d2-422cbb3f4b0a,Moroni,88,14,71,19,71,57,320,
b0c05e6a-24ab-48dc-bd88-5830f7f195a0,Morrigan,21,61,19,80,15,53,249,
857e7ebf-23c1-40c8-adc0-82de602b898c,Morris,63,39,60,58,49,26,295,
fcdd5fee-71c7-4fdc-bcee-b74b69516a02,Morrissey,79,89,47,22,57,94,388,
6e296c04-e450-480d-ba3f-f5df53000e01,Morrissey,50,99,6,69,36,5,265,
d0af318e-92dd-4167-9f80-dccb5cec0fbe,Morton,45,50,47,89,85,68,384,
991d3bde-b7e0-4bc1-800c-a1e03466f7b3,Mosby,47,35,13,44,76,13,228,
fc0e2a74-f32e-4db5-9b07-06fcfe62e8b0,Mosella,98,67,73,90,64,3,395,
006eb03a-d7a8-4275-b27e-d7ca61becdbc,Mosella,39,21,24,63,8,66,221,
147458ec-a3ea-47a8-a1d7-f4299b140bec,Mossie,4,81,14,37,23,63,222,
2d1d6dc3-9b8e-403d-9c8f-7bfe97966d66,Mostafa,58,23,8,97,42,21,249,
2ea5596e-8895-45f0-b910-d47cfa2e652c,Motty,29,94,26,14,6,52,221,
8cc44d3c-fa9a-4386-835b-e26b1dc9f550,Moussa,3,4,7,33,58,96,201,
94e78439-ac34-4360-ba85-dcae49fe2476,Moustapha,33,2,25,38,57,26,181,
dc1df6e3-aa63-4b27-993e-b24171633b8c,Moxie,62,62,54,78,62,74,392,
625ebd7a-a5ac-47cb-8085-fee22c25da1f,Mozella,87,31,78,37,40,54,327,
48e51375-9b39-40db-81ca-91f99781802d,Mozelle,65,35,35,15,53,67,270,
3e38207c-e946-480d-baff-e6145d2a1c44,Mozelle,30,71,43,47,5,27,223,
8f3b46a2-f540-49f2-81d8-b2fa4478edef,Muad,58,40,25,71,86,6,286,
f67f26dc-9d3a-497a-912c-0245c3c5775b,Mui,50,66,59,43,49,30,297,
ba50271f-27bf-4648-8c3e-4a63b59f02a6,Mujahid,31,33,26,80,20,49,239,
aa4a9392-fe69-413a-a31e-6db567a8b395,Mujahid,50,25,67,2,66,11,221,
6f5e4fa7-ac8d-416e-8302-96ae0a7ebee3,Mukund,65,71,37,89,25,17,304,
aca422bf-478d-4ed4-900c-474f4db2f7df,Mulan,40,90,1,65,82,97,375,
e0196068-6dbf-41db-9e24-7bbfde2940d7,Mulki,32,35,39,71,95,25,297,
396afc7e-51df-4697-8b08-697e6a29c25d,Muneeb,3,40,63,48,30,54,238,
376434e9-208b-4c4d-aea7-91de81d03ae5,Munira,47,4,49,53,57,9,219,
7ddcd9b0-e52f-4995-adb2-ab4a338132ed,Muntaha,0,32,76,45,67,21,241,
8635b656-d343-4f8f-b035-46d45d7e3dd8,Murel,73,38,14,76,88,19,308,
d0e658be-8b8f-45e6-a75c-2b207d63f96b,Murlene,21,43,77,57,44,56,298,
4388bffb-b46c-47bc-a9f6-b5e395a28b78,Murlene,13,28,1,29,10,59,140,
788c5812-b396-4526-9767-17d215586688,Murphy,20,10,70,52,43,39,234,
cf800e90-5920-429c-8056-04d666df8d7a,Mursal,85,82,25,48,40,74,354,
36075604-ce40-488d-abe0-68b6c75a1a5f,Musab,69,3,65,49,40,52,278,
bf30b5dc-8a70-4b5c-8620-d2284bc9c540,Mya,99,78,9,3,31,22,242,
614d66be-7e65-4633-abee-ea9c7cc2a651,Myana,17,98,43,76,90,24,348,
568608a6-8d3b-4d2a-94b4-499dba1b7143,Mychal,48,51,94,85,7,26,311,
2423dea1-5300-432a-8f74-c954b6165c0e,Myer,31,25,22,95,58,76,307,
d3fd3867-11eb-4868-916d-6b4343c29026,Myer,34,46,56,17,84,67,304,
58c5580e-a037-4d82-ba63-432e7ed70660,Myisha,27,80,17,51,25,69,269,
2141a9ba-4636-4643-82d0-fd09649e5efc,Myka,9,33,0,21,79,41,183,
b7b02555-6fab-4cfa-8482-1c1023be04a0,Mykaela,98,90,43,88,34,42,395,
c69754ed-fff1-41e3-ab4a-565b47cdea78,Mykal,33,94,42,41,67,46,323,
fc880dee-78ae-4314-8820-4688c9277f0b,Mykala,35,48,65,0,41,54,243,
fb53b46c-8670-4ffd-b3a8-2cbee3593e45,Mykalah,20,98,72,60,84,13,347,
9b453fcc-cc12-4e0f-9a80-4b24fb4655f5,Mykalah,73,64,86,37,22,96,378,
539a6794-94b0-4c6f-9da8-7dfa9d371623,Mylan,46,99,33,13,52,93,336,
da10748a-141e-40d2-b709-0856891d9196,Mylea,3,68,61,71,96,80,379,
08105634-62e2-4ec6-94df-4ff43fcebbfe,Myleigh,68,80,31,69,46,98,392,
0d573391-c29e-4013-a6f2-0d5c0b3908c9,Mylissa,54,24,54,81,87,0,300,
35645f8b-8496-448e-a8a3-008f5e7073ee,Mylo,90,33,87,21,96,95,422,
1657292e-0bda-466d-bf83-1a9416f5e444,Myong,70,76,86,76,65,23,396,
0b83b273-be62-47e7-9f81-666d907a0996,Myranda,86,56,44,33,7,73,299,
8e604bc2-7e4b-43cc-af85-447ddcf93f5d,Myron,86,9,18,49,2,55,219,
b8be5466-6c59-4a5e-9038-bfe431370b38,Myrtis,73,76,44,37,17,47,294,
c7aa2fe4-1620-475d-ab21-930ba301c4b5,Mysha,82,89,33,51,72,2,329,
af5efd4f-32a8-40b9-9b3b-5a6b7afc1a3a,Mystica,69,16,88,14,12,35,234,
74d2d039-40ab-4c79-a073-a74d9bdd3cc4,Naama,76,37,5,44,6,48,216,
754aa0b8-23b2-4e46-b5dd-5f90fe643657,Naasia,41,24,45,46,87,43,286,
3c61b6c4-ab24-4eea-8d18-3561e49e30f1,Nabeel,51,52,24,21,98,64,310,
62333d8c-1523-4977-9ea1-09a5a2d65dde,Nabil,45,29,0,95,79,45,293,
cfbedaae-c3b3-4d6f-b817-e6d99d7bacdf,Nachelle,79,63,8,11,80,20,261,
b218e374-ef9b-4a7d-85cc-136a54b73e41,Nachman,57,79,15,23,46,15,235,
107495db-6c85-4f05-9718-e6185607a12e,Nachmen,10,75,70,57,16,31,259,
debcd3f7-7ec9-4030-a57e-48f6fc98ec19,Nadean,60,51,48,29,61,64,313,
23509ba1-f717-4c0c-93a4-d6535ee2937b,Nadeige,1,84,84,100,14,39,322,
064b27a1-f32c-438d-8856-55b934a5f770,Nader,54,42,15,77,89,45,322,
86eac83a-9267-474e-ab9e-9c265640c240,Nadina,19,0,34,78,76,86,293,
688dee2b-73cd-46be-965c-213ed2e57266,Nadine,49,97,22,53,78,40,339,
a552dc32-e140-46af-a90f-8d825958fc00,Nadine,57,20,79,60,2,9,227,
8e8ae40a-26ce-4e28-854c-5481de5e5ac5,Nadyne,14,25,23,91,13,62,228,
281a62e4-7467-4440-a04f-b6c4179dd494,Naeem,62,73,50,32,30,61,308,
4b46a2b2-9708-42af-8952-7e02cd0e635c,Naeema,100,82,96,93,3,93,467,
027c8c5a-b207-4275-82a8-be23ee352e8f,Naeemah,34,30,20,21,72,2,179,
0d69a9f7-01d2-4c44-9b2e-46504166ff45,Naevia,86,99,18,64,56,28,351,
9112476b-18f4-4b39-9c81-359a954c1a9f,Nafeesa,11,93,50,66,34,2,256,
d3fa9600-1cc2-45ee-9f3b-1b0097186ff5,Nafeesah,99,99,22,40,61,69,390,
fb826109-715e-41d0-bbc7-54f2bd80004c,Nafis,3,84,31,21,78,12,229,
e973599f-2acc-4519-a958-1e99a8acd611,Naftoli,2,81,82,6,100,51,322,
81b7661f-d3e1-429b-8aec-abb2a018f5f7,Nahal,44,22,75,16,38,40,235,
f28fe37a-fbd4-4f1e-b512-860ae190a361,Naheem,96,39,69,93,38,90,425,
fa80eb70-26eb-4a24-8a3d-4fc59d1c0a23,Nahriah,67,34,94,99,17,85,396,
daeacc46-3496-4939-aede-d0a986694825,Nahshon,22,40,68,90,4,70,294,
e5741e5d-a964-46c0-93dc-d4ecb11e8b3e,Nahsir,13,3,32,42,84,18,192,
b3a87f47-2f98-4221-830a-78f5b6b35a3c,Nai,84,21,32,48,40,4,229,
56c99a3e-254e-4039-9b52-1a401eae3a85,Naibe,3,26,24,70,95,59,277,
1c3896bf-aebb-4e0d-a615-6508c269d31a,Naida,76,30,10,17,5,51,189,
f4ad1397-6cb4-4fe9-9cfb-35253f705ef6,Naila,26,65,81,9,57,89,327,
e5d6fd75-8fbb-4c9b-8177-d0a891d28cc7,Naila,34,69,63,19,24,68,277,
7ac44796-a3e0-4af7-aa9d-76081bae5d66,Nailah,44,41,66,98,78,38,365,
f4b238e7-f4f7-4ee8-8b17-22217773d741,Nailah,52,90,76,49,99,78,444,
30e00100-6876-4920-9641-008fe6237eae,Nairoby,47,9,36,12,52,44,200,
7ef0a4bd-e599-47f0-ad46-90f6a46e8eff,Naisha,98,2,52,82,39,44,317,
05ab9fa3-14ff-4ee2-94f0-15713bbd2d22,Naithen,60,10,28,10,29,20,157,
1b0649a9-2b75-42bc-bdb4-de3f6a076841,Naja,26,88,27,92,28,63,324,
7dc84901-243c-4df0-8f70-cf0bbd2fbfc0,Najae,10,29,50,65,17,98,269,
47f790c6-6322-4f2b-8291-94eae25fae09,Najib,90,36,91,15,89,9,330,
53768fb9-1e4e-43d9-b58b-8873487a3fb8,Nakai,59,29,18,91,34,6,237,
0daef458-38f0-438d-b124-95bbd07e19fb,Nakayla,52,27,85,76,0,21,261,
745f0e87-81f7-454a-a236-4c5e18d6cb74,Nakeshia,78,83,15,57,45,40,318,
93300c63-284d-4dd4-96dc-0420de5efaae,Nakeya,5,43,8,9,11,25,101,
f0c0b0c3-9ecc-416a-ab63-c7e64005bc1c,Nakia,92,28,40,35,43,2,240,
00952c92-d09c-4240-a783-b8ea189a87ea,Nakiah,46,40,40,7,12,99,244,
d803bed1-9b5a-415f-8dfa-d3675dc4292d,Nakiah,35,56,21,100,84,93,389,
f25c3743-d428-4aa3-8edd-e1bd01519ecc,Nakita,60,62,56,37,53,21,289,
5aec8170-9db3-4b96-8713-d4b7401e55cd,Nakiya,67,62,72,39,68,78,386,
dd287a4f-5897-49fb-9da9-db184b84a9b9,Nakya,3,87,43,61,24,40,258,
7f1564e0-0603-430e-8bf6-5cf290d89837,Nalani,50,44,14,70,21,54,253,
d94c7751-19cf-44e8-9df0-d393ee9f8fd1,Nalu,78,52,86,80,35,10,341,
d5694108-f8be-427b-a1d9-84be3631605b,Namrata,25,62,82,79,44,76,368,
890fdd0b-b452-4f47-9b0b-9ec4297e14ea,Nana,42,59,86,72,48,93,400,
84dbc38d-b684-4788-9ece-b5200b5775ee,Nancee,41,80,41,37,64,87,350,
ddcf147f-f59d-42b3-92c8-447702f1c74b,Nancee,76,4,97,35,99,62,373,
fcb59e6b-19a1-42f9-a7c9-28bb8f7687fb,Nancey,40,53,56,53,99,54,355,
f558a498-6810-4fc5-bf52-083e0594a29f,Nandan,94,55,83,21,25,75,353,
e83d171a-4a2c-4a95-8569-88ae8527c4fe,Nandita,37,6,37,51,87,39,257,
be0b523c-3d27-4cee-bce2-64f3a21a3931,Nanette,28,43,64,45,58,63,301,
52560a7a-fb26-45d1-a2c0-a079d2062894,Nansi,9,22,60,82,31,6,210,
9d9c3a36-dd47-4a64-ac2b-0fa851d5a1b4,Naomia,18,27,78,6,86,45,260,
ff4d4ef5-e8b0-4d48-86aa-bff3449e3332,Naomie,19,33,42,64,90,65,313,
d9d3b8b0-be15-4cda-8e25-0dbbebd09099,Naomie,51,52,55,80,35,55,328,
809d6fda-6857-45cb-9ff8-1bf93d3e79ce,Naquasha,80,74,59,11,6,9,239,
e9c4d745-6369-4cd8-869e-b56a0891f6f1,Narcedalia,68,73,82,1,38,17,279,
18acb90f-4aa8-4fde-893e-c62a3c48798d,Narcisa,23,92,34,95,22,86,352,
e2a38d0d-8555-4159-853b-51b97466036e,Narcisa,95,88,50,40,79,24,376,
d6e00437-e280-4380-927e-062b1085f7b4,Narcissa,87,16,83,49,45,37,317,
933eac54-79d6-4e08-9fce-6325feddc54b,Narda,14,89,84,43,68,21,319,
9f0c3252-bc00-47a9-a225-92e5c58eeef4,Narda,98,90,66,18,27,29,328,
b75d39cc-c797-4b71-b73d-f33fde25bdd3,Naren,79,47,42,80,30,33,311,
f989fecb-6399-4abe-a7b3-771af8c59187,Narice,68,92,56,21,58,52,347,
93038f29-6cca-4550-9448-04a8f300f144,Nary,22,62,54,83,49,12,282,
e9b49894-a7f1-4347-ad8f-cfe39d19440b,Nary,33,93,58,65,72,75,396,
b5a0c41e-c21b-4d29-b043-105e66082abd,Nasario,16,22,14,39,49,89,229,
e62a3066-3d0b-4edd-8531-5db3c09b4e14,Naseer,43,84,31,82,49,55,344,
1f7ba1fd-f7c9-4728-ba59-81ef4eb98392,Nashali,76,39,8,69,32,94,318,
476726e6-55e4-4114-a62d-920136816546,Nashira,5,17,97,65,83,5,272,
e692ce6a-c9e3-4215-884e-020cd88d8a64,Nashley,94,56,15,50,15,91,321,
e6d8bbd2-7616-456a-be73-2e85f37079b4,Nasia,22,22,55,92,39,28,258,
34d747c2-a817-4467-8fb1-65a361ba2ef3,Nasiah,73,46,68,84,37,30,338,
a5807e17-9512-41a7-ad51-8d1247c251eb,Nasiah,77,40,27,8,95,69,316,
93396fde-db41-46e0-a040-4a26dd472cd1,Nasif,29,90,75,38,18,38,288,
b0e1d854-accc-45a0-9d3f-643125ffb496,Nasif,74,79,10,84,4,80,331,
e7b0a82b-ca1d-4c0c-8b06-573aae2d98b0,Nasirah,21,13,28,73,37,32,204,
dceee50e-2935-4dd6-88a0-4511956f4e95,Nastasha,54,2,19,22,39,42,178,
e3b003e3-4238-4c9f-80e8-eeb1124344ad,Nastassia,51,49,69,42,2,64,277,
c212ae19-240b-4b63-8199-a77082ed52ad,Nastassia,60,73,10,80,91,22,336,
a80f341b-1048-4237-b2a8-e04ac6768422,Nastassia,2,39,34,36,86,53,250,
2d8d2d33-7309-41cb-a349-6c6cffb9f71e,Nataki,48,43,95,57,35,51,329,
3a3176a9-3ba3-4e43-8b54-d7e7c6549308,Nataki,23,63,88,57,97,44,372,
8e625aa4-8660-4b27-bf2d-70fac9538e54,Natale,3,86,48,63,66,29,295,
05be3df0-6ee0-4f99-a433-792da9d4d0d4,Nataleigh,9,20,38,79,16,27,189,
9280a487-e97e-497b-8e81-6d23e8da47ae,Nataley,93,96,13,98,77,76,453,
db8ff2db-51c0-4348-8845-e6789ce87c41,Nataliah,87,14,97,98,5,75,376,
ab264041-f8b3-4039-9dfe-aae49bb69167,Nataly,38,17,71,51,23,34,234,
7348d9ce-ba82-445b-9b8e-d240b26f5b38,Natalya,49,42,73,34,11,75,284,
d094c465-f918-4771-b1d9-639f1f0af797,Natalyn,49,31,54,42,68,7,251,
19acc883-a041-4c2f-969e-9c8fed1c0da6,Natalynn,11,57,15,73,91,32,279,
f2bb855e-4edf-43af-8760-56867d06d126,Natanel,75,96,12,36,13,84,316,
a96009a6-d0d9-40cb-b42d-d9dab7f1eee3,Natanya,25,4,97,84,77,45,332,
0ca7ef23-f833-466a-809b-f565f4c3a003,Natanya,90,80,48,33,19,88,358,
59055543-38f5-407d-a09d-c25af3c713df,Natashia,9,94,35,72,42,11,263,
70b94d8e-30e8-4dff-a246-3940d1af52fb,Natashia,26,24,67,58,95,5,275,
35d0ba91-b483-4f62-84b5-3c17b5511b49,Natavia,57,98,59,41,4,20,279,
b56f920e-bd01-4a42-a87c-5129f069eebb,Nate,58,14,73,71,88,61,365,
62b20f61-1b13-4537-8c78-0d952dc97620,Nate,30,42,36,16,0,66,190,
1674aadd-8b2d-44d2-a608-c17b5ad54b55,Nathalee,56,46,28,72,98,44,344,
51b39643-bacd-47f9-af5c-acf0d21c22af,Nathaly,73,14,65,58,12,15,237,
43bac0b7-160c-4528-93b9-fe1f702f5adf,Nathanal,33,85,88,88,96,23,413,
49b5bede-fd5e-4671-a564-34671d02e90b,Nathaneal,54,40,43,32,41,69,279,
d97157d3-4b1c-4bbf-ab0e-23cf0a06960c,Nathaneal,36,18,32,20,73,34,213,
d6d2bc13-c437-4d2f-a242-0e7f59975360,Nathanie,58,90,99,79,32,70,428,
80d13b6d-9d31-48c8-b7ba-8a440a4d7581,Natina,54,47,94,82,16,96,389,
c2d462ae-3a08-41e8-a7b4-758f0303d96e,Natosha,50,92,60,95,10,39,346,
9fffec99-ba6a-4fe4-adc9-363a3531be20,Natsumi,37,62,0,35,77,64,275,
cb4835b7-825a-4bf6-ba13-e7ecc9bded65,Nattaly,26,97,43,52,76,62,356,
31bb5155-f89f-4536-a0a6-7004b0358e52,Naveed,81,71,8,66,56,26,308,
93937dbd-e8a5-4e11-b821-1668ff06f613,Naveyah,46,48,83,22,89,88,376,
d7321dc6-6d84-4fd7-a36e-d4222300872c,Naveyah,0,74,62,46,88,14,284,
20ff87ec-e794-44ee-bf66-0fab86891fdb,Naviah,37,51,98,5,98,39,328,
35000b3e-ba04-4c97-b394-ca0ac13d9687,Naviah,2,51,44,100,21,49,267,
b29e024c-5e2f-47a3-ae77-a1907c07df2c,Navin,11,31,12,90,45,14,203,
c52b2577-d6f2-43f4-839b-bc5230899773,Navjot,89,3,73,51,64,96,376,
885368cd-43c9-4740-9b32-9750701b704b,Navjot,78,67,88,19,24,48,324,
b191f69f-1035-42b1-9b29-a06a6b968194,Navneet,44,35,63,94,39,10,285,
ffff00eb-7513-4916-8b1f-f85305f0ae05,Navreet,33,39,86,59,36,59,312,
9bb86814-4073-4621-bef4-efe2fd611f2e,Navya,74,2,14,52,21,23,186,
fdee12a6-3948-478f-854d-cfd6d83b94e1,Nayelis,89,31,86,2,86,77,371,
b8fa7345-7eaa-49cb-b492-ee049308fb69,Nayely,11,21,93,89,26,67,307,
94f6bcc3-4d89-4d1c-8501-a4ea05c6a87d,Naylee,57,6,46,24,82,55,270,
bcaf38da-8938-4b27-8927-dd968d31eb7e,Nayquan,50,62,66,52,11,31,272,
57cf0683-20ae-4292-92d5-3164c289967f,Naysha,80,45,52,79,22,47,325,
f31b2842-2ebc-46df-a1a6-d2722c1b90fe,Nayzeth,64,0,73,64,63,22,286,
b1dca593-4e3f-4b02-90a5-39e1aea14570,Nayzeth,87,5,99,96,1,1,289,
0df8ab64-33c3-4ed4-a3f8-27f9aef300f8,Nazar,43,59,55,57,83,58,355,
5eb6acfc-7e01-4abc-910c-5427376b0a5d,Nazaret,55,0,90,19,81,73,318,
db7fe5d4-7724-43c0-90f2-1ba8d6134f76,Nazario,68,81,92,62,77,84,464,
29e5556d-d93f-43e2-a4c8-337411123215,Nazeli,12,49,36,49,97,51,294,
18d535a5-58b1-4645-b02a-970fce011dee,Naziah,7,81,73,56,7,96,320,
7af824ce-0249-429e-b9ab-3fa7b0fbd5ba,Ndia,56,74,87,86,59,80,442,
a19578c5-84f1-4698-b6e6-23289f043149,Ndia,67,90,24,36,37,30,284,
72cb16e5-9a10-4d26-ae3e-aea717369f2d,Ndia,77,15,53,35,5,52,237,
edfac285-8247-42d6-b6cc-f0834a22d441,Neal,86,63,35,61,84,35,364,
9f60397e-a885-497a-9323-f2969ad93c21,Nechemia,81,23,88,66,42,61,361,
4c1af4a1-65e1-4546-ba40-f8d111ab44fd,Ned,65,80,92,29,31,99,396,
b5fca708-bf22-48b2-ba15-94be8151a02c,Nedved,78,65,40,55,30,2,270,
23f62187-dc9d-49b6-95ea-6e7a2e987a77,Needham,70,38,31,41,28,18,226,
198ad91a-bd2a-4506-89ae-f34185655b09,Neeka,92,33,46,17,55,5,248,
d2c1f5a9-6c34-4f0c-8e7d-b7feeb69d037,Neeko,30,54,75,40,34,26,259,
b7b38d77-889a-4f47-8c4b-3909f4ce6a7b,Neelah,59,93,74,20,36,44,326,
f424ca90-9393-4eca-94fc-d69fe391ad9f,Neeraj,91,46,63,63,78,86,427,
4d157b1e-bb5d-4ed1-b649-75baec9d8714,Nehemias,81,77,71,91,62,32,414,
d066486c-0d18-42ca-b3f6-7b53b9dfa169,Neil,52,32,95,64,52,75,370,
89ff6e34-27f7-4a61-819f-aebe0ac43918,Neithan,29,22,69,67,60,81,328,
f9c3a421-4640-4f60-84ae-2f35d61422bb,Neiva,49,71,82,7,59,10,278,
20468a58-27aa-44be-b23e-c8adfa72f0fc,Nekesha,100,10,39,10,100,32,291,
b20c67cb-3141-4f52-a4e8-92e2f58fc2a1,Nekia,45,92,38,38,67,11,291,
acc00fb4-5427-4dbf-b390-26b27c0da4ff,Nekita,59,83,34,78,16,42,312,
e0f11ceb-f85d-4a43-b7af-b3be856104d9,Neleigh,88,5,45,68,91,60,357,
35ac470d-6390-4bfc-a2de-58fb2704790a,Nellene,47,73,65,72,56,73,386,
1e3cf324-6504-403c-8bac-aafc1fabe592,Nellie,45,94,32,1,38,58,268,
716d23b4-5ee7-496b-9ac7-14aed8726b58,Nellora,32,27,40,17,27,97,240,
f3840123-97f5-43b4-8874-4b07d524ac8c,Nelly,85,27,74,91,11,43,331,
06ae0a04-40a0-4504-b8b5-53c909276337,Nelly,65,33,35,8,84,51,276,
979a6c5c-6834-40c3-be2a-0013bb80ab8c,Neng,97,17,36,97,43,23,313,
6de9265c-d629-4f2a-80c4-ca77653e2dff,Nephtali,46,65,65,46,60,2,284,
398ef307-632e-40ea-af78-cb313355633b,Nereo,77,49,48,58,63,65,360,
e9f7d994-2123-4d23-bea0-ada8427be31e,Neri,20,21,64,81,12,41,239,
ac2245d3-3821-4fe4-bff4-e46dc8a9d6d8,Nesanel,52,45,55,69,100,11,332,
07e73789-7b0b-4cab-bb01-6fcbb946fa9f,Nethaniel,95,69,36,16,16,7,239,
fde2c6a7-9fa2-44f3-a5cd-ab7ca38e9f1d,Nevada,28,10,23,50,69,93,273,
3601559e-b308-46b4-af1d-59988864b861,Nevaeh,60,58,87,72,19,96,392,
319d6327-5696-4cd5-b809-f18e8a067c2a,Nevaeh,6,41,68,15,30,61,221,
ca1280d7-0035-4fae-a6ea-cc337e9fb87f,Nevah,75,10,66,54,49,83,337,
32a002d0-49c8-43f3-b7d2-cca1925b40dd,Neveen,44,48,77,34,54,25,282,
3948f8ce-52b9-4c33-a522-b935ef9d1ca1,Nevin,51,34,88,44,67,76,360,
a19f7941-d542-43a2-8bea-30ec268832bb,Newt,0,79,35,87,28,55,284,
e0752e06-9809-4476-8a2d-46c47be52fce,Neyda,6,85,31,16,84,42,264,
8f56a6fd-066f-40fc-b543-44194606ea4a,Neyda,85,70,1,41,52,100,349,
0bc8f949-6f06-4abc-a9c6-df0dd33b96a8,Neyland,69,44,94,87,98,74,466,
601bd25c-a799-44eb-a336-e5847fb984dc,Neyland,73,20,53,69,77,6,298,
1184902a-cbd5-4fb8-a92d-1972257930ca,Neymar,17,12,62,78,66,90,325,
67adc46c-e82a-4869-ac1d-ff0059a1ddd7,Nga,35,19,38,54,98,4,248,
f9aa1b21-bcf1-4cc3-b95c-d801a6a402da,Ngan,98,14,84,39,6,90,331,
b0b43932-954e-4362-b681-33727dfae7b0,Ngozi,37,21,32,72,100,9,271,
eef050df-d795-438e-83da-97dc7bc2d2aa,Nhan,95,10,88,68,40,31,332,
0fecbb2c-df5c-4b9b-89b1-e76697330bb6,Nhi,81,46,44,58,22,37,288,
10b5aa65-ad18-46a2-bcf6-9aecb3563430,Niah,7,66,17,98,89,22,299,
3eb77be0-7535-475c-9591-7e8ca073bc34,Niam,61,13,49,100,7,44,274,
433968f7-5bcb-4289-8535-557616c10b40,Niccolo,21,0,52,9,38,38,158,
7e3c7899-ce81-4bf3-be54-436f48c0b3d0,Nichola,27,57,69,60,89,55,357,
1bdb9bce-62b8-4641-8c47-87a6559c79a3,Nicholai,24,83,46,7,9,36,205,
687ee505-eff9-4247-aeb5-8dae1933f293,Nicholes,70,52,63,90,52,63,390,
81dbbbe9-7fed-4659-b163-f9cb15a8dcbd,Nicholl,7,49,87,68,47,61,319,
5652a50a-242e-4372-bcba-a9443ee82608,Nicholle,85,57,86,58,23,100,409,
30bb4724-0b47-4728-ac17-a9786546383b,Nickey,81,73,25,22,77,58,336,
4757684d-624b-488f-8e1c-956cb6de4297,Nickey,50,100,31,27,38,63,309,
003ac1d9-3179-4a13-8b87-75a8336473f6,Nickholas,0,29,7,74,5,30,145,
2e6377b8-dba4-464c-b6d5-3df0ca01ac46,Nickholas,60,68,56,69,83,41,377,
06666036-f22c-443f-a0d9-4f84ae14a7ca,Nickole,32,53,93,29,52,69,328,
194d9940-0bd9-4860-9c10-2c7d04295b39,Nicol,85,85,14,58,18,100,360,
13d5c3f0-557b-410c-9769-f2347613c268,Nicol,4,65,31,62,46,43,251,
21ba08e5-74e1-4eb9-8436-9d50bf552e2b,Nicola,57,32,19,45,100,72,325,
a99545b3-2976-4fb9-83ca-9b54553c4104,Nicolai,95,21,79,51,62,21,329,
4741b819-deb4-47c7-a984-cb819f1344b9,Nicolett,25,5,47,52,96,22,247,
483298f4-9437-407d-b03f-cb523c8f7b99,Nicoletta,99,8,46,19,43,32,247,
4ab02254-0ebd-44b9-9ca3-e3d6d3f359f5,Nicolette,63,17,96,86,63,20,345,
305cde89-b395-4ba5-a6b2-936bc460823e,Nicolina,12,20,31,94,54,81,292,
63b2da5f-216f-4b47-9105-8f3ca95e3dc6,Nicollas,69,59,1,52,33,18,232,
4b243a6e-fd8f-4e23-8dab-1f074a8cf63d,Nicollas,93,1,48,41,52,92,327,
d7e1e690-8bea-4e4b-ba35-f62607805495,Nicolle,3,48,9,96,78,60,294,
4b048639-5ed6-46d0-b874-74fd71d37c38,Nicolo,42,43,67,50,70,45,317,
ffedd6d0-58b8-480f-9ae8-cd9de62bc53b,Nidal,88,76,71,82,30,47,394,
8ee3a386-9504-441e-9249-d6118daec85d,Nidhi,60,55,81,47,80,99,422,
6a403333-b446-440f-b90a-19c6bd7b7c6f,Nidhi,23,12,25,19,82,90,251,
552e1506-041b-40c1-8b05-a7217cc3587c,Niels,54,43,47,95,59,57,355,
81044963-3d78-46af-a2b9-e7e2c197059a,Nihal,81,2,60,69,42,21,275,
72ffe3c7-0d8f-4e07-ba6b-8e4dfee0b5a0,Niharika,27,38,91,40,52,45,293,
42b05830-61e6-41a2-a03b-f2395b1717af,Nik,18,76,34,23,46,92,289,
35c68008-538d-480c-88a0-0959b64efc06,Niki,78,47,66,41,37,30,299,
8cee69b5-4f3d-4cea-875a-a3007f23bb93,Nikia,36,38,25,35,31,9,174,
cecca053-6a1c-490b-b2df-81846e562b5c,Nikia,53,90,36,89,28,67,363,
706b57ce-7f08-46d3-98ff-ee8f69c177e5,Nikko,5,15,50,77,39,16,202,
1b9f6a58-e59c-431b-90f9-2e96b8744e06,Niklas,47,86,36,3,27,29,228,
5741d794-d0c7-435c-9632-999c83064453,Niklas,49,19,99,91,34,38,330,
cf054eca-e02d-4080-b669-3437ec3e89cf,Nikol,49,92,68,49,90,30,378,
cbabc76e-c9a0-4604-8a29-e30d9b9e7622,Nikola,27,68,54,64,90,82,385,
abc360fb-624d-4e2a-97b7-50dd54ad52ff,Nikola,50,4,16,28,34,50,182,
979c9937-42f6-4c5d-a199-e2cea1cba6ba,Nikolas,40,0,98,13,66,91,308,
6fa02ab1-c6a7-459d-b856-99920836e8bf,Nikolaus,97,21,37,69,99,58,381,
dc3f6ede-0aac-4b2f-a5b0-82ad262fd07b,Nikolette,83,86,28,53,63,69,382,
e2ab3a25-aa3b-486c-92f6-d09342734732,Nikoloz,89,66,50,19,62,28,314,
5c664008-cab4-43a4-98af-bd16554f812b,Nilani,83,0,46,19,23,40,211,
70a6101b-2f4f-493e-bb0f-d3e72ab20f6e,Nilani,20,72,85,11,91,10,289,
df3a4594-61f5-4882-a94f-fbcb247e92cf,Niles,3,65,66,70,35,43,282,
0140c92b-69a5-43c4-b84e-54c7923d2c45,Nilson,85,95,92,72,59,73,476,
42d4956b-c554-45d5-9fcc-de32b398ce60,Nima,3,96,1,88,31,2,221,
4035d560-2fcd-483c-a1b4-67a01ff65ed5,Nimco,70,22,74,71,80,77,394,
f0c5d37b-d4e6-4f4a-b641-9764bbe39055,Nimco,6,26,94,58,9,21,214,
de07855c-4ca7-4587-86dc-37b5dd72d0ae,Ninette,86,3,84,2,82,53,310,
16058386-a679-4bbe-9128-2afb4b81c4e5,Niraj,84,33,33,4,78,60,292,
a716ded7-c50f-4ea8-aa44-cb9c21163d17,Nirali,55,79,62,26,67,58,347,
347cb5fc-6e78-4dcb-a9a3-d956d2c61b33,Nishant,23,10,35,76,14,39,197,
92159195-5c3e-46c0-be12-73d1e52fa3e0,Nishat,34,88,6,89,51,82,350,
8e3e1212-30b8-448e-ab11-d6617eaf99fa,Nishka,69,8,12,48,24,30,191,
45228b1b-9034-4d4e-90bb-9969367d385b,Nissim,53,41,67,95,25,34,315,
cd3a6abd-febe-40c2-bb7d-844b10e98ed5,Nivia,79,53,7,14,47,82,282,
a9c48965-345b-483d-84f4-ba692430ddc0,Nixon,68,28,30,42,73,16,257,
47d211f2-e18b-4484-b3eb-79126b57a6fc,Niyana,80,42,14,60,54,21,271,
87119bf2-fe94-4161-ac19-ba38d01ff03c,Niyati,44,96,32,88,16,46,322,
a62c8009-54a0-44cc-8150-3e2a9ea3a547,Nizar,83,3,47,99,14,75,321,
12c5fed3-e624-4f11-abf3-8707d74d3ed3,Njeri,9,80,31,26,97,15,258,
9bef8f66-573a-4886-a489-82c055ae8bc8,Nnamdi,90,59,69,87,57,3,365,
3b992db8-9dd1-49e5-98bc-cd32fd326662,Nnamdi,42,66,32,34,20,77,271,
9fc06b14-ebdb-4ef4-88c9-f96823932ce7,Nneka,56,55,0,86,17,34,248,
d077d5fe-2fc6-4607-aaba-f0d7c4caa10c,No,17,82,62,74,52,34,321,
fa2a13e9-ecf4-4883-bb21-829d4fef07ad,Noa,45,73,91,33,54,26,322,
1d46c3dc-5d9d-4251-a388-6a04ee4ec8ed,Noam,60,11,60,44,94,55,324,
1c1a4704-5f20-48fe-8a73-9b21e108f923,Noble,74,90,56,95,18,23,356,
c3faeb4b-50a0-4b08-843e-86ac43e7174b,Nobu,56,77,85,5,73,4,300,
68bbf18d-7a8d-4818-b0ba-b6dd697a94bd,Nobue,76,82,33,65,22,94,372,
a6e4cfa1-426b-4685-8b62-cb39d6d41adf,Nobuo,94,0,80,41,79,46,340,
67f5ac09-9c91-46e9-9e7e-74788f8d98ee,Noe,90,71,18,76,68,28,351,
c7dc629f-6701-4553-a190-4333efb71445,Noelani,46,91,77,57,61,55,387,
b896cab2-a5ef-4122-9c5e-053a94b13a4a,Noelia,28,99,20,17,86,8,258,
1f026de2-7899-4128-8198-8092b78d20e5,Noelle,44,33,92,14,22,28,233,
9798e4be-6350-405f-aae2-a6ccfa5f7550,Noga,0,76,41,16,97,47,277,
99931b2b-dda8-4abe-94c0-df61751bea8e,Nohelani,39,91,92,0,39,66,327,
07951521-7f68-4b6b-beaa-f5083f6700d3,Nohelani,44,97,30,75,75,74,395,
30797d73-3f8c-4ac4-b6d3-7e7330b26fb1,Noheli,58,92,83,42,28,44,347,
8472bc93-70aa-4417-b222-e4bbf0d0605a,Nolan,18,28,24,79,82,83,314,
244db07e-6948-46e9-b345-f19316db0ac6,Nolberto,54,7,27,52,79,13,232,
57ca8c69-3f77-45b3-8725-3a92956f06f9,Nolen,70,58,8,81,88,26,331,
541a8cbc-5bd0-461a-a19c-b65909aed9d7,Nolton,34,18,25,45,77,3,202,
b986ac97-9523-46b7-b770-ca10cb12390b,Nomi,7,73,86,50,79,99,394,
d7cb382c-e1fb-45a9-94af-e7097c80b0c8,Nondas,41,26,28,90,49,30,264,
84324772-9435-456f-8111-aa24fa1f67c4,Nonnie,49,54,53,52,74,21,303,
97e6faa4-d653-4ee8-b70f-ca834f5721e9,Noora,75,33,76,65,67,42,358,
40e13ba0-9f49-4ae1-b2d9-15d402accc91,Noraida,16,76,34,95,58,93,372,
56a68325-bc77-4b70-b00a-9ca817d4f9f1,Noralba,42,77,82,94,18,80,393,
b6892333-8cf1-4f73-a821-4fc4a4d1bbc8,Noreen,56,17,47,69,68,38,295,
9897094a-a83a-4c51-ae77-5ecb1773dff4,Norene,66,64,65,61,46,82,384,
4c05736b-d981-4a26-9346-8fdb4b80f0f4,Noretta,55,68,82,64,57,93,419,
71c027d9-37b6-4633-9fbb-8f28326d0131,Norfleet,94,53,40,12,57,36,292,
6dcc2a26-eb0f-4b83-bea5-4caf3016ffeb,Norita,29,65,16,62,89,45,306,
dc3d7878-38e2-4a30-96fd-8139ec91adb0,Norm,3,89,47,35,65,22,261,
91456c07-fc93-46b4-803f-c8f0cc0a3ad6,Norm,16,59,78,28,81,8,270,
3e269650-faf7-47df-97e6-f336ca6215a8,Norma,7,66,70,95,5,91,334,
b11a4030-12bf-4b81-853b-0a74029b8ad1,Normalinda,34,100,93,71,63,15,376,
3a725728-346c-469c-8725-970a6aa9f31c,Normand,72,93,63,35,12,35,310,
241a8172-689e-43f3-886d-4e28fd6e8c98,Normand,55,60,28,65,86,93,387,
2e7d261e-17f5-4934-bcfa-16404212501d,Normand,16,88,7,59,16,2,188,
903d2e56-ca05-4d28-a6eb-3148348272a5,Norval,27,35,22,60,47,33,224,
816b2c93-2122-4e3c-bc6e-e3fd1efe329d,Not,85,36,68,78,51,9,327,
8a26ac46-f2a1-4f65-850f-e8cc2a297b8f,Novak,55,97,97,79,60,30,418,
3afa5905-c77f-435c-a51d-addf5ae3d61e,Novalie,58,79,86,25,44,88,380,
58ae80f3-38f8-4cc4-a727-1a5655bba00c,Novell,72,99,20,17,21,77,306,
10a1de8c-e0c9-4482-9f45-838636a378d2,Novella,39,0,79,4,77,13,212,
0458b8a1-1d08-47b4-b694-1ac788b6612b,Novice,26,13,12,70,84,17,222,
8b369129-c13b-417b-b534-250d29317ac5,Nube,0,90,31,84,86,45,336,
95fcda16-0906-4803-995b-a88745feee00,Nur,61,87,10,7,56,7,228,
74e324a1-25c0-4c3c-8f43-fbb24a7e9f8c,Nuria,53,98,17,21,26,41,256,
3b780eb8-30ce-4390-bd9a-3226c7764823,Nyala,42,59,44,48,6,97,296,
36d20abb-afe4-44c1-835f-a396a255aa74,Nyala,48,61,2,9,96,34,250,
867dd6db-0457-4f87-b301-4a760537bd8a,Nyasha,91,11,74,45,55,2,278,
838b838f-323c-466a-99af-0af13fda70d4,Nyasiah,44,49,55,61,65,89,363,
237b0e65-bb7a-4ed2-a7c1-fae75c310c21,Nycere,39,93,65,66,84,45,392,
5cd91dc7-219d-4617-9bbf-00746daa9547,Nycere,12,43,60,27,1,41,184,
794715a6-7b66-4716-8452-6a320a82d7a3,Nyemah,43,68,36,63,27,27,264,
b7228894-17de-4467-97d5-e41602a5e292,Nyia,78,1,28,62,31,14,214,
8f29d822-a661-4a87-b70a-d2290a7a65f7,Nyima,30,57,99,5,87,24,302,
ff3f2f19-1935-4542-9bbb-2f605a5a6953,Nykerria,49,4,37,67,57,81,295,
4888de11-48d6-447c-ba82-b2e958424fff,Nykia,16,1,16,19,78,9,139,
767e5aea-8cdf-454f-b7da-c70231d1757a,Nykole,91,41,10,8,81,13,244,
70b54dc2-b1d8-43a8-8551-2749a1c4f3db,Nylia,100,77,60,82,37,19,375,
1784929f-38a5-497a-b476-a690b799dd75,Nymir,7,1,41,92,32,12,185,
17245c4c-6e9d-4819-b1df-8cd788a5299d,Nyshawn,57,87,38,10,22,57,271,
e48b42d1-14cd-4e6c-9ef2-3bdf51d92ca3,Nyssa,38,57,45,90,67,10,307,
732bdc07-303e-4a56-aefc-80b79164b21c,Nyx,63,59,28,82,86,55,373,
d589f5da-6e94-428c-bfb4-2f1b9bb333f5,Nyzaiah,24,41,63,38,34,53,253,
a76a16eb-eef6-4d9c-a103-8866a24cd02b,Oakley,27,79,72,76,9,10,273,
5ab91a6e-9b0a-4190-9203-38da07353921,Oba,5,48,77,48,53,96,327,
e40f5f4c-f3c5-4582-94b7-4948f4335bf1,Oba,55,26,21,55,91,47,295,
300c2530-ea14-4b24-860f-b920ed47f388,Obi,51,88,42,9,26,19,235,
03da4f81-743b-4737-ae81-1cdefb7ca0fa,Obinna,81,36,84,13,68,97,379,
cfb5b625-d66e-49b0-b856-ffd4354c78a0,Obryan,68,88,80,24,3,96,359,
6e44be44-28ad-455c-abae-274f61a11e61,Obryan,74,7,23,87,83,78,352,
378ebb06-05bb-403b-8ad7-e459d6cfd38a,Octave,54,51,60,13,21,23,222,
7ce90644-2a6d-4dd4-a9b6-21b897ebdde4,Octaviano,34,33,39,23,67,70,266,
4baf76cc-084b-41f6-8eae-1453d15e0574,October,93,100,15,79,59,3,349,
9600c582-fc4e-4205-8f9e-28c2d72ccecc,Oddie,8,7,91,20,100,60,286,
42222fd2-c250-4228-8147-41658541369a,Odell,23,78,93,86,78,37,395,
a8f8d89a-83b6-4a37-a1b5-4ec64b80be11,Odell,28,25,17,14,52,41,177,
c1e8c46e-19b0-44b0-8932-18dac4bec7a7,Oden,65,2,62,1,61,87,278,
ea89e665-eecb-4b14-a677-2517557ff25a,Odena,58,57,63,10,73,41,302,
22eea57d-dfaa-4ba8-a189-629ac9ffaf63,Odette,59,98,92,41,68,92,450,
693731a6-19d8-40d0-827b-54ee839b23e6,Odie,32,56,69,95,11,3,266,
6ad565c5-1b25-40c2-bc38-22ea93cf36e5,Odus,74,2,40,81,32,5,234,
ad2e2518-5372-47c1-96c9-ba9f3bd73679,Offie,67,9,72,94,82,0,324,
56456027-e310-456b-bcd6-a09f90b82db1,Offie,28,55,86,61,43,24,297,
07e6fd25-8ff6-4452-ac89-a5853a64366d,Ohm,11,87,33,75,56,46,308,
88260dab-cc5b-4d71-b649-c61d77a6dc7f,Oiva,72,14,8,18,63,64,239,
b80825e2-94ee-45dd-a716-305782b6f5d1,Ojani,64,74,64,43,22,49,316,
f38bed57-58d5-4985-b542-eb3d61d3bc4c,Ojas,81,72,72,90,96,29,440,
0689a111-93ae-4333-81c5-7e0b33123955,Okey,70,50,8,20,73,29,250,
90992e70-7d81-49c1-8933-c8f25995c8b9,Okie,3,22,84,38,64,65,276,
30bc74eb-ac57-458f-99ab-61237db2165e,Oksana,100,56,91,81,82,2,412,
7d709e6f-db48-485b-a803-6f88dab91a75,Olaf,47,52,59,70,59,92,379,
0a367b07-d4b4-4c93-84ad-97eaaee55d99,Olamide,31,35,21,15,78,17,197,
f4d4383b-3f54-479a-a634-4a1bf7fc3f71,Olar,50,20,28,27,78,18,221,
f7a8abce-5b24-4225-9405-2d0e0bf37b8c,Olar,87,15,47,26,77,87,339,
3b7a6759-eeae-4dec-b7e0-8442917b8488,Olden,29,88,39,20,88,5,269,
327aefb2-a961-466f-9d45-2050dc0124f7,Olee,96,69,89,95,62,73,484,
58957bce-2a4f-4204-a705-b56232524f99,Oleh,0,99,97,27,3,100,326,
fc6dab95-6642-4c70-bf92-ed5d87b32b8f,Olen,77,48,60,32,36,63,316,
3e0c87d3-fbc1-49f2-8a1c-f54bd3e92a9f,Olena,84,31,92,97,6,89,399,
fbaffb94-3e63-43d3-8a5f-36c20669fa17,Oleta,82,79,96,93,87,78,515,
cdd754f5-0368-4110-8722-ba4838635c4b,Oletha,91,55,77,57,64,59,403,
a71ccb30-2b6f-457c-bde3-89fde35e9103,Oletta,85,66,37,94,35,34,351,
38871aae-7584-4190-8d15-940e660599f5,Olevia,19,49,46,67,19,47,247,
041a65ad-66b7-4dd7-8d8f-953a8c25b9d5,Olga,47,37,18,36,34,94,266,
501d3f29-9866-472d-a670-3d90200767cd,Olina,38,19,76,11,28,15,187,
14d7173f-7025-45c9-a7a2-27a01820e9c9,Olinda,83,76,51,75,82,98,465,
232e9b79-bf9c-43ef-a3c2-6ca12a0da06d,Oliver,82,75,26,1,10,42,236,
5a3e5228-8404-42b0-9377-1820718a9ce4,Oliverio,54,59,97,56,30,57,353,
0c0c8a31-a8fb-4490-91cd-098591a460cb,Olivia,89,76,18,36,38,80,337,
74c89bc8-2997-4c73-a525-ad698fff160f,Oliwia,27,34,79,16,89,32,277,
3dfd1090-ea1c-4fde-9441-303512e1ff86,Olla,36,2,88,0,2,90,218,
e230e1c2-6dd3-4ccf-aa9c-f7799b555894,Ollie,8,90,26,71,53,84,332,
8d92c1df-61db-42eb-b238-c3ab19d93a00,Ollin,30,85,42,12,1,94,264,
fcc4712f-a0fa-40ff-b16d-5c3186fbb0d0,Oluwaseyi,89,47,5,35,64,80,320,
d42feabb-b8c6-46a7-9664-57bbbcda16b5,Olvin,63,0,47,49,23,36,218,
a15903c9-074a-4d1d-9acd-5567935f5050,Omaira,97,53,53,85,11,23,322,
5b611c82-594e-43ed-82dd-b1454a4e1785,Omaira,50,42,81,42,95,58,368,
605dd41b-fac6-44c9-8915-34b116213ba4,Omar,15,44,17,37,14,45,172,
2d3e3f3d-4389-4717-9f7c-b49a33240b8c,Omeed,77,89,9,87,41,34,337,
48f178a7-9213-4397-90b5-c4f070510f59,Omeed,78,31,42,79,7,10,247,
6f29b137-fb9a-4d81-96bd-fd0973845f6f,Omer,85,6,52,27,56,29,255,
5af1d9e0-5219-4f7b-826c-d534d64a5aab,Omero,80,51,11,31,30,91,294,
8290486a-62f2-486e-b2e7-625e51e9c034,Omero,98,3,46,70,96,76,389,
d65d6623-4c81-4db5-9913-c94980ff0e49,Omie,78,68,3,51,50,99,349,
3ab6a3cd-8769-4e00-beec-ee96c2bf46f8,Ommie,14,14,88,67,40,59,282,
a3142f8b-2719-4e3a-832f-bb7203035495,Omolola,9,6,51,49,7,47,169,
db701fa5-da57-4bbc-8c8f-fd9ca82c9725,Omunique,94,28,7,61,50,93,333,
ea10ad0b-e1df-4afc-8aff-43fe6c37f4c4,Onalee,14,48,6,48,10,32,158,
9b73e527-d3fa-421c-8e89-43d22adc0f81,Oneida,6,20,71,68,47,68,280,
d11d2d0c-f7bd-448f-b58e-dd304fb1f4e7,Oneida,32,73,100,28,58,46,337,
4082456b-31cc-4629-8bba-5c13daedea42,Oneil,63,57,67,74,17,7,285,
929ae2be-4761-406f-a087-7e5e2852df6f,Oneita,15,72,25,53,33,84,282,
eda4c2ca-beb7-440e-bbc2-81f463a74bcf,Onesimo,85,27,24,74,11,48,269,
44508849-fad4-443a-96f0-18497ee2825e,Ong,42,68,6,16,36,39,207,
c0e080a9-a536-4dc8-8660-250fb776e512,Onika,69,13,85,27,84,18,296,
439b8483-17c6-46a2-bc1c-bf8287670d5d,Onita,29,28,36,51,70,92,306,
11e5dbfa-7206-48a5-922f-100122abb999,Onita,39,41,40,45,36,18,219,
ccb6047d-50f5-4460-8a72-9d000f0b3440,Onyinyechi,14,2,91,37,90,64,298,
f8a71c0c-b383-47ea-abf9-95598adeecef,Oprah,27,40,44,9,26,100,246,
4de9cd7f-16bf-4129-8af9-dfd4fa017a97,Oran,90,69,39,92,76,71,437,
099d5800-74aa-4aa3-9ffb-a3907a7e3474,Orasio,37,83,36,17,19,59,251,
a25387df-60b6-4c02-895b-fe333a977ff7,Oren,15,98,55,40,22,18,248,
e83343b3-848d-4e83-954c-4a05551ae072,Orene,28,97,8,69,19,25,246,
9d52e449-f801-4e9a-8672-e104239099ee,Oreoluwa,43,62,76,89,99,30,399,
ad23ae5e-730a-4827-8cb1-2ab1a7343a93,Orfa,19,64,41,54,21,90,289,
b9b29d80-0d04-463b-9890-06f9414541b9,Orfa,16,100,71,82,47,13,329,
b62f0114-1790-4236-aed5-3aa9d0a4a1a7,Oriana,74,2,55,8,25,92,256,
d0b58e02-ed93-454b-8d18-461bbb511cfa,Orie,72,33,8,5,85,38,241,
864c13c3-d908-4464-93e3-f0acfe8094e0,Orlando,96,21,81,71,16,90,375,
b7078020-8be0-4cab-b39d-b3684e49e644,Orlean,26,14,20,31,74,91,256,
aebbfeef-6c9c-413b-ad85-2e2af2b6581e,Orlena,100,69,37,50,62,45,363,
bc2ca955-a0fb-4c94-b364-762df4e7beb1,Orlena,29,57,57,88,58,23,312,
e153b84e-87e8-491d-bd99-ba15f183825e,Orlena,58,1,50,18,83,28,238,
cb6965bb-3c41-4217-a79a-5c016f7bfab9,Orma,29,64,63,16,37,18,227,
f2e321ca-f855-432e-8f5b-f343f0f419bd,Ornella,76,74,99,47,23,94,413,
da11545b-1d97-4404-80c3-48c8cef1a1fc,Oronde,76,32,16,4,90,11,229,
a2288ec0-8b37-4be2-bddc-7510897b37d0,Orquidea,78,49,50,25,69,11,282,
f0f28166-3700-47e7-9766-c994d705e119,Orquidea,75,28,91,76,69,6,345,
145701eb-f902-46cd-9c57-47be10c5ba00,Orry,77,14,24,59,7,46,227,
356dade6-2054-4664-9d34-d9fee299c338,Orvella,39,7,91,99,25,97,358,
842ceb1d-ef18-487d-8861-fd487678757f,Orvilla,83,81,90,41,4,72,371,
00780b29-0ca9-4c02-9246-604d1e14be66,Orvilla,4,32,3,64,31,67,201,
2393862e-4332-4f0e-b3d2-281f57c3ba2c,Orvis,13,36,29,57,1,55,191,
c3e33187-8aa9-438b-9761-4a77b504af4c,Oryan,71,42,21,8,10,30,182,
3554a255-5f61-4e36-a585-767eeceed811,Oryan,71,25,86,27,16,2,227,
5e73d227-5a1f-4b3d-987b-da7a6ca8deae,Osa,28,11,41,29,44,13,166,
5c762e73-472e-47ae-b242-748e7b44f122,Osama,64,7,87,24,1,78,261,
b84f0dc7-41ca-487d-bb70-c7bd234a4c42,Osborn,59,92,14,10,95,92,362,
bab22ea2-5e9c-41c2-8d3e-1a08055b1cab,Osborne,11,23,36,16,21,50,157,
7a3eab9c-a72f-4f18-b408-320b3de3d936,Oshae,35,24,71,86,35,58,309,
9bf33765-1a0b-4605-bc60-dbaa9445e2ec,Oshae,2,6,69,19,21,12,129,
80bd504a-3186-4d27-bb0d-af28b014a0f3,Oshay,98,21,30,72,18,44,283,
3cf062d6-e31f-4578-a690-cf7b4d21adeb,Osie,38,20,26,77,72,51,284,
296dae3d-1c04-4728-b2db-20e019854d3b,Oskar,14,79,53,79,79,4,308,
927a1d2e-41e4-4951-b4f9-1c4e23d367e1,Osman,35,85,72,38,20,68,318,
5f8260fb-ef79-4380-829a-20bb3a87c8f3,Osmara,6,36,91,20,33,79,265,
94dba79f-24a2-4012-bf57-240d7ec523af,Osmin,22,9,96,19,20,52,218,
05053f41-805b-4ca7-a3d1-a9cb367236e1,Oswell,86,0,20,12,33,66,217,
42f10d4c-9c37-4a84-ac0d-d9a0713563c1,Otha,79,26,94,68,74,66,407,
35a4ff7b-8d7b-403f-9e65-b392a76b03f4,Othel,17,73,76,63,3,71,303,
9312e99d-8843-44ed-91b4-e549faaf7a4d,Othella,12,50,83,51,78,99,373,
bbb99844-c815-4057-ab3a-e936fccdf81a,Othello,37,100,23,59,7,85,311,
0927eca0-c136-4a2f-ad2b-96c3260dfab0,Other,37,11,83,22,70,95,318,
6502b6d9-c9a3-414b-9356-470213f5319c,Otila,19,84,26,80,79,99,387,
c1795204-c530-4893-a941-401acab42bf7,Otila,80,99,32,79,27,28,345,
cb789c39-40f9-4b43-80f4-b9bf571abbba,Otilio,89,69,88,74,47,71,438,
3386e8a4-8aa1-4ab7-a461-830bb32ca0d5,Otoniel,19,67,33,24,31,3,177,
0ebe8285-4c02-4624-a4d5-016df3d2ae5e,Ova,77,9,21,60,11,57,235,
587adfad-6f7c-4c87-982a-cdd7d59d6e0c,Ova,29,91,21,47,28,22,238,
d67d58cd-6062-479d-a9c1-ca1e869ec092,Ovadia,78,23,0,73,9,83,266,
2253ffae-38e4-468f-806e-9cbe54bdff34,Oval,3,68,66,35,25,22,219,
b96bfdb6-9ef3-4816-8d5c-40f62e85566a,Oveline,53,36,67,69,70,70,365,
c0ebc19f-21f9-43b9-ad7d-6c82bc45e2f5,Overton,34,73,18,57,26,40,248,
9486de30-7572-43ba-979c-a07903b9c0f0,Ovey,86,45,31,61,58,55,336,
4a2085bb-7a03-4d83-937e-09ef1dcf6061,Ovidio,67,57,62,2,41,50,279,
cbec3379-9760-40fc-9ee1-2885d90fe76b,Owens,92,71,35,100,26,69,393,
c0560c87-6e23-4ac8-968a-302ffe6e31a7,Ozie,11,33,46,42,62,54,248,
f34ed813-9c82-4691-b61d-9eadad5ed2b2,Oziel,96,77,9,17,1,14,214,
032f2704-08c7-4f58-af5b-94d920a3ec6c,Ozil,34,29,50,63,81,49,306,
a76cfb74-a9d8-4d21-a5a3-de77612af9d1,Pablo,33,62,16,10,100,74,295,
39540bf4-5200-423f-85f4-5bc59e3aaea0,Pace,76,66,77,40,15,8,282,
cc437ca0-bd1a-47f7-a1db-1c4ffbcc317f,Pacen,58,100,55,67,49,75,404,
abddc257-1ae1-44a3-9016-851cc372c920,Pacey,24,45,36,57,85,53,300,
5751625a-eeef-453f-83a3-c234e5cd0ead,Pachia,35,24,16,39,1,88,203,
835fff64-dbc6-49fa-af8a-a91403f86743,Pacita,5,5,53,66,96,57,282,
174ef717-4d36-4f49-9c9b-4f1f1c3c578a,Paden,37,41,16,84,52,57,287,
40664db0-1427-464a-b016-a55be4da6e73,Padma,57,16,50,47,43,74,287,
de0ac0d1-d67e-4cce-8856-d73a34791a34,Padma,84,22,100,45,23,39,313,
e6a0549b-a65d-4c36-a097-282259100f3b,Paeton,39,24,89,0,26,62,240,
321fa3f6-9027-41e6-b843-cb3001c2b82b,Paetyn,89,51,56,31,7,30,264,
15e78821-8d26-44de-9fde-4c3f9f844312,Page,46,97,54,57,37,23,314,
884ecc16-aa41-4bbd-b024-2c7b355264fb,Pahola,81,53,27,3,68,35,267,
51b77825-8007-4b80-ab66-a107465d4b22,Paige,67,9,77,74,51,69,347,
43e709dc-6ff7-461e-a6a0-a01ec5cb93cc,Pairlee,7,3,15,69,25,54,173,
b8b4f2b9-6f89-47f5-9b21-d4d3f2526304,Paisleigh,42,96,72,1,71,60,342,
3aac0266-6bf4-4fab-ba2c-975a56c4f4f7,Paisleigh,36,27,60,74,75,1,273,
e0e72fdb-5976-4720-ac81-13b5804153c0,Paisyn,49,32,55,6,50,25,217,
d4224b0c-82da-48c5-867a-c198418f8163,Paiten,41,46,86,21,30,19,243,
aedc0d97-e9ba-46ab-888d-96ed3a0c7848,Pajtim,92,37,36,91,89,32,377,
a54b1163-f0b7-44ea-8b92-30b779de4643,Pakou,2,34,2,82,47,37,204,
8da4fcf9-bf51-4f0b-a392-27085e455ae5,Palma,92,45,71,82,22,77,389,
d1a28d0d-63b2-4dce-82ab-f683dd2fb6e3,Palmina,45,84,66,11,21,6,233,
da41228f-e3a2-463e-8123-b23d3c87c70e,Palmira,94,87,92,15,28,64,380,
7a8cdf77-7a0a-4b77-82e3-6f59830500fc,Pamala,56,63,20,67,9,49,264,
103f32da-6995-4974-805f-cf26793fa5a7,Pamela,54,36,71,41,35,99,336,
810788dd-22ee-4f36-a2e9-cca5267c4be3,Panagiotis,29,82,36,97,62,18,324,
72ee3b0c-5f8c-4982-921c-c7e5654c2638,Panagiotis,85,60,41,52,68,99,405,
c71f8591-4273-409d-8c3f-3667fc32f0e3,Panhia,1,12,57,54,48,67,239,
0f38b780-4ccf-402d-a387-d1e7f5e1f9b6,Pao,55,67,65,98,82,54,421,
4ce2434d-170c-485f-8574-44d8eb8ddbda,Paola,31,67,64,54,91,66,373,
f2b17298-6639-42cd-b436-a2be996ea16e,Para,32,73,7,21,78,57,268,
63754051-80ab-4425-b166-f6e696fc20e7,Parisa,13,63,61,64,65,55,321,
8d975c3f-3a26-48bc-85c1-1f7e561ea5af,Parissa,63,87,20,76,5,4,255,
2299136d-a797-4a8c-a9c2-b332fc061304,Parker,19,100,83,20,22,15,259,
841c1bf1-f819-404f-a588-2fe7c0742f04,Parker,80,81,87,57,41,79,425,
917c4754-67b2-410e-a638-134b1b400767,Parker,8,87,50,3,51,71,270,
6125b939-b9de-4e26-89a3-b174291576d0,Parlee,100,91,57,78,21,34,381,
75d7480a-c838-4bc4-8116-5c71c943dd54,Parneet,16,71,17,28,100,91,323,
d77e62f8-f1d6-4674-8467-691496c405f5,Parnell,97,13,62,77,82,32,363,
6de1f0cb-a57c-413d-ac85-53eb7335a835,Parniece,89,18,78,81,58,50,374,
fd9dffe5-b1be-440e-b049-3f64d37bf4a6,Parrish,54,57,24,14,63,53,265,
d8efc7e0-96ab-412b-8bae-761a03edb395,Parrish,33,71,76,18,28,22,248,
1037c77e-98b9-4269-a08b-e42795033729,Parsa,30,35,8,81,22,76,252,
6768ee03-0ec3-4e79-b349-8c0919837885,Parys,76,11,88,62,71,60,368,
3ae96656-8607-4169-af35-911a57a22757,Pascuala,36,75,22,25,38,20,216,
694e29a5-e458-4cba-8e18-584f17248cee,Pasha,27,91,58,97,81,84,438,
f63066f6-cea6-48d9-9c8c-52f81739da70,Pasha,78,71,47,73,2,6,277,
7fbd0e28-ba47-4fe3-8807-c1f2b9424f14,Pasquale,19,41,14,15,18,63,170,
5f0dab73-fef5-4c5c-abb9-75aec735381d,Pasqualino,40,15,2,72,30,22,181,
bc71a549-6181-4b11-8a6c-d74dbd766370,Passion,3,52,79,96,23,70,323,
6b22bdea-37ad-4f82-ad3c-aec1bc8e9d0f,Patrica,14,89,85,38,89,21,336,
7fcb1c47-db7b-4352-918d-bb915c9878af,Patrik,77,47,14,71,91,40,340,
c5ea090e-0651-4958-a7ae-c6730d091be2,Patrizia,54,18,37,2,97,75,283,
412e2863-bd8f-453c-9b11-8ccbcfe9d088,Patrycia,59,71,49,10,95,5,289,
30f71764-3250-44c7-a380-8cd068ce4953,Patryk,91,51,58,69,6,54,329,
ea561be5-5ba3-4869-8d98-fe56bf6fe90e,Patsy,53,92,72,69,48,77,411,
544ef254-6f22-4d9e-a4fb-35a5d740d585,Patti,85,39,92,24,98,20,358,
ca60585a-2569-4336-8b2a-44cb143a9d4f,Pattie,58,94,89,64,12,61,378,
1e7c199d-6e5e-4b4c-baef-a285094729ac,Paula,6,14,60,37,80,99,296,
ea81c730-061f-412e-ad51-5380ea30d5fb,Pavan,70,93,41,95,11,43,353,
bf4d64ac-697e-4f44-bf1a-c4865cf693ee,Pavan,10,82,89,43,32,29,285,
e4b1340c-582b-4bb3-ab58-28164a078584,Pax,82,2,32,63,78,40,297,
82abe899-99f1-460c-a64f-73069ec30c73,Payge,70,69,38,12,0,89,278,
856cf4af-59c9-42a9-b7cb-3877295b7af2,Payton,5,73,27,26,12,49,192,
cf405242-4b5b-47b8-b407-e12adb9026d4,Payton,43,90,22,55,37,55,302,
bf5bbadd-0679-41fd-93b4-4606d5d9f54b,Paytyn,28,93,68,80,52,51,372,
99c2d333-5bfb-4400-aa0d-226f65750804,Paz,14,61,50,95,88,34,342,
03058337-b471-4e70-a717-aeb42bb11c2d,Peaches,0,46,51,80,81,80,338,
0f467a3e-32e5-4c71-883f-aaa278385633,Peachie,16,19,36,75,24,18,188,
419ec549-30c6-4a58-bf07-62b5c0915758,Pearce,46,26,84,91,17,10,274,
aa771cfe-1f59-43f8-ab01-ebb1251736b2,Pearce,32,25,31,4,89,45,226,
0c509ed7-31f0-4f1a-97d0-f4c20d42cea0,Pearce,27,36,18,55,29,16,181,
f0ef6ce6-277e-40b6-8377-2df8b7fe9280,Pearla,76,43,76,1,84,72,352,
173962d9-4e03-461b-bf7b-3cb71fea4e7a,Pearla,26,39,10,59,92,75,301,
cb2220f0-908b-44fa-911d-bcaa950f1b1e,Pearlean,72,19,68,57,96,96,408,
c66813df-f0be-4a78-afc6-015b59345209,Pearlena,48,100,55,17,14,1,235,
4331aa61-8f18-4610-a376-c6750086da47,Pearley,79,20,55,37,79,72,342,
13e8c925-f03f-4ffb-b218-abd69fc96d19,Pearly,68,58,29,77,32,96,360,
1273714e-c58d-4e47-8563-0744bf458879,Pearse,24,24,89,87,39,35,298,
03f1e6d9-d69e-46d0-a7f8-e47052398e69,Pearson,27,55,85,54,96,19,336,
5f5de026-fa07-4517-803b-92c7ae5d3140,Pedram,10,52,84,3,10,22,181,
8991e9b1-9dc4-4bf9-a545-bca246584b76,Peg,65,36,60,84,99,63,407,
8878099b-a757-48fb-b0fb-a317bdd0a6e1,Peg,74,7,6,98,54,31,270,
33e5eebf-6501-4474-ab47-3c661cd0b373,Pegeen,19,71,55,95,14,7,261,
995c2703-dd22-4ed3-ab1c-dd4abe0278b6,Pegge,67,88,52,51,99,12,369,
c781c41c-9720-47fa-8fb8-df5b5c0860ee,Peggie,83,30,61,51,26,37,288,
0951b78c-024b-4e0b-be10-44cc92be75b4,Peggy,35,47,1,11,64,6,164,
fd481ff3-b788-466d-94c7-cc3b9b7dc980,Peggyann,33,15,27,98,9,57,239,
0e446f26-e0ea-42cd-8e78-846a92fafe9d,Peggyann,69,79,46,96,5,98,393,
c57030ba-37e9-4b26-a6dd-a24de8be3a69,Peggye,56,69,18,51,47,65,306,
2afb2ee6-c984-41d3-bb50-85be3d262812,Peighton,80,89,91,52,42,15,369,
5d74d6c0-7969-40f0-9ac6-d958d6761fa0,Pella,11,2,32,22,85,32,184,
719366b1-b152-42c5-898c-94f5f308625b,Penni,48,4,39,32,73,11,207,
f631c3ac-4755-4289-a2f2-004675e3cccb,Pennie,18,27,31,81,4,54,215,
d7073703-99f8-402c-a857-4e6e4f703d0a,Pennie,84,77,56,70,28,70,385,
7e37d8f1-f650-4fc4-8e36-4da66d19a849,Percival,16,49,0,16,99,33,213,
b74403c5-32c7-4161-bd8f-851564262efe,Percival,86,15,54,64,87,17,323,
df84ab81-5932-42f2-9ece-e649154109bf,Percy,93,59,7,49,55,38,301,
61e5e45e-b2cf-4a56-a2b3-a668111cbded,Perina,57,41,4,100,51,33,286,
f13abe55-a140-4fa2-8462-fea4014294d2,Perkins,62,29,29,53,24,82,279,
fd7e89e6-9cd1-4fcb-9437-0844dfbe5c57,Perlita,0,98,5,17,58,4,182,
24bfba10-2641-4927-9cc4-60b56f238e70,Pernell,21,50,8,5,0,52,136,
9858d4d1-55a7-4640-ab2d-7969e15acb4d,Pernell,32,34,10,74,42,37,229,
4fcfcd2c-0aec-44fc-9cfd-1e6e63df58e0,Perseus,16,15,60,63,27,66,247,
f3ea30a5-6be4-4a25-9ae8-61c6a4684532,Pesach,53,21,45,4,66,39,228,
068f0294-3361-4db9-873b-e2f18b9da704,Pessy,80,6,10,79,10,13,198,
73182a6f-9608-4b3b-b630-79bedd1d6f34,Petr,55,34,9,95,70,96,359,
f7c95174-bf00-4ae9-8086-591454dbc7df,Petrita,4,52,61,59,19,19,214,
84b2d829-5477-4f69-bc78-daf4958fb702,Petronella,92,25,98,84,58,100,457,
2fbc804f-950a-4171-977e-b89bb38fbaea,Peyton,76,0,30,21,27,11,165,
1517b1c4-6f5a-4a34-abc4-2d7e30ae6312,Peyton,69,70,75,33,11,96,354,
b85de27b-c74e-47c5-95e4-86b27f767627,Pharoah,76,51,72,26,28,23,276,
65ba7c02-78a4-4f95-a0a1-e7af5148eb5e,Philipp,16,65,5,58,1,20,165,
5bd72f1a-05b2-4ba4-bdac-0fcefa36c680,Philipp,35,1,76,41,11,98,262,
e5a60b08-9209-41eb-b735-1a70fa8c7a17,Philo,12,97,0,34,28,75,246,
475d07de-2e9b-471d-88e6-683b235970bf,Philomene,22,50,9,88,27,65,261,
06c29a8a-0ed1-4756-9308-25c930494975,Philomene,51,49,70,74,47,23,314,
27d5ce02-da48-4503-9ce8-b5f5d9ce210d,Philomene,98,85,30,17,7,17,254,
8fc86948-2420-4639-9279-91409f8ad4b6,Phinizy,22,48,79,77,66,74,366,
851b0cf8-8aa3-4f3a-8b5d-17a00219e08d,Phu,24,99,55,41,97,91,407,
765da0a1-ba36-4035-909b-bc507cfedd42,Phylis,86,14,43,13,2,74,232,
925311fe-0f42-4360-ab9e-443fb2e69cd3,Phylis,14,10,33,69,63,16,205,
7c7a97f3-02ad-405d-97c6-7686335ce92d,Phylliss,88,49,13,99,33,62,344,
a0f0c844-7db0-42e4-b214-b34fdd09c051,Phylliss,28,23,54,17,91,54,267,
68949463-4381-480b-a9fb-7e36a191ed48,Pia,65,96,16,32,37,39,285,
502f6091-08cc-45cb-9761-95b374f95fd3,Piccola,61,67,46,81,73,44,372,
f8ae1d29-376c-40d0-8def-8356163f0d4c,Piccola,97,95,20,37,28,11,288,
cc7aa9f0-ff02-47f3-b66e-8facd0669822,Pier,10,21,66,42,51,51,241,
c72a7eb7-9f99-423c-b56e-2472c583c9a8,Pierce,33,20,39,23,32,96,243,
e27bc9bd-058a-433c-9a25-63291393119e,Piers,83,6,87,41,55,86,358,
96bfd8d4-bdcd-413c-9a21-08abe0be8410,Pietro,91,86,78,14,68,51,388,
f522e486-8e4a-4f6b-ad65-02e2d3070ffc,Piilani,82,36,36,85,77,70,386,
11cb0b47-9377-409a-b1e3-34953e88668e,Pilar,21,93,93,76,30,89,402,
62fcea58-927f-45c9-8505-b20ea89086d6,Pina,90,66,97,91,58,68,470,
88c9aea5-c210-4191-8a11-a5cddf7e6e06,Pinchas,44,18,99,79,42,43,325,
4ea8357b-bf62-4b8c-9f4f-a14d080823f9,Pinchas,70,39,94,97,22,89,411,
56a3ed33-4fba-45d7-9219-37571622f26b,Pincus,16,21,11,78,11,39,176,
1f400bf0-80e4-40f5-8a22-a34a06bc83ce,Pinkey,19,51,17,74,45,18,224,
9413dd6c-fab3-421a-af7a-4236af5eee70,Pio,6,16,34,30,74,84,244,
cd646ce8-144a-4135-9a8d-c72a10628410,Piper,10,1,7,87,86,25,216,
56c24f33-4fa9-46f2-b7e8-db192dcc64f6,Pleshette,31,42,87,91,93,8,352,
cb9b9706-9cc1-45ad-ba37-a429a81ed5ba,Pluma,77,21,73,27,94,4,296,
273f77d7-43e7-4681-8d2c-b8318aa0dc95,Polina,52,87,81,62,14,93,389,
ca53cc65-4eb1-4a3e-9966-9f780805162e,Polk,86,36,35,61,58,15,291,
51a50daa-0474-4ae4-b437-06309f3c9a0d,Polly,6,54,57,87,19,98,321,
e2ef7a50-6b87-4e1a-a64e-f245d3d26401,Porchea,5,54,55,37,43,22,216,
6265c470-a10f-4c3b-a544-0285cb45ee9d,Porsche,46,8,93,51,90,3,291,
a004aa9a-8e1c-438a-9d2e-33dd9207f8d6,Porschia,52,29,80,35,86,0,282,
52b556ab-d3d0-4367-b5b8-3e39365b6140,Porshia,44,94,42,86,75,92,433,
6e965b38-ee4f-4381-9822-b754a396bdcd,Porter,29,94,66,33,68,34,324,
44fe27a8-4049-4e7e-9c6d-6337a9bed1ae,Pota,94,79,68,99,77,81,498,
71fef00c-0e95-48fe-a3af-dae34c8613d2,Praise,12,44,81,33,78,27,275,
4994c3af-cf00-4535-856a-8c63490959d3,Pranay,82,91,71,89,19,37,389,
3a7d1e29-e8b1-43e4-b5a2-ded6fbe56075,Praneel,6,47,9,65,13,56,196,
8f9d3d70-81f8-4580-8127-2b2ce45049ee,Praveen,13,34,39,87,46,38,257,
88b023a1-d96c-48a3-b44e-0dfed83175e0,Praveen,69,87,13,51,98,14,332,
ba93018b-f07b-49c3-8766-be7e255c91e7,Precilla,12,33,2,52,52,77,228,
49456ffa-293b-491d-b62d-57533c3e87c0,Presleigh,13,100,32,90,36,41,312,
718bad4f-b7f1-41b7-8d7b-5252d9027c7e,Presten,74,78,62,10,87,96,407,
f9af493c-23e9-4ca1-884c-df775c805667,Price,49,17,34,40,83,91,314,
34ccf5ae-7b42-4d0d-ab61-b3168d0124dd,Primitivo,49,77,17,44,25,4,216,
498dd725-c5f6-403a-b514-841697b70397,Primo,20,92,99,64,82,29,386,
d27c1aed-978e-407e-8a89-5b0ac33b5ff1,Prince,15,47,61,91,0,8,222,
72c12982-e2fa-41b6-9a3e-5fe8c0a17be1,Princeton,28,46,48,89,42,75,328,
5be555d9-61d2-4d8c-be2d-deb2ed814bf2,Priseis,68,4,63,6,8,42,191,
d7c71e11-6b82-4370-b932-473cd410a86d,Prisilla,47,14,29,4,55,79,228,
ad52993e-9515-49fb-91ee-92fb0aabffd0,Prithvi,62,1,93,18,70,1,245,
6362e75a-7a32-49eb-a479-98d1f60fc9bc,Providence,37,72,34,85,30,63,321,
e44a0b50-920f-4eb5-91c5-10ceb8a58516,Providencia,81,1,17,31,51,40,221,
5aec6e79-f734-4852-91d8-46c88b7f0f17,Prudencia,80,63,38,82,17,39,319,
66781867-0a18-4e48-83cb-b9f38c326283,Prudencio,88,96,65,40,8,96,393,
2ff68e1e-9736-4ff4-933c-56cd8a70bd68,Pualani,92,75,61,80,24,63,395,
acfec0b8-34a8-407e-94da-da32508eb7df,Puja,32,82,52,21,77,87,351,
cd8c0e5a-2446-407e-87bc-99369603fd53,Pura,13,54,44,30,83,85,309,
32efd0ce-92e7-4726-ba4b-f6404cbd7dc8,Purcell,72,66,71,2,15,18,244,
b68e196a-9c58-4a8d-a78f-456066a537bc,Purvis,2,34,22,46,75,9,188,
4fd99060-6680-4b7e-aaf2-45350588d638,Purvis,33,76,62,81,2,95,349,
1a8f6e15-8c6d-46c5-88db-c3c1e2767c14,Qasim,36,32,76,69,100,78,391,
5ba28376-ce31-4e21-8c73-d5e22b688501,Quamaine,41,13,55,92,60,6,267,
dc933698-2377-482f-a81a-e8a1c0df327c,Quamane,90,7,10,16,17,0,140,
c0afbdb0-667e-410e-ab6c-d2bdecc07b65,Quaneisha,55,76,83,46,73,5,338,
893e0c2f-943f-4032-829a-b4ba3b8e5eca,Quanetta,91,91,36,92,82,71,463,
884baa33-a126-4fd6-98b5-7561c89907a5,Quanetta,53,92,90,3,46,49,333,
f0412d92-53da-4cfe-ba10-489d7f74352f,Quaniya,87,49,20,23,94,13,286,
1a051ba2-f25c-476d-a43c-365eb1d1e306,Quantavis,99,6,64,83,8,72,332,
f54f13b6-34e1-42c7-8dc4-3b9b65613ec1,Quantina,38,95,27,45,60,26,291,
41afe5d0-e75e-49f1-88aa-162c15294e88,Quaron,3,75,27,63,65,50,283,
96c5bab6-f00c-4299-8d67-9e1a08c587bd,Quashawn,68,85,70,67,7,62,359,
9d5ddf6f-ea0e-43de-a511-933b4a6166c8,Quasim,36,64,35,32,39,85,291,
d952fbe3-293b-4d13-a242-090050d338d4,Quatesha,83,40,46,73,10,27,279,
6736aed7-ebeb-4bcc-849f-7ef47f55c6f1,Quatesha,60,4,6,0,47,26,143,
4e308269-46ea-41d0-bd9c-c758ed516b26,Quayon,100,85,73,95,37,38,428,
7aa96840-1911-4dbc-8f05-ce017bca4c3b,Quest,6,16,88,63,38,23,234,
6008c603-b975-4f69-a0cf-785b799d26ba,Quetzali,92,76,51,5,43,2,269,
a6308197-e0bb-4281-b2fa-875aa66b423f,Quetzalli,88,87,81,59,11,62,388,
f61b320a-f2f1-4a56-bdf0-4f1874b14068,Quetzalli,94,84,3,6,81,79,347,
1462236b-8d81-48b4-974c-f483fdcb6af1,Quetzalli,22,98,60,99,47,85,411,
29125bfc-23b8-41b2-a825-80aa3dc20718,Quetzaly,7,25,82,24,1,42,181,
7372d2c2-094b-4b68-af4f-06525edf6b8d,Quin,5,1,69,55,10,90,230,
efbd32ff-dfc5-4b8c-820e-8f6e6ce18d23,Quincee,16,24,76,79,10,33,238,
ee552f64-4733-45ad-8c75-2ab266d72510,Quinci,65,14,30,96,87,9,301,
9cfa40a6-ec4d-43a2-bf2e-7dbc91ad2992,Quincy,84,45,12,44,100,12,297,
0f2a7be3-4bee-4b56-aef6-969e2451a666,Quinesha,68,0,94,20,42,60,284,
f2be2bee-beb7-4d48-b99e-0dacd1e1341b,Quinlan,36,37,3,6,47,0,129,
58f3efed-0a75-47bd-9040-e0ab256fbae5,Quinley,84,68,24,58,2,13,249,
458f0e35-22cf-436f-8f7d-2763a8bc98e3,Quinnton,50,36,95,37,3,21,242,
2a1dcf8e-c5f4-4c21-92e0-f209e612dd65,Quintavious,69,39,77,7,67,43,302,
6f5b7d72-aa68-4c87-88d8-f5575d382169,Quintavis,30,56,95,69,16,67,333,
6b028aac-b702-4703-96c5-1ba880c4f946,Quinterius,0,46,53,50,65,57,271,
7303f0f8-d3f3-40dc-acbd-95d50180c9a8,Quinterrius,55,52,96,56,100,29,388,
06cc8430-ece5-42d8-b502-678e2ef4e53e,Quinterrius,0,5,13,47,16,52,133,
7ab5370a-96d0-4a5c-be1c-23592da2a042,Quirino,80,21,42,38,30,46,257,
1d740296-4868-46f4-b878-c0181b2eb870,Quoc,78,66,69,89,23,2,327,
4c76664f-0e95-4080-ba2e-5be3c82efebc,Quron,17,32,95,24,47,90,305,
b2c0dca4-17ed-4d43-bb87-1dedc6f1dcc1,Rabia,72,54,88,83,30,49,376,
3901dbb3-091a-41bd-82ea-48bfc491a975,Race,39,3,19,29,66,57,213,
385f05cd-72e6-4f68-bd31-027487acfb1c,Rachelle,56,96,12,55,15,83,317,
a25c681e-8330-4b90-9558-ed53bef3c8dc,Rachyl,13,72,39,52,73,80,329,
c9fe4cf0-32a6-4256-a774-f886a81e776f,Rachyl,39,16,39,97,19,79,289,
29bce58c-57d8-44df-b562-09ebe846a053,Raciel,37,36,4,58,1,3,139,
3ec1e19d-24e6-4ff0-b94a-b02f375054a6,Radhika,54,89,29,14,19,69,274,
754e8fd1-018c-4660-af18-b4c95cbe1794,Radley,44,16,53,82,2,70,267,
6a0dc510-cd4e-49a8-986d-d8ef615e5218,Radonna,44,56,3,57,48,66,274,
e00bdd6f-0267-4f2a-8dcf-6ff1be8cf785,Rae,38,15,41,57,77,99,327,
f4fb02f2-ecb9-4aee-8a08-57167e0733fb,Raechelle,76,42,14,34,33,43,242,
e83b938d-b64a-4528-9b96-ac6af3621ee1,Raekwan,52,98,51,73,83,41,398,
fd0b3a88-e555-4066-a10a-b804f13780ae,Raekwan,15,93,14,53,30,4,209,
29b00f40-f5eb-4d34-8f4b-f6cc44d74e8f,Rael,34,18,68,60,89,49,318,
247d4375-5b64-440f-a2c6-4d02d5be0e23,Rafaelita,78,87,60,80,15,6,326,
82edfbbf-d067-463e-879b-6ef6fcb50bc5,Rafal,88,48,47,83,88,92,446,
2f4406d7-cf48-477c-8529-4e75df905f09,Rafat,48,22,90,41,98,53,352,
266a6515-4e0f-4683-b308-8017735e17c2,Rafat,98,91,21,12,49,70,341,
f78e15a6-b803-460a-9fff-a00eec150bb1,Rafat,33,49,74,77,29,99,361,
0accbda8-c2ad-49af-825b-aaece5e9bdf5,Rafeal,41,0,31,1,69,25,167,
566044d0-1f89-493e-a6df-892a78082584,Raffaela,56,17,31,67,20,91,282,
18e2f1fb-3006-488a-9118-4c21c0cc0884,Rafid,75,18,38,35,77,98,341,
8276baea-f55b-48dd-b29c-7cada94602ca,Ragen,17,40,81,34,10,74,256,
9b225d3e-963e-46a7-bdf9-0ddfb3156ee8,Raheem,31,18,68,79,18,64,278,
eef043d5-e926-4a36-aad5-58a7d5ca853f,Rahel,73,83,12,82,71,36,357,
5f501a7b-2336-47ee-a60b-a441ff4ed94e,Rahiem,81,42,7,58,61,66,315,
660082cc-e1b5-4bff-919c-125b1e9fcdde,Rahmell,85,21,20,22,17,18,183,
ddd59913-12bd-4d17-93b4-a9544c7f1930,Rahshawn,17,99,22,12,37,37,224,
099a5f60-e379-41a2-8cff-c56ff4ab6b93,Raiden,91,69,56,95,85,58,454,
e63a225d-900e-4eb5-a09c-0f775546c4d8,Railyn,73,30,26,68,15,83,295,
d539ee44-6d62-4950-84fc-900369e1347a,Raima,88,92,81,46,24,78,409,
371cb9e1-76e1-47d5-ba53-fd16ccb0ad97,Rainbow,20,78,58,5,23,52,236,
d281a260-6467-4232-8c9a-d9af2d871feb,Rainbow,88,25,11,3,40,52,219,
38ea01b5-3694-4e95-8071-8ae04e0478d9,Rainer,2,53,14,47,14,19,149,
fa73c394-34f6-4a15-9eaa-af84abe12269,Rainer,70,56,35,94,91,31,377,
5350e86c-11f2-41c0-86b9-e56ccd93015f,Rainier,35,76,35,84,22,7,259,
cc2c9d40-70a8-4c2d-97de-e336550f2f65,Raisa,89,91,74,72,95,94,515,
b2e9e83e-2a47-4e12-9158-9ca1509dde81,Raissa,50,64,17,53,36,14,234,
61a1bb0e-624f-42c5-84dc-dc4f7e78a3ad,Rajanee,72,66,87,74,38,7,344,
f12878dc-2bea-46e6-9a82-2a18a6b4233a,Rakesh,17,65,24,60,57,57,280,
47c044b6-a935-420d-ba63-f2e2c0992587,Rakim,18,56,92,14,93,23,296,
beb96b0a-6b74-4885-bcdf-dd501045f86b,Rakin,32,29,38,90,22,52,263,
f474d50f-9717-4dca-9ddd-9d50728fa61b,Rakiya,18,87,90,61,41,89,386,
0cf94be6-8dc5-421f-ba33-7529ebb7d8d6,Rakiyah,81,68,47,53,96,88,433,
216d6e30-ea32-4dad-bc8e-d2ea4186d6f7,Raley,3,37,86,52,91,62,331,
edb72f44-6c97-4d46-8c2b-19b9907d96ec,Raliek,64,5,29,72,53,17,240,
cb01ee41-dc05-4dee-b205-9f5f0caeff96,Ralphy,91,29,30,20,9,65,244,
047498a0-1e45-45a4-8881-39a1ee867705,Rama,79,62,85,5,39,36,306,
9e8e4cdc-fabf-4653-acec-d0597637abe1,Ramata,72,8,57,64,14,45,260,
2613ca33-12c9-44da-ac7d-fadcfbe8bf37,Ramil,41,55,1,91,10,100,298,
69410148-9bf0-4cc7-b079-da34663c9515,Ramir,4,60,44,20,58,56,242,
ef1397ad-6595-4fd4-9ade-a0292081b810,Ramiya,48,68,78,62,50,70,376,
5181d4a1-00c4-4329-9ab5-370e6f07fe46,Ramon,91,40,23,8,23,5,190,
84fa2067-9741-4a39-9ad6-d6ba6732a1df,Ramond,97,0,95,66,13,95,366,
85ef91eb-176f-4cbd-95f6-f8a919002820,Ramsha,2,37,10,85,100,22,256,
757d7726-0c28-4291-bf87-2fad3196a705,Randa,61,62,11,28,37,2,201,
44b4e72d-cd44-49e1-82f8-4c2691b9d50e,Randal,25,56,60,33,9,13,196,
d0a6d992-a85f-4559-9c09-fec02642b593,Randall,3,38,66,93,39,1,240,
58d9925d-9ba9-4e08-8334-05196d68ef24,Randi,4,45,100,46,88,93,376,
3797b037-4e92-4ce9-9ea1-34bf820fdc58,Randi,46,66,2,74,84,10,282,
ad1a2eaf-49d3-4b58-971a-6b7fde9144f7,Randiel,67,19,38,91,94,15,324,
56169465-20ed-41eb-be92-85e53d14d805,Randle,78,28,50,42,87,83,368,
05249027-89fe-475c-b087-411b9823c358,Randol,29,55,45,14,97,73,313,
dd0fc12d-71ea-4fbb-b797-65eeb70304dc,Randol,46,14,65,76,37,2,240,
5eaf167b-d923-4562-8354-36611bf6f27f,Randy,24,56,91,5,15,93,284,
d61a5915-7222-4e06-8536-f1f0630d6a46,Raneisha,72,19,19,26,60,60,256,
3ec5fcfc-1aca-4b0c-a6f9-f395c4171c63,Rania,90,5,62,69,65,75,366,
d952220e-e402-4521-8688-93110fe7c937,Ranijah,22,34,13,67,4,20,160,
97e9751d-b4ba-4d61-8a0b-fc6d150f8189,Ranijah,100,92,82,66,21,63,424,
41ffaf17-126f-4519-862a-8fc0988fbaee,Ranvir,48,23,53,100,95,9,328,
76144785-f800-4abe-af39-83bd6410eb30,Raphaela,20,35,91,22,60,12,240,
731b57c7-973c-42ca-9290-6109a4506908,Raquell,22,43,60,3,52,24,204,
149c3d9e-107c-46ad-b224-4e608bdcb2bf,Raquelle,67,58,88,97,97,85,492,
e4628173-676b-4f07-ad8a-4727830a9f93,Raquelle,70,42,40,3,100,57,312,
7f19c8c6-e932-487d-838d-7c4a1e888b5b,Raquon,18,58,9,100,39,11,235,
e3820374-aa86-43d5-8eda-1036b6b92234,Rasean,34,23,31,60,38,50,236,
0a4e892e-5c6d-498a-afd8-97a2b8ed51fe,Rashaad,54,45,98,24,22,58,301,
3d6a20c1-9c64-4933-8d08-56c61d056643,Rashan,6,14,46,23,30,80,199,
b55bc286-58e7-4324-966c-2ea5775a147d,Rashanda,0,13,11,69,13,74,180,
a07ca85a-acd0-4687-b12c-9fff1d62f1f4,Rashawn,66,26,37,57,3,21,210,
aa9bcd2a-303a-4857-acd3-a69f8c7d1a33,Rasheeda,57,77,29,3,73,48,287,
2956a20a-4717-4a7d-8311-17604fa1affb,Rasheena,67,73,22,59,84,33,338,
5893fc43-e31b-4068-81eb-98664a7a1e3f,Rashon,57,73,37,41,32,2,242,
ee1749a4-e5b8-48ef-8a91-d844a020575f,Rashun,63,31,88,69,59,21,331,
af967a1d-941f-4aec-ae36-ad3f43bfaf13,Rashun,33,87,62,71,87,65,405,
3d136e6b-faed-453e-b1b3-2a0927ecaac4,Rashun,80,59,77,92,80,58,446,
83342b90-e1f3-4384-944a-cf98ac8e93f7,Rashunda,86,8,2,0,14,82,192,
1f78c1e8-5ca4-425d-8b2d-482ec52d52b0,Rasul,69,76,26,59,6,80,316,
0a66a669-7ca1-4a55-aa12-d7e9ab030091,Ravonda,53,11,49,59,52,98,322,
8d76e1b2-5944-4593-b2c1-9545a2939efe,Rayana,33,47,29,62,32,40,243,
86737600-123a-44e7-99ad-9ce3ccd98fd5,Rayansh,58,27,18,79,61,37,280,
3252f51f-8b02-4cd6-ab32-0c96ab38f377,Raychelle,72,0,52,39,6,12,181,
0d2382a7-03da-4694-a395-96fd77ae0818,Rayden,29,59,59,92,45,50,334,
48e18b34-bcd4-438d-b43b-642b710f231b,Rayetta,2,57,94,78,12,57,300,
4112b26c-25c1-4661-b53f-5080f6ec8185,Rayford,49,52,10,11,3,5,130,
d11cf5a2-5202-40c5-b6b8-985afe4a1fa9,Rayford,45,45,29,97,32,74,322,
24ce743f-9b88-492c-b89d-fff5123a2eb5,Raylen,78,0,14,63,37,80,272,
fae496df-09ac-4056-af11-6f5a28cfb9c8,Raylynn,76,99,51,38,58,16,338,
38bf81ab-fb9d-48e2-938e-b25cacff9031,Raymie,100,48,99,6,91,71,415,
2683c109-5000-471b-8718-b4e31179e8df,Raymona,11,53,12,30,17,85,208,
4c728e56-110b-4719-92ee-af215c7d998e,Rayn,59,9,99,65,49,78,359,
e087d48b-ec4c-443b-a9aa-eefde7dfe856,Rayn,87,28,94,96,69,47,421,
8dc1e7da-b1ab-4fa6-a666-fc7a97d3df9a,Rayne,84,47,48,40,4,43,266,
3400f74a-597e-41e7-b8ef-d4e37f474eb2,Raynesha,61,11,34,50,28,31,215,
5b5b8216-be98-4525-9df7-551d1156545a,Raynette,21,45,61,50,5,100,282,
9bcc47a0-efbd-4e10-81e4-19668d5218b5,Raynette,91,42,61,83,10,63,350,
4cf666a8-b9e4-4aff-a6d6-310f2ad042fd,Raynette,11,13,45,2,84,77,232,
36718eee-79a0-4910-8d17-51923631a490,Raysa,77,17,79,46,14,68,301,
31353c28-3d00-4312-ab8f-f70031cedfa0,Raysha,85,12,8,79,26,30,240,
35152afc-9c0d-491c-9851-36f800a081c5,Rayshawn,45,45,59,73,50,44,316,
4c35b633-bc96-453e-ae04-5c4ebc112fa1,Rayshawn,93,86,85,2,54,82,402,
d60d7822-cd57-495b-b68f-2b6ffbfd846a,Rayshawn,80,4,32,25,29,16,186,
07abc14c-bfa1-48aa-8895-fef55e9172c2,Rayyan,74,42,1,96,20,77,310,
827a77e1-ea85-49fe-b722-b208e8e6560f,Razan,62,71,66,81,49,71,400,
06ec2927-1a84-4c96-8d2b-1085256a6b31,Raziel,16,99,51,60,52,56,334,
02a39820-ef54-4a39-a86a-1f60125bee1f,Razmig,43,90,99,78,47,55,412,
8ff2086f-8c4e-4106-8248-433dd8cc2ffd,Reah,83,37,56,86,50,69,381,
015f1e89-89ed-4fe3-a220-c862fdbd2bbb,Reanetta,70,51,42,30,14,72,279,
b7b8fd24-91f9-4980-b2aa-f6a6cb4cfa0c,Reathel,34,36,94,44,56,68,332,
60153443-ebf6-4f17-956f-f1f858028586,Reba,8,8,15,53,30,29,143,
026fa917-b828-4d74-ac0f-f0d8e49074dc,Rebbeca,94,32,64,77,32,50,349,
78d2b7ba-c031-49e9-a2ea-17a0cc6af825,Rebecah,93,35,8,6,16,67,225,
f361de78-822d-4eec-bf56-546806ed1cad,Rebecah,36,20,24,45,93,68,286,
40a44370-7db4-4783-9a2d-de563bcd56ac,Rebecca,27,47,92,70,16,0,252,
8131409e-3d76-43c6-8d1a-586ca4a635c3,Rebeka,88,88,50,0,49,47,322,
0ba0c82a-e9bd-44ae-90f8-a0a3620d8b8c,Rece,93,19,61,70,100,67,410,
c05faed2-dcc1-4d4d-a3ec-c354d51d83ef,Rece,73,79,96,5,59,46,358,
f4ecfe66-cef1-47c2-b39d-158992cd9787,Rechel,67,51,22,45,13,67,265,
e7930ba3-44f6-4437-b2b6-7e16ffd71d75,Rechy,26,7,53,57,75,1,219,
1c81c47b-51c3-43c8-9c68-f1ba13f9cba1,Redell,70,86,60,6,97,5,324,
0a025f6d-996b-4c7c-9040-c9ef580e1ec9,Redonna,90,21,88,87,14,32,332,
ab56b803-d1ca-4a4e-8d80-b43d15a0cb66,Reece,44,69,35,52,6,10,216,
1f55ca3f-1a15-4301-b238-66ce1a6e5456,Reed,68,77,40,24,4,33,246,
12f9f35f-65a5-41a6-b0f2-579660f81012,Reef,16,10,83,82,26,82,299,
77ee8447-05b3-49ea-93e4-d690d6e14269,Reegan,57,14,8,78,90,8,255,
6db097b1-e534-477b-ac2a-1ab40e94aa0c,Reemas,13,0,15,75,90,63,256,
7e374daa-7caa-4e35-92b0-0ebfdddf3deb,Reemas,36,54,100,33,88,76,387,
80afe605-c54e-4406-83f7-21156c069add,Reena,31,69,24,16,97,50,287,
59220fd0-f27f-4e98-bce4-dc7a996d990d,Reet,100,1,59,80,3,48,291,
c7db3ac5-4c85-431b-8f9c-2c8798ee5ccc,Reeve,29,32,28,96,77,60,322,
ee7490c9-cba0-4adb-9840-51ce5f1eccd1,Refoel,65,37,44,98,52,55,351,
c7f516ed-3e2c-4f33-b761-45b74c7c98b2,Refujia,99,1,75,98,56,84,413,
f6d22d20-284e-482d-8d3f-d2ac94cffd99,Refujia,51,64,3,99,98,96,411,
4fd288c2-062d-4441-a81a-506f02c5df4b,Regino,59,14,69,31,19,88,280,
627d1111-e1be-40cf-8ccb-8f9c49f0a571,Regis,61,47,99,29,43,88,367,
65913c5f-4430-44ea-b9ee-db26c8aeb7b2,Reham,23,11,51,66,25,66,242,
980c8150-7318-44ac-82b6-1afeebffb694,Rehan,91,86,73,25,35,92,402,
667be8c0-4c9c-4281-81bd-7d38e01c45d2,Rehma,92,18,35,92,69,89,395,
8bd44bca-7e0b-4204-9e47-2993d692e82e,Rehma,19,52,29,32,21,13,166,
acd22d95-c896-4e9b-a7ca-990a4de7fbe3,Reice,51,16,83,58,35,25,268,
e326b461-b35b-4036-86ba-63ca5d5630a7,Reid,39,97,55,51,3,76,321,
9e93df6b-23c2-4c54-ba99-69ed9205a7f9,Reiley,71,37,41,46,97,51,343,
9b41f851-df04-429b-9650-b70dc7d43cd6,Reinette,52,41,0,10,64,56,223,
3144626e-e6ac-42fd-9a33-3765f4f9e524,Reino,35,35,45,61,9,88,273,
f14f93ef-fd32-42ab-a3e2-493b0f79eaf3,Rekha,76,27,73,100,96,67,439,
3beba08c-fe7b-4dfe-91bd-965e916bd2c6,Relina,71,93,33,67,50,28,342,
729b6420-a196-4504-9c29-d23469788841,Remas,26,77,4,6,70,3,186,
ab2c70af-1477-45ad-bae9-6da27dfdf39a,Rembert,35,44,15,69,82,62,307,
77cee43a-3bd3-447e-80f9-521a0b61fe9c,Remberto,8,74,20,71,2,34,209,
b805d4f0-f435-4886-83cc-dcd461f73758,Remberto,14,51,17,91,80,20,273,
7abd832c-e558-4e37-8627-2beb4585342b,Remie,3,50,24,89,98,39,303,
a7360631-6c53-48e0-ac0f-13e7b05b2aba,Remijio,40,51,96,49,2,70,308,
732fc43b-2327-44f7-8f9f-b2f35ddb8fa4,Remonia,2,95,99,43,53,43,335,
81f3f821-5fec-4cb5-accd-6c98e3a684e7,Remonia,57,21,86,79,74,3,320,
75d8cb44-62d8-4a69-9be9-1a1e79715533,Remonia,57,40,2,62,42,5,208,
6ce8fbcf-60e5-4511-a998-4ae7c42fbb21,Remus,16,73,76,10,22,66,263,
ef495238-da59-4f3e-8b7c-448def233c1e,Rena,27,56,87,87,54,0,311,
2bbff7aa-581e-4f9a-9be8-9a38285511d3,Renada,51,2,78,42,50,77,300,
c6689486-d666-492d-b607-095096974e81,Renae,91,95,38,83,41,74,422,
576b296b-26aa-467c-a4e1-2675a6c93d85,Renan,1,60,45,74,5,79,264,
b267fb45-cef4-493b-85bc-8395bb2cacc0,Renardo,82,7,88,23,19,52,271,
5b3c9e74-39a3-4921-88c3-63cd96709adb,Renatta,14,85,14,80,59,57,309,
e4a7bf29-a2ff-417d-b458-8448db37aa1d,Renatta,25,39,98,87,91,56,396,
2ab5ff9d-21ae-4238-beeb-ec3c696235d9,Renel,18,88,3,72,33,40,254,
9b649d57-e14b-4a0d-b011-ed0d34825986,Renell,30,68,67,65,12,55,297,
7e23f6b4-c101-4ef0-8fd8-609f2bf9017c,Renella,53,85,11,100,53,98,400,
db22189a-0ebe-4ed0-9158-6d1fdcb7eeb9,Renesmee,51,43,19,36,80,18,247,
11a36bbe-7c63-4aba-959f-91e51cbfec61,Renita,12,47,17,9,17,50,152,
c45b2af1-44f1-4348-8083-c15186db4103,Reniya,15,43,62,22,80,9,231,
4bd0ab44-1b1c-4832-b9a9-e197fb84f7cc,Reniyah,47,23,77,66,50,13,276,
9bc2141e-50ab-46bd-b9ca-6546f8f74fb8,Reniyah,55,39,43,28,6,66,237,
b9ce8ff4-809b-496c-a1b6-f67a15b3de14,Renna,74,78,52,22,50,53,329,
c30e9a9c-763a-415b-9c4d-186237107b62,Rennie,24,73,62,97,18,98,372,
1692b1b6-d5f4-47be-ba4e-3595f052152f,Renwick,16,80,15,77,68,71,327,
d767ea58-9405-4b9c-9f1f-24232be47fa8,Renwick,53,26,47,42,77,70,315,
85ac0885-6a5a-4344-84a7-897d376d9f60,Reola,85,69,62,69,29,58,372,
01cc342b-c655-469e-baef-4cb71f86d8c2,Resa,61,73,87,2,92,16,331,
88a9259a-77b5-499e-8d85-0ee5c43f2efe,Reshard,92,63,9,86,29,81,360,
71c73a21-89de-489b-82f8-29f6b09c0006,Reshard,26,75,2,42,61,44,250,
16856036-cbff-4701-9c62-a1d1ef5fe198,Reshard,87,96,60,63,83,34,423,
7aa43126-3e68-4384-9532-666aa227f1b6,Ressie,43,70,4,2,59,46,224,
3c09b60e-4094-418e-a2c2-9a812f62d312,Reta,16,15,48,49,78,93,299,
5706873e-77b6-4714-afcc-f0758f2a688e,Retha,95,85,76,82,45,41,424,
a295493f-3df4-4d79-8ac8-4913853baf94,Retta,85,34,88,49,31,83,370,
9ba416bb-e9ae-4ce1-9ea7-9a4b4c007eba,Reuven,99,61,66,42,17,47,332,
3baa66c5-ab61-4b47-b4a5-b57824a27f81,Revonda,92,19,89,68,16,86,370,
cfe37418-e826-4aae-87ef-7042034087de,Rexford,75,72,49,92,97,28,413,
c8ed3093-74fd-4e76-90ea-561b8934a354,Reya,64,94,3,27,33,86,307,
1b864473-6d39-49e0-ab23-a51fd3e195ec,Reyan,0,38,93,23,70,73,297,
ed78f87d-008d-4d4e-9347-fd3edf2a7a08,Reyanna,64,87,89,31,7,73,351,
8d79d096-5341-4f06-b623-73659ac38dcb,Reyhan,39,13,49,13,78,32,224,
a94e684c-6235-4082-8079-833f6f48feef,Reylene,81,52,94,42,24,96,389,
ddeb371d-94ca-44de-99e6-ac25b2f8c999,Reyli,98,96,83,13,21,82,393,
ec222304-bdc0-44fe-8f8f-23690ab6e684,Reyli,38,68,47,92,36,100,381,
06ad8a11-c537-4d80-826a-881696edf4bf,Reymond,53,61,2,57,90,32,295,
2faff460-bf16-4230-bf90-a06bb30dd05f,Reyna,49,6,18,30,30,46,179,
83c8f779-8f0b-4bd7-ba7b-8f6c029767dd,Reyne,64,16,88,26,53,0,247,
7361e535-5706-422b-9a23-66d937921b5b,Rheagan,54,46,8,60,90,51,309,
752f9e41-f1f2-4ce0-a947-dcca047b8a34,Rheana,55,4,30,96,34,44,263,
072b4b89-41fc-4b0c-8372-439c44ac76ea,Rhelda,19,62,64,56,72,57,330,
e5c9116d-54b2-4099-b69f-64a9ac99fdc3,Rhema,52,67,14,74,33,7,247,
95cdef58-f1de-4710-b1da-f9530bf36c1e,Rhett,76,28,7,24,12,75,222,
1a19ab9b-37ef-4e3f-92d1-c23c4ca1905e,Rhetta,44,43,51,49,18,1,206,
b52b963e-9a2a-4525-a086-bbf4efd76b02,Rhian,48,35,65,16,2,6,172,
189503e5-9ace-44e1-853a-a6f1ec09cf5b,Rhianna,87,94,55,30,26,99,391,
fccccc08-c8b3-4daf-a776-b47b3933b3db,Rhodora,94,19,23,46,37,56,275,
74a7d897-bf2d-48b1-9706-ede476ed9548,Rhodora,35,85,2,36,66,36,260,
711c1788-2fdf-4449-9a21-dbd33701ab1d,Rhondalyn,100,26,44,66,21,47,304,
ce769c2e-d8ee-4484-a517-16ca59de4a0e,Rhondalyn,95,63,31,96,12,61,358,
68a3e84e-acbd-4eb0-90bf-44f5830952be,Rhyan,48,16,42,43,76,66,291,
cf67f190-60fd-4e5c-80ec-31a442b19fa1,Rhylan,45,51,30,66,31,59,282,
92c673eb-2f99-4b7a-a9e7-0411c4c6e749,Riana,92,74,58,31,78,9,342,
2aaf7d36-5591-46dd-ba66-6aba973ad78d,Riannah,32,56,76,10,95,13,282,
d3181b33-6ea3-46a8-9128-4bcabe1afb9b,Ric,89,11,12,21,77,41,251,
46bfa4ec-28a8-4e7f-8d33-4292852bcb74,Richard,13,16,56,37,98,80,300,
d234582f-ddea-41e4-91de-26d7c302dad4,Richardine,34,87,16,52,43,17,249,
a7c8c6c8-d976-4c04-ab5d-d1cbcb2c7c99,Richardo,22,69,25,41,22,59,238,
10aae055-75a4-4989-bf56-569d927c5a5d,Richele,99,72,3,82,100,36,392,
adafd8b2-7bb0-4e63-b64c-0ff9894ba7aa,Richmond,21,54,32,63,100,6,276,
467e89b1-abf1-43a2-a8fb-fd4a3db48c43,Ricke,92,9,2,69,71,25,268,
01427362-9d70-41cb-b487-16d3792ac58f,Rickey,69,90,13,34,33,57,296,
17ac93cf-28fb-4004-9966-42652b52cc90,Rickey,23,63,67,92,67,26,338,
a913fd92-8759-4f15-901b-85ceae78a7fb,Ricky,32,75,74,96,18,3,298,
7dd78d09-ffff-49c5-9c28-1d24b316411a,Rico,38,38,77,93,51,26,323,
210dc7ca-c860-4d67-b8bf-88d55c684240,Ridhi,86,84,70,87,16,51,394,
d5bbd9d5-11b3-4390-9cf9-36cc459f1e15,Ridley,9,10,87,54,65,93,318,
2a39ca81-b658-4807-8cbd-a2c584fdafce,Rigoberto,47,21,28,29,79,42,246,
5fd75e08-91af-4a17-9332-7f0a4f4c02f1,Riker,12,28,55,76,85,71,327,
3c50ec29-eb33-480c-8880-d8a535a293ca,Riki,28,48,21,71,37,16,221,
76a63211-8a05-4aab-9f3f-e3500146c225,Rilynn,15,58,85,29,20,8,215,
2320a06d-b1e7-496a-a518-e6f44e002545,Rima,77,84,3,0,94,17,275,
7e88cbe4-7cea-451e-b5ac-c7217e062db9,Rina,77,100,89,19,48,40,373,
8e5dbb26-11ee-423a-aa3b-f57c93a5cdf8,Rina,54,14,11,52,51,86,268,
30e62e77-c39e-449a-a96f-ec789a715b5b,Riona,76,96,88,9,37,85,391,
f4e63c30-5cdd-4ae9-9fb1-bcaac8895f84,Rishab,76,51,21,89,81,58,376,
2e059454-59b3-4eab-86d3-87e2ac2d59ee,Rishabh,86,82,86,84,94,0,432,
e7971ae4-99a0-4664-9bc3-b25a3821f165,Rishik,70,95,63,16,51,62,357,
4f2477e3-65eb-4d26-8575-478ad35c0c72,Rishika,40,58,72,95,71,21,357,
50bbe7ed-0210-4e26-a0af-a575ae63bf90,Ritchey,85,78,47,67,45,22,344,
58b20a02-32ce-4f1a-ad9d-b0c686b5ef68,Ritchey,36,33,11,3,68,89,240,
855d7ca1-a89a-4b6a-8a2f-e846f0e4dbfe,Rithvik,98,63,30,56,10,50,307,
34853d31-c512-439d-b0d0-eae250f9a945,Rithvik,81,98,28,92,16,83,398,
f74a7ece-e762-4cb5-8b12-b3e24bf49ced,Ritvik,48,77,57,70,70,66,388,
403146b6-d978-4cc4-882e-7531620f5ac8,Rivaldo,66,31,57,81,60,34,329,
7c3459fe-9bd4-4686-b915-5509f28076d0,Rivka,65,7,4,84,62,90,312,
0c920b4d-99e9-4b3d-9b72-f3e3750a397a,Rivka,49,2,53,39,25,94,262,
117542fe-43c4-4ff0-b6eb-d7de280257a3,Riya,28,78,51,39,67,27,290,
06e2e06f-5d7b-49f0-bb1b-d5e69b15a158,Riya,85,29,11,82,2,63,272,
54f91662-920c-4a3a-8c03-4b6dc0c9ccb7,Riya,25,61,0,26,36,83,231,
22c83ca8-a6bb-4fd4-af9e-f38426044ad6,Riyad,42,62,27,82,48,11,272,
bfe6e3b5-8996-4eb0-b996-24fb272d5d2a,Roan,42,45,15,19,58,79,258,
42eae473-01aa-4d36-83bf-5e0a0510a385,Roan,45,56,65,65,27,33,291,
60e0dbfb-077f-48e9-8d4a-9f8b14b34e37,Roanne,52,63,66,22,95,44,342,
9dfaae55-69e1-4a40-9dbc-65e81a2141f9,Roark,78,40,50,9,42,96,315,
5c4a2428-3504-4d0c-9482-508c9a23e9ce,Robbin,22,59,16,66,2,0,165,
3e9b53c5-f9f8-4b5a-acee-cbcca28273b5,Robbye,40,25,16,99,18,37,235,
a12c57a0-36dc-48a2-ada0-6fd6a1353b6f,Robel,19,71,7,50,60,8,215,
ccd42642-6c7a-4862-a7bf-b9887975dc76,Rober,67,3,86,68,11,34,269,
b668083a-d8b0-4ed4-bb56-46e1da809044,Roberta,21,8,23,23,18,34,127,
b01e8e5a-8b9e-49be-81d2-91d9e5eedac5,Roberts,9,94,55,70,1,30,259,
f8c39823-32b0-4378-b548-2c29180474d6,Robyn,27,1,94,26,33,64,245,
bb3496c9-7fb5-4a6a-b64d-b2b34035d3ba,Rocco,75,65,66,4,59,45,314,
2588ead6-de12-407f-b5bd-69c56576cf09,Rochele,73,80,17,93,37,25,325,
dee82ff9-d543-4501-968f-cbc98031ba1f,Rochele,100,42,93,72,94,96,497,
4d4c2ada-22a4-481f-aed9-9fd9967e5732,Rocio,34,13,26,10,72,94,249,
31050319-62aa-4ab3-bbc3-914be8d9532f,Rockell,5,3,89,66,82,51,296,
232c54fe-7fb0-41fe-ae73-b102eebd1c8e,Rockie,54,84,34,26,13,62,273,
f4db41e2-fc3d-4eb8-87f8-628662b3c992,Rockne,14,77,85,15,43,44,278,
5c00370c-525a-4f29-8009-7aae85224b2a,Rocquel,74,7,23,100,64,25,293,
0ab8a20e-a749-41c1-8dcc-00cc5f6b2fe7,Rod,25,83,77,93,41,47,366,
e2afa0fa-48b1-444d-a69c-0eb5df6c4fd1,Roddey,48,97,5,34,68,13,265,
b05e2556-fb4c-4ed6-8ff6-9194d58ed867,Rodnesha,40,64,2,98,12,0,216,
a99ead98-66a0-4b0b-a41a-17d1f2c4ffe5,Rodnesha,81,93,81,75,54,6,390,
3ead54d8-e31d-4a43-9a68-38aef8fabe30,Rodney,69,44,3,78,82,39,315,
951c48ee-b2ab-49c0-bb00-96f526801dc8,Rodrigo,65,31,11,90,53,54,304,
0f89ad9c-13ef-4314-8fc0-fdc8dc8a6797,Rodrigus,34,50,89,50,97,96,416,
b552c5a8-5972-4696-9358-8be22b540790,Rodriques,34,1,59,3,79,1,177,
fa65972f-71f4-438f-9376-8b70a68e3b5b,Rohan,64,24,1,32,18,66,205,
a0b095c8-a704-4255-a061-f517d90a39fc,Rohin,39,22,77,22,6,20,186,
3f3d016e-cb01-450a-b96e-354c9afe7063,Roisin,81,31,10,30,41,18,211,
2e91184e-85f3-46e2-a012-a56f2066d70a,Roisin,30,30,10,0,99,66,235,
2d524a90-4a62-4909-a3c4-56901caf1cfd,Rokisha,68,73,12,6,70,38,267,
d0538d02-5c5b-4510-9d4c-c29710b0de82,Rolando,90,85,81,41,81,53,431,
ca3a6813-3da8-466d-8669-b7739c684bfd,Rolla,24,33,54,40,84,2,237,
82cb286c-0962-43b1-b7fe-b6cf8fff052b,Rollie,66,43,56,76,54,1,296,
2e17f149-bec7-4dd7-8422-d89121c980e5,Rollo,70,50,69,33,60,16,298,
085379a2-609d-4983-a37f-e322136af894,Rolonda,85,38,59,28,39,53,302,
d6eb57ad-5305-4d90-a055-2b94568aa3f4,Romaine,17,54,64,86,62,67,350,
72cd930d-ff7d-46e9-82eb-9b9cfa60ac24,Romaldo,19,37,47,79,19,51,252,
31512736-7825-460e-a706-e8eec5a3704b,Romaldo,10,34,17,57,100,33,251,
8205f4dd-5ab1-4af2-878d-89685e65dee9,Romaldo,89,30,0,95,46,95,355,
054d61d8-8ade-4ffd-a677-dc82645f07f5,Romario,54,67,63,78,16,96,374,
dd43fd9c-ee80-4c52-af65-5fc2fba6ff1b,Romayne,7,73,73,52,9,10,224,
458307e0-2e36-46ad-b94c-8717ceab9df4,Romelia,90,77,12,88,22,78,367,
83bba269-cbe0-4c7a-8f6e-7c4aac82ae9e,Romello,42,22,23,75,63,33,258,
b767c8e9-b3bd-4c9c-90f8-3d5dabb1bf28,Romello,34,43,0,4,28,50,159,
7650adcb-ffab-42f8-8de3-53ccbf673178,Romelo,26,50,82,41,69,90,358,
5ac841f4-89f4-4786-9247-ef9699de904d,Romen,94,13,18,77,5,28,235,
36811e80-ee8e-492c-892f-d545d1cf8ea5,Romero,10,15,72,21,73,52,243,
7f0da39a-5034-4654-9c49-1c1db2e1c87e,Romi,50,16,30,83,24,70,273,
e65debea-da55-403f-bad3-e65ddfb248f5,Romney,4,3,44,13,52,16,132,
87b57efd-1e3d-4886-b501-957532422fab,Romon,41,61,36,78,6,76,298,
6d7d363d-3c9c-4bdf-abaa-15776118088f,Romona,81,50,2,52,29,51,265,
e15a429c-bda2-4b68-a6ab-456be26cbe34,Romulo,5,42,9,54,27,95,232,
0f52fe77-408f-4944-afd6-99c4e9f1f47b,Romy,21,92,49,99,20,52,333,
1814f5f4-6905-4982-8e53-370f7c7a5a6d,Ron,43,35,93,79,96,58,404,
984ed4d4-567a-4044-8c0b-8e4d15abfadd,Rona,98,49,6,43,56,71,323,
6e8a3164-059b-41a3-bc89-6f10ef7dc594,Rona,22,68,43,44,43,5,225,
de0c3665-1abc-4c8a-9c95-36608baf79b6,Rona,88,17,62,62,2,44,275,
d40d383b-bbe4-42f8-b191-1c3759b395ac,Ronal,62,74,79,56,14,59,344,
c40fa9e9-3092-4aac-b563-675ee660d687,Ronaldo,64,18,18,25,90,71,286,
96946e2a-4b1e-40a8-b58e-c9a530ba4fa7,Ronav,38,68,72,88,99,49,414,
689026ad-dbbe-40ba-9b6b-0aaf4538d7e2,Ronda,94,87,68,6,34,87,376,
dff069a9-8809-42af-bf24-5df8dce5764e,Rondell,94,41,93,0,22,94,344,
f8bebaca-2ce2-422c-9b0d-7fa50e11147c,Rondell,96,84,34,18,31,10,273,
ca4d4fe6-3def-459b-a1ed-f0fc42a0d41a,Rondia,25,75,52,92,29,70,343,
cbbf543a-6807-4200-b1ae-71d448bbf85e,Rondle,39,26,9,49,22,15,160,
cd56d6bd-ef05-4721-bfb8-2fe0cef3fa38,Rondy,86,3,44,78,99,70,380,
f2cd4bbf-3b3e-407a-95d4-94fa197d847b,Ronee,67,23,54,37,88,84,353,
66b31feb-ffc8-4264-8e2f-c3183dbb85bc,Ronesha,51,10,5,29,40,14,149,
b6e8fc77-f3b6-4d7d-b3f3-35c31fdfc94e,Roni,28,9,65,61,1,49,213,
f891c180-c0a6-424d-8bf6-4dabc8179e7e,Ronita,1,58,77,61,22,7,226,
b42f05e3-ebc9-4801-aeb0-07b3a587df2e,Ronita,10,83,11,65,22,75,266,
9d686954-1145-4c9e-882e-96999f7cd7bb,Ronya,86,3,35,36,29,22,211,
258ad09f-9ffa-4407-8702-bec68cec6d84,Rook,33,43,6,17,25,17,141,
29c4770e-13e9-46f2-93b6-b32a1cf55e2d,Rook,44,63,23,73,71,13,287,
970faf67-2d2d-4b1d-bbe2-7271c878539a,Roosvelt,44,18,7,75,86,98,328,
c772e3f8-b132-4e7b-a97a-a368713d4c08,Rori,95,59,20,25,66,67,332,
db9a0e63-650c-4ee8-9f69-634b8711b31e,Rorie,36,67,7,1,85,68,264,
3caa60f9-7d48-4ee0-9002-336ab9b26d20,Rorie,90,60,33,15,46,15,259,
b14519e2-3dcc-44dd-9b34-9af9f897a6a9,Rosabel,15,4,5,75,60,94,253,
062f319f-dfab-43c1-8f95-310631bc4a1b,Rosabell,72,92,59,0,55,15,293,
7e69e708-64a9-43db-abd2-85e37e7e2d22,Rosaire,25,79,37,4,12,92,249,
8464cc86-f975-4cdb-ac68-257fc59c4916,Rosaire,86,53,42,58,16,65,320,
e253930c-479e-481b-8392-c449a5d0b4a9,Rosala,68,84,45,16,36,72,321,
2c36f3cc-70ee-4940-9a77-8dc0d55c7401,Rosala,40,91,73,42,11,13,270,
fac51ff9-19e3-458e-8097-18eea2d318f2,Rosalba,46,29,47,100,98,77,397,
2cf212b7-cb4e-4c1d-a617-c556c12bb9e0,Rosalia,95,69,62,75,59,13,373,
eb094f8b-a626-44a3-9e2d-774231d5a361,Rosalynn,98,64,85,28,2,2,279,
b5a79a73-8abd-4e86-97bb-ba73680ad36c,Rosangelica,45,69,83,0,35,29,261,
ffcec7fb-4883-4a7c-9c56-2383c33f81a1,Rosann,50,84,5,30,0,12,181,
768e3e9b-c3c6-46ac-9df2-2fd9e4742a6c,Rosary,22,36,52,48,13,58,229,
b431b4ce-be53-4271-aea6-d44615bd5f15,Rosaysela,95,34,24,68,66,50,337,
63238af1-a0fe-42f9-a6c3-7502ee1674ad,Rosbel,69,60,94,81,38,92,434,
f1de087d-010e-4abf-82ba-157f5887eaac,Rose,3,19,68,0,44,2,136,
b89ae06d-590d-4f2d-89fb-11bbf8190129,Roseann,24,21,43,1,10,7,106,
65e9ebbb-f04a-466f-8766-bceeec12585a,Roseanne,74,21,54,73,73,67,362,
8517ba4d-cdbe-4cfb-898b-a40b4dd3a666,Rosela,32,0,72,83,28,7,222,
ba1d0b27-bad9-4942-b1a2-32ef66675b4d,Roselin,59,9,86,45,68,49,316,
3535c1b5-66a4-4dc9-bb54-3553829d39ec,Roseline,87,85,30,85,4,79,370,
4bb50402-73f5-43e1-a1fe-00d588f37516,Rosella,16,50,56,27,39,90,278,
6d9c298d-8e44-497c-ad43-b17b5cd6a83a,Roselle,42,7,55,14,78,22,218,
cbffe873-5513-45b7-be54-20bcdc44a4b9,Rosellen,81,26,49,8,5,54,223,
aadf28c4-16cb-4758-8a21-c82c659f969f,Rosemond,79,11,48,67,3,70,278,
9264826b-2c7b-43fd-a9f1-aa5e138c4705,Rosena,51,77,2,35,36,53,254,
76849499-8c6c-49d4-a8f1-bc831d791f99,Rosette,19,57,32,75,35,19,237,
a7a4d4a1-a940-440d-a286-737c4222444d,Rosette,88,48,49,91,95,30,401,
4ada2bc6-11a2-4a2c-8dea-0b27d113d872,Roshan,0,61,35,43,78,78,295,
894a2960-2840-46f8-bd9f-46a563730d6e,Roshan,88,46,92,7,97,91,421,
f4cc965f-8213-429b-a2e4-9139c54a88ea,Roshana,13,70,85,62,29,51,310,
38d3d92f-3248-40c5-8933-c3f0905a9722,Roshana,84,15,30,55,85,24,293,
59f3fefd-0e27-4647-9d2b-e7dc93e21aae,Roshell,82,33,67,78,16,62,338,
25b5c9f4-7e01-49d3-803c-4c2a9b498493,Roshonda,55,95,87,27,46,23,333,
594f7e1c-9c43-4fc1-a9d8-4c7c580a066d,Roshun,40,32,57,50,25,56,260,
3ce42f95-54e4-497e-83b4-e93a692ccdb9,Rosi,75,95,94,65,98,84,511,
26f3ad87-8554-4cb4-b818-6c28dc3f286f,Rosi,61,65,40,84,100,6,356,
068a91d7-4dcc-44f2-9e99-fea50b5e133f,Rosibel,74,69,22,77,44,37,323,
9cd7b9dc-5250-4f30-994e-470be1abe035,Rosibel,18,44,17,77,82,26,264,
77724377-4722-4d4b-9e06-9ebb566e3133,Rosie,79,76,84,75,40,94,448,
74fab51d-8f58-406c-a778-f2a46e0f14e4,Rosilyn,19,12,48,52,83,100,314,
94a6c354-824f-4a30-87f0-880922f098f2,Rosina,35,8,7,31,86,88,255,
728f6bf0-cc0c-44b8-bf95-586564f135b5,Rosmery,18,96,10,92,73,58,347,
b7352153-8dd3-4bf2-9db0-9c1187a80de9,Rosy,86,39,41,62,93,4,325,
1b4018d1-f686-46b6-a35a-655fec4e2395,Rothana,94,81,81,52,59,91,458,
4a6894c3-f0f4-4ffc-bf19-d924c19f9651,Roverto,30,28,95,6,52,42,253,
0537aabf-a3fe-4b5a-83cb-f97a264a1949,Rowen,89,95,38,41,13,51,327,
aac19c3c-cde3-471f-95be-fae3e5b7cda6,Rowena,0,60,16,0,39,49,164,
f16d3b5c-bec9-4c23-9175-98d2339b4013,Roxana,72,97,29,18,94,77,387,
68adffec-ccf7-410b-9bcd-733920e330dd,Roxane,93,89,58,1,32,14,287,
156c3074-b4b8-4ced-8926-322539efa0fb,Roxie,89,44,68,63,6,46,316,
a2fef59e-b2b5-4f11-8d29-db2fd2fd42d0,Roxy,98,68,16,71,86,39,378,
6b4e3cbd-4e6c-4f52-a1db-a5eebf6c6ab1,Royal,38,80,23,87,65,27,320,
5f9039e5-afe3-432a-a9c6-36ae9bf042d5,Rozalyn,42,20,51,77,94,48,332,
11202f5b-63f8-4264-8e3c-82b0b996690b,Rozanna,41,40,31,100,36,0,248,
3b788cf9-6422-4d48-8975-20e835711b1c,Rozena,76,50,22,62,77,17,304,
631c0e18-35ca-4637-85ad-d2beecac61b8,Rozie,80,82,7,82,91,5,347,
9f576b2d-fb7b-4b5a-b3ba-3f0df918d8e5,Rube,30,12,64,74,41,94,315,
6d13e7aa-289b-46a9-85ee-fabd6767c8a3,Rubel,45,80,96,65,23,53,362,
fc8cd408-e9ee-4448-8b0d-f391934fd2d3,Rubell,87,96,6,35,90,20,334,
2581c96b-2c56-46e7-98ca-e42b0e0901ad,Rubell,42,74,87,48,81,68,400,
8e727b8a-67fa-4939-9f02-7db354fd08df,Rubena,32,10,67,12,52,42,215,
4c575338-c910-4780-b13b-76a5ef8fb447,Rudine,38,65,68,71,22,31,295,
0b5069de-6615-4894-9dee-55c32451de77,Rudolf,30,44,93,34,22,20,243,
3accd4dc-861c-47f0-9c84-6444a416d5d2,Rufino,63,17,36,46,35,57,254,
7eab9645-ce88-451e-8307-bdf0499debf8,Ruhaan,25,27,98,43,56,69,318,
015c56a9-1a08-4e5c-9b79-386bcbb3ce17,Ruhaan,88,48,71,82,43,29,361,
30500dbf-c0bd-4f57-9b1a-acc6dc314bd0,Rumaisa,7,68,79,96,90,89,429,
213d7a2d-5a17-4665-9e3f-b728203801e3,Rumi,42,62,68,29,61,22,284,
2a7858e1-a254-426a-95b3-e1ce927086b5,Runette,29,0,19,71,83,80,282,
6f4f610b-fd6f-49bb-b038-37485a656be9,Rupa,66,58,29,3,12,91,259,
5619076a-d005-421d-9c05-8ff53fd63e56,Rupert,24,85,18,53,59,66,305,
286faa53-9942-4508-8a9f-99cea65a131b,Ruqayyah,67,46,21,64,3,30,231,
6e708edf-d972-4b14-b22f-7086012e353e,Rushi,30,8,38,51,91,63,281,
f550cf8b-bff3-4859-b668-d0cba4def2f0,Rushie,59,66,58,20,62,55,320,
a677b3fe-f5a9-45f1-91f8-ba98b24bbe53,Rutger,58,20,28,38,74,10,228,
19e9a253-a7c9-47da-9326-804ac19ea6e0,Rutha,65,89,71,73,22,18,338,
2242df58-11c5-4720-9bb2-3f8ec5e3144c,Ruthanne,62,82,6,56,15,42,263,
343c6ac8-2922-47e9-828f-b79310818ce9,Rutherford,15,86,11,36,71,11,230,
012de306-0a73-403c-8ede-8ad0dc7f06f1,Ruthey,38,77,10,31,38,15,209,
a0f503bd-68c3-40fd-b391-406e20d912c1,Ruthie,38,39,29,61,60,88,315,
0c360766-01ee-4d3f-bb7f-dddb083b17d2,Rutledge,14,19,63,37,41,74,248,
b733e3ab-0c3d-4011-be53-066333a3e716,Rutledge,26,73,36,37,48,10,230,
40066dee-d2aa-413e-b4c2-831ffe8ea133,Rutledge,58,56,20,94,78,16,322,
b8b06814-0edc-45a5-92f9-b02442cff9a5,Rutledge,89,39,14,3,96,100,341,
b38a35a3-b6b7-4c26-924e-a5c924570086,Ruwayda,11,18,72,19,84,2,206,
dae0a46c-2df4-40f8-bb7b-e92d6aa3e07e,Ryah,28,89,86,59,89,18,369,
06e0a72a-0f05-4ef2-a38d-69a992ff4052,Ryah,75,46,38,61,56,56,332,
3f890824-5593-455a-9514-6b2dc50b40e2,Ryanchristopher,17,47,97,34,59,25,279,
02e2a1e6-05b7-49c2-98df-b2d02b7b6df7,Ryanchristopher,54,47,55,89,12,72,329,
262bb90d-092c-4e3f-87e2-c6ecb53bbdc4,Ryane,87,72,1,20,11,69,260,
0073e954-81a9-4c56-80f6-a3c66ef145f8,Rydan,57,89,87,48,80,63,424,
10ca460c-e831-4fb2-b036-6dab67764e8c,Ryden,70,93,97,29,16,86,391,
aab90d35-f213-48e5-ae42-6f261b98569a,Ryden,6,41,1,96,0,73,217,
b98ffb0d-82ac-4411-9243-93e501c10573,Ryen,44,81,25,53,14,64,281,
284e6d03-4b31-41b4-87c2-5c69ed7ca274,Ryla,41,8,64,100,91,69,373,
da977ae2-c8ff-408e-bb4a-d9f910f465a1,Rylen,49,41,71,75,52,92,380,
d0c694a6-d110-401b-a4ee-94cdf34923a9,Ryler,2,26,69,3,85,100,285,
dddee05c-3066-4d6c-9023-65279ce85b7f,Rylin,91,50,19,80,55,77,372,
78515ea7-5975-436b-9a30-bef2c9d645de,Rylin,82,21,90,87,53,37,370,
180c13c2-b8a9-4abe-bfd9-7af111512ba0,Rylyn,95,21,5,73,84,77,355,
e1908a28-cb45-4ba5-a93d-db732a0125ad,Rylyn,78,79,18,29,17,66,287,
d85b0a37-3987-48a1-ac5a-1fe506d3b570,Ryman,6,100,84,42,90,12,334,
781732db-636a-456c-bf49-e8403384385b,Ryman,57,60,19,1,84,45,266,
8bd425e2-4841-4123-9745-6b3f202c35eb,Ryon,40,99,59,3,98,63,362,
68bb6961-92dc-44be-bdd7-a073d7a42b44,Saad,75,8,33,4,72,51,243,
fc608323-89c7-4cd8-8412-9d8fdddfac8f,Saahil,0,82,25,55,27,76,265,
dd67c07d-5dc9-4174-84c1-66fcf9b3f435,Saahir,1,18,44,5,15,93,176,
63cb58e2-7601-4be1-9697-479f71ce4cc9,Saam,67,50,29,97,97,32,372,
9ab66b80-cb79-466f-a545-ebcdf55e8441,Saanvi,71,43,19,33,5,34,205,
a74de38c-b87d-421e-ab29-d8abdf9a0f9b,Sabarin,54,71,93,14,25,65,322,
d935e0c9-6205-4d9c-b213-ba9114bee949,Sabarin,70,51,51,84,25,98,379,
d1064b70-34d4-4783-8c23-978ee319f5f3,Sabastian,80,79,36,15,86,98,394,
903114e2-1244-4572-b640-63cb31c1066c,Sabbir,90,94,55,65,71,81,456,
10f5cd2c-5143-4aad-a6bc-7cd8c0611573,Sabella,32,96,76,44,23,50,321,
f0d02bf2-caee-4c3e-bd5a-cc41d7d4274b,Sabian,82,4,56,6,58,88,294,
0f6cc21e-3e8c-4dc5-87e6-ae06862b5209,Sabian,76,74,30,1,70,36,287,
b43fd970-c796-4e59-9cde-15209d51574a,Sabino,97,87,69,95,9,100,457,
50746432-0ff6-4aff-93b5-ebecef058560,Sabino,12,38,8,84,26,70,238,
7c1fd7e2-c748-4ea0-bce6-867f38c254e6,Sable,57,0,2,54,20,87,220,
bd50ba4b-6a97-4f5d-be9d-3108cf171040,Sabra,79,96,66,5,99,20,365,
63f647d8-7e72-4abf-a3cf-78ace08cedfe,Sabrena,67,56,43,84,89,89,428,
e4bf0bd9-6713-4740-928e-7bbc017d9424,Sabriya,9,56,74,65,87,88,379,
07d2d337-8487-4910-8e5e-60bb25dbf33c,Sabriyah,37,20,40,22,69,72,260,
7dba3fb3-636c-43c9-a7f0-62e546e1ca20,Sabriyah,75,73,76,20,83,0,327,
115331ee-8564-4c6b-95c1-f80306d1df23,Sacha,43,57,74,2,88,63,327,
eecb77b2-bc8a-4cfe-b327-ed1422158d3e,Sachi,95,79,34,16,65,19,308,
ab300abf-3000-439f-a887-6b00bcf938c5,Sachie,7,73,96,35,56,6,273,
5be418c1-0419-4a87-9377-af718573ff78,Sacoria,72,4,30,32,48,3,189,
b33f4a64-19a3-4016-9fb0-881c52251269,Sacoria,83,50,16,65,40,69,323,
e4d0c401-6a8a-4be3-8da3-481048212717,Sadam,4,88,66,49,95,18,320,
601d02d5-d49f-44e9-975a-638394daf601,Saddie,35,64,61,88,12,6,266,
da473acc-59a8-4f7b-b0f9-b247bd736ed2,Saddie,55,23,35,12,72,65,262,
e6b6ba47-7ae1-470a-a285-23bc1263c689,Sadee,59,34,1,67,1,24,186,
4dc4601f-c386-4d62-a6d2-d2c972d745d0,Sadee,31,34,20,88,59,57,289,
475458c0-fdf5-45f8-ba23-d05d4e3bf901,Sadey,21,87,20,94,7,76,305,
9938ec36-5618-4f43-92dd-bc86b8849177,Sadi,99,47,87,4,77,61,375,
5ecbbcd0-6799-4ea8-b7c6-ca79151050d5,Sadie,9,57,34,36,25,35,196,
47c446a5-30a9-4ef2-bcda-06bedd37f088,Sadira,9,86,52,67,11,68,293,
e6fc826e-bb2b-4b9d-b5ba-830aee4f9eef,Sadira,40,93,11,65,16,96,321,
e3092447-8ead-4ae9-b1bb-cad551d6c82f,Sadler,66,40,12,66,62,96,342,
a87186fe-ca43-4186-bafd-afef6c686c44,Safaa,6,30,95,40,60,39,270,
095b78ab-5b37-4efd-bc1a-aaa072251242,Safaa,71,92,89,3,42,74,371,
2a6529c1-dfff-4ef3-b455-8b91dc5640a6,Safaa,15,54,15,96,1,60,241,
02f13750-63c2-45a2-a672-06d94ab58b03,Safiatou,84,79,71,61,23,32,350,
dbbf9e83-92a8-430f-8c95-96731211e3f7,Safiyyah,64,17,66,95,75,85,402,
f3b30c54-68ad-4ed5-8334-59dc494d10ab,Saford,29,28,86,46,61,88,338,
145daa37-38ef-4009-b2d7-a118851cdc2d,Sagal,25,0,39,97,88,10,259,
20a97174-728c-44df-b3a3-21a2e1ecc868,Sahib,82,10,47,61,60,93,353,
471fd4b2-c10f-431e-938a-3016c76f8deb,Sahid,3,88,72,51,80,45,339,
0c003fe1-6303-49bc-9e5b-5a46fc9b6a3b,Sahid,45,18,5,13,93,65,239,
100b3997-a905-4773-86b7-43982896a78a,Sahid,84,19,38,95,26,54,316,
3177ddd8-9729-4b10-8716-cc890fa3b3f7,Sahil,33,40,58,50,21,21,223,
73aea89d-0302-4ffd-89ae-0795f37ece35,Sahil,75,77,58,9,81,99,399,
94752dfd-8ab6-4334-9a00-44614af722ad,Sahir,22,76,9,48,35,17,207,
922b5fca-7262-415d-8cfa-da1a96571cd9,Sahir,84,73,84,80,67,79,467,
e23ca3c5-d98f-4ed0-a6e3-07191cbe6441,Sahira,32,26,22,21,23,9,133,
b5d5f4d4-6a67-45c6-b9e5-83e318b44287,Sahiti,21,35,84,69,100,69,378,
236b975e-db43-4897-8a74-ae431eb36072,Saida,53,53,44,8,78,88,324,
eef990d6-d568-4636-833d-c27f21cfd548,Saifullah,52,44,25,88,44,59,312,
4f2e454a-1c35-4d96-b5a5-90cb725bc800,Sailor,19,70,28,53,15,59,244,
04ce4e14-3ab3-47e2-9597-121c4a5d211b,Saintclair,87,3,42,24,21,60,237,
e4b5e47d-db98-4cf0-a473-827776c25a9b,Sair,91,64,91,53,92,85,476,
387c9f49-c8a5-4dcc-ac7c-4a816994945d,Saira,100,23,86,83,17,10,319,
44fdac68-e22e-4f2a-84d8-97161340bb9a,Sairy,58,91,87,52,74,39,401,
e2bcb17f-097d-4ac4-bd87-a936d52d9b28,Sajada,60,94,42,32,61,69,358,
97dea787-bc81-4f22-98cc-8bc3fc365419,Sakae,19,21,47,66,53,19,225,
1b16d8b5-8c41-41db-ac64-bad75348fe9f,Sakara,51,67,3,37,63,42,263,
140ef852-9eae-4d5b-ab8a-a801f0b61735,Sakari,91,81,84,90,58,49,453,
23af5ac0-2f6c-481e-82c5-ccd612d876c0,Sakariye,17,43,30,80,74,71,315,
2888149b-99d2-4baa-889e-f45beea77351,Sakaye,8,30,49,30,50,36,203,
695b59b1-415d-4046-a780-4004f0f43912,Sakaye,38,95,80,20,99,48,380,
d759e72c-a3fc-4120-b754-8c5b3e248fc1,Saket,52,98,31,42,73,3,299,
bc55a9e4-6df4-479b-9d4d-aff314de9102,Saki,16,24,49,14,14,96,213,
717cad47-98a9-44ad-aaa9-d78c08dde38b,Saladin,48,58,52,34,41,37,270,
ff46c29a-f0e4-4168-a769-87e37d80579b,Salah,70,56,54,92,42,94,408,
09b251a7-7364-4ad1-b521-2a54cac03d6b,Salam,41,23,17,37,57,56,231,
a84d51f7-dde6-40cf-a8c3-2a18e43452ab,Saleen,50,19,64,21,98,55,307,
77fe559f-2d1b-4b5e-ab51-07741447827e,Saleena,38,87,30,34,52,26,267,
501c6010-7701-43a5-a798-0380e18aa478,Salem,80,72,56,41,22,13,284,
79d19b5d-1ac8-4659-818b-751f72e89d54,Salem,75,16,5,92,22,17,227,
bd61761a-fe81-4893-bc94-7c14526311ad,Salih,77,95,36,41,85,67,401,
b41a1737-02b5-4851-9220-d04d3241c0ee,Salih,55,24,47,14,64,62,266,
23b67251-9c02-426c-981b-248b5c563062,Salih,47,96,13,11,62,67,296,
c8702662-2766-4e4b-a7f8-35c0c595fb14,Saliha,60,11,39,23,32,17,182,
c9f37d3a-af78-4ea9-9982-7fa56b54c397,Salim,66,57,91,42,62,9,327,
5a7f0834-af3c-4a1d-82c6-d099607e0316,Salim,80,82,10,8,4,0,184,
b92c96b9-1283-4b8a-ae37-8cc35d7bf7fa,Salima,24,75,42,64,59,52,316,
e050b5c8-d6bc-4372-a435-abaf0555fa1e,Salimata,26,1,49,7,34,44,161,
f6f52258-0333-493d-914e-dec4feacac00,Salimata,8,80,96,31,68,36,319,
a60f5a35-080a-4a5f-b4e5-1b60cb5ad54c,Saliou,37,71,37,87,0,27,259,
3d1fea3c-78a6-49d6-b815-f52664ab4730,Saliyah,66,15,10,31,44,2,168,
0275bf95-1338-4f9b-86b0-4fd11e574d94,Sallyanne,55,29,91,41,58,100,374,
8042b4d4-5ec2-48c1-a5f2-b91e0d22f040,Salome,4,11,43,92,45,65,260,
b6b92a4e-5a4f-4e51-bc0a-b84467a8361f,Salome,73,27,68,0,71,35,274,
e0a074f8-52a7-42f4-97a7-24ae493a21d9,Salvotore,85,96,94,84,94,32,485,
b95ee991-6499-428b-af92-453b0118e6f4,Salwa,49,4,20,85,64,29,251,
db980bc8-b345-49fe-8c29-7a89f67e3e7f,Sam,5,14,93,44,81,56,293,
128ba1c6-f755-4fc2-bf23-eccf2bb5b3d1,Sam,85,82,77,57,79,60,440,
48241a1b-099a-4f54-bca2-6d3ae2fa8859,Samad,53,83,72,57,36,83,384,
d87e4777-42b3-4919-9a25-89213b25d9b3,Samaira,48,34,56,78,5,25,246,
c9fac4f7-21a5-43a8-8b7a-6f4b69fa29f3,Samaiya,53,24,28,57,47,11,220,
72802237-aeef-4a12-92a0-988274356e94,Samaj,16,79,58,30,26,64,273,
3f04d066-9c20-49e9-b776-d2078cbd3a31,Saman,13,96,52,31,99,67,358,
7e6ecfa9-39f4-4505-bbec-986f9818a49c,Samanatha,21,61,7,67,5,31,192,
4da9e6b9-33e2-4c77-942d-44f8b374c09b,Samanth,73,41,11,73,80,43,321,
04ed2af3-c359-4127-bc1d-47a498c78894,Samanthamarie,17,88,34,35,46,3,223,
6f4aef97-d1e5-42a3-a25b-af30b613f3ac,Samanthan,32,22,16,19,59,26,174,
57fdcd5b-a613-4305-a8a0-c064983d21d6,Samanthia,33,28,43,99,25,6,234,
17dfad18-b21d-4ae2-9ed3-f74c9edf5d73,Samarth,56,75,54,28,12,42,267,
16ab5e97-0c6d-4dbb-94e8-6db3670c1205,Sameeha,39,68,72,17,17,64,277,
33af161f-d442-4528-b12b-4a496598105f,Samera,25,69,8,34,59,32,227,
ad73eae5-7c8e-4f9a-a4f9-5de4d31d0a36,Samera,74,76,71,25,70,69,385,
e7ab7fad-573e-4600-bd72-070130e5c20e,Samin,28,0,32,88,80,53,281,
2152b346-3b4b-4cd7-baa5-537b3ff63b23,Samina,60,59,46,68,81,62,376,
7b064364-7f6e-448e-b2f3-e1f4071bb262,Samina,69,90,86,19,97,34,395,
d7cb5197-730f-45a3-84c7-f9df7d2bea65,Samiul,6,62,40,75,59,78,320,
f8c4ab55-d94a-4894-aead-358ff2a2d7be,Samiul,95,89,46,93,26,60,409,
26c6ed72-ea7d-4f2a-9af9-8709e41d28f0,Sammi,44,39,25,36,59,31,234,
99ac1e22-4749-4b80-be7f-7d5ebcec31a3,Sammie,62,3,50,46,25,41,227,
30d651dd-fcf4-41bd-b817-eb018c3d5948,Sammy,28,21,76,57,88,74,344,
21f55688-d5c0-4023-b8d3-7988f2c3f42c,Sammy,6,52,2,34,24,5,123,
2c5b036d-4631-46b0-938c-81f77732877c,Samnang,24,81,0,0,24,32,161,
579df3c7-a953-4451-b720-b3c08f5c9899,Samona,34,87,75,53,45,98,392,
61c3278e-6f82-4803-884c-4bcdcfd1dd0f,Samora,33,76,21,71,92,54,347,
2f822863-3657-45ef-ab01-c2f07e467cee,Samorah,22,73,64,43,92,67,361,
c0632a1a-2676-41b3-a45d-460adc08a177,Samori,68,93,75,92,16,88,432,
fc17ec6a-4779-4b6e-96ab-d562b3341a65,Samual,77,20,56,32,44,99,328,
47daed43-ccae-44b9-8661-10969f0afc42,Sanaa,68,18,99,29,33,75,322,
033c1069-5056-4695-a453-3b63746b5571,Sanae,47,63,9,13,62,35,229,
7e0b843f-8c06-44a6-8a64-04a4a522342d,Sanah,54,38,74,18,7,62,253,
e1ccc5b6-857a-484e-b052-c605cda19525,Sanah,95,20,63,38,0,79,295,
3aa21fdf-b89e-4f42-b106-7246204b7b56,Sanai,91,18,4,18,39,100,270,
1a9a705e-32be-498e-a53f-e99e15f7ec8e,Sanaya,67,100,59,9,25,10,270,
d52e579a-e3ca-4aed-a083-425dc35f76e8,Sanayah,94,77,95,78,23,36,403,
57deb452-dd68-4b81-9a58-303efd8653e8,Sanayah,61,99,91,62,65,89,467,
1d6ef356-5378-4d13-9547-477cca2cf7bb,Sanda,34,24,4,43,14,63,182,
072f1cbe-db4b-4975-8c5c-a04e26761764,Sandee,14,79,28,11,21,12,165,
b601854c-1092-4a4e-9e73-9234e5f29083,Sandor,34,31,34,87,85,11,282,
f53a5a0b-3866-4c13-b511-ef353c046148,Sandro,85,97,91,31,51,11,366,
a6fdfaf9-c754-4e2a-a3d2-86d2806643c9,Sangeeta,67,23,95,74,16,59,334,
1640d1e8-5255-4566-ab40-c87a8b027fac,Sania,47,2,42,3,21,96,211,
4425f76a-882d-4fc7-a2ff-08e0d0a43a1b,Saniya,41,20,28,25,26,6,146,
fa0586fa-f124-4e4d-b004-ff97614c68b5,Saniya,49,79,86,92,74,99,479,
82ef7b9e-550c-44ac-9ef9-d6842236090f,Saniyya,64,13,31,71,80,61,320,
1ba88935-f94f-4ee3-9800-0bd1a439cf19,Sanjana,43,2,21,49,18,95,228,
0dc09b32-5a44-4e49-bf39-9a3dfe318728,Sanjana,35,35,71,18,80,39,278,
cf2dc47e-90d9-404a-ab9c-6672cd572703,Sanjay,54,13,95,100,74,93,429,
5cf08148-7b94-4caf-bb08-6ffccc764467,Sanjida,80,68,25,0,46,0,219,
e6c7e838-f7f6-41ff-a4e3-5ec104c886a3,Sanjuana,30,38,50,96,74,69,357,
3bc865c3-d315-4592-805f-19eb863711ad,Sanjuanita,29,16,95,32,42,51,265,
55c330ea-b840-459e-b92d-04811ee385ef,Sankalp,26,56,0,9,14,3,108,
17f6a002-7370-4157-802a-bfe1738de78d,Sanna,65,59,73,11,3,49,260,
f3d2565a-69b3-43dc-a101-46cf90162bbf,Sanora,76,40,57,95,94,73,435,
7db00ec7-0338-48ce-a0e8-92c3412c577f,Santanna,1,68,97,0,58,51,275,
26320dd9-a4b9-4dd4-b778-438ee10bbe00,Santario,48,62,86,29,40,57,322,
e1c31a00-3f41-4696-ac96-b855706012ae,Santiago,91,28,48,13,52,78,310,
90fa29b8-95f4-489b-81e7-2b019557f61d,Santo,25,61,58,54,98,5,301,
c1f73299-9645-4260-8ede-74efcdea2901,Sapphira,21,39,5,91,26,65,247,
be4f71a6-3dad-452b-9d63-9c66ccc74346,Saprina,17,34,99,70,23,41,284,
adb00574-d881-4c77-a320-901b1e0b2179,Saquana,70,93,80,32,3,61,339,
3f04733d-75a3-48cd-bfd7-41ca7c4a206f,Saquana,85,1,31,89,58,15,279,
a2d2072e-9a6f-4302-b8bf-db1998e5453f,Sarae,43,52,36,53,49,12,245,
4e5167b6-b9df-44ea-b449-5e274bcaec53,Saragosa,64,21,70,97,37,90,379,
77a4448f-5b92-4b26-bec9-68bc5504c8e3,Sarahjane,72,43,58,83,82,55,393,
e8736bfc-8b18-470c-8e9e-deb380bd5a69,Saraih,29,87,83,43,17,96,355,
3c42ebbb-1910-4cd7-827c-6565cc889966,Saranya,61,86,72,15,8,27,269,
343e8095-63ca-4504-b9d8-5e086b55124f,Sarely,49,64,89,99,75,2,378,
d2888769-3ce1-4ddf-ae7b-22bd1edd829d,Sarika,82,18,45,23,100,70,338,
b0433589-4595-4e4e-962e-00c842a2f8d8,Sarith,82,2,53,78,90,55,360,
6972cfd2-0b4c-4fcc-877b-9ebdbfd40d59,Sarrah,70,16,95,93,99,95,468,
98e6176f-3231-4c94-ae8c-e4cffce8c4a6,Sarrah,74,59,0,82,70,83,368,
13a33d62-3b6d-4ab3-8035-bc9a55266deb,Sarrinah,84,58,30,22,69,71,334,
2f1d70a2-74b0-4f1e-b50f-69943b04dafa,Sartaj,4,22,63,72,93,36,290,
4e60b51e-3e4c-4850-8a6c-bd206384ab72,Sasheen,91,36,81,41,71,35,355,
c630eafa-9e9b-4c6e-a708-2739c99edb05,Satoru,68,62,43,94,12,95,374,
e031b8fc-1831-498c-862f-e832d44c80bb,Satoru,57,28,92,68,43,48,336,
28f77224-0839-4d83-862e-8e3a18e0190c,Satsuki,38,70,100,86,31,4,329,
b1e580b8-56d4-4713-940a-e360b85ae7ae,Saud,96,57,18,8,38,0,217,
f1909677-a3b2-4b2d-ad2b-e9d5012c642a,Savanah,48,80,48,36,12,47,271,
d04c86c0-b885-411a-a0d1-4b6aca359051,Savian,17,42,92,64,98,23,336,
f4a35e2f-d501-4b3c-a84c-788b85cb1dd2,Savion,13,64,3,33,25,34,172,
baba771c-032c-438f-815e-7d568ce82d2e,Savior,30,27,47,61,61,61,287,
9cbcdd78-7f12-4f83-a3fe-afde1326b9e5,Savon,72,10,42,95,47,58,324,
a5310d81-46ad-4c16-9391-cc3636249149,Savonna,41,36,27,66,91,3,264,
2357d0a1-d5ed-46fc-94ba-ac58b86a18f1,Saya,75,30,93,42,24,3,267,
294bc424-ab6b-425d-a8a4-0e5fb061a08b,Sayda,12,75,50,61,53,23,274,
0cbb19a9-f8a8-451e-80a0-54120cb3f025,Sayler,9,27,7,28,3,48,122,
539f8ce3-f3da-40de-b190-e685714474c4,Sayquan,31,48,65,34,48,78,304,
1d418ee9-3127-4433-80b1-d2b60cc08b6d,Sayquan,58,55,46,99,12,19,289,
0808611b-8691-4d92-8816-322d90ea95f6,Sayra,33,49,0,29,93,40,244,
381c73d0-5964-4db0-916e-c5fbfbe68d2a,Saysha,34,54,31,82,47,86,334,
9c2bba76-c517-49f5-9bac-24e4be16ccaf,Saysha,41,52,50,3,95,78,319,
4a3d2722-ce3e-4cfe-b6d3-8eae80fb0e18,Sayvion,81,55,3,46,89,7,281,
0cc316a0-8af2-4f79-9837-de3727af67b7,Sayvion,3,85,36,34,68,5,231,
683d007a-56da-4556-8e05-93bde97a7665,Scherry,68,68,80,71,47,91,425,
ed1c1ab0-6c4c-4592-bff5-c90204802ce5,Scheryl,6,27,33,97,50,87,300,
3021e53d-6bd5-4970-b709-27c2fb1dcb09,Scotland,44,27,78,89,14,72,324,
41e2a927-eee5-4bf2-b8ba-0578747ad80c,Scott,60,46,86,17,59,61,329,
e1b21a15-bb28-462f-9226-eef68f6b3732,Scotty,76,93,13,84,34,73,373,
a0b0d6ae-63dc-4d98-9efc-84d9ab29af1e,Seabron,31,67,71,76,67,58,370,
9260cdaf-7db4-41a4-8686-eb359b986f51,Seaira,38,15,81,12,1,63,210,
a6bbe5ae-ef63-4d00-95d4-dbb2ce4835a2,Seanna,92,33,13,61,79,42,320,
2ac7f15d-18dc-4612-b4ca-06e246720395,Seanna,97,14,43,36,61,28,279,
1b188439-a09b-4e3f-8fc4-f4b014c2c242,Searcy,90,91,0,92,66,92,431,
5903ae3f-a9b7-4efb-b4b7-0d1487adbf45,Season,35,29,30,71,9,50,224,
4876951f-c08a-4da3-bfda-77a9a1bd9238,Seavy,41,82,64,30,71,79,367,
96123455-5e30-485d-b6f6-295afde76eb5,Seavy,69,98,6,80,69,88,410,
bcdd2bb3-30db-4d3d-8810-363781b8b92b,Sebastain,78,75,11,93,54,29,340,
50ee9ab7-f58b-44ed-86da-81f784835099,Sebastien,83,84,94,29,16,22,328,
a2302654-5480-45c1-9d59-12616f185a71,Sebrina,21,40,78,79,68,75,361,
d97b772c-56ee-4223-96a0-f04d98a1f431,Secilia,74,43,80,70,57,81,405,
9dd73991-de1f-44db-b21e-6680528cabb9,Secilia,16,100,27,96,12,10,261,
6b53966f-018d-476d-8f22-5c20c361283b,Sedgie,14,31,45,20,62,64,236,
98a35123-f1bd-4512-844d-30243301a874,Sedona,84,66,24,84,13,86,357,
08c6832e-d038-481b-b70e-ea4d5ac8abe5,Seema,48,10,62,55,53,96,324,
8bdac085-976c-482a-820e-52f9d5fd2332,Seferina,9,20,22,2,21,42,116,
7377f7d8-5328-4e04-bf5f-4d315a47c568,Sehaj,40,4,33,25,67,4,173,
fcf0ba3f-bdd9-4e75-94cf-8611807317f6,Seidy,96,62,46,25,64,45,338,
36e5d40e-2f9e-4562-ad14-53ee8bf7fb14,Seidy,72,25,2,66,75,22,262,
00c4ff52-8b7f-4d55-9b5c-075ec588d65c,Seiichi,21,30,85,26,28,73,263,
de7dcebb-7b01-498d-9fe4-3dd8c9b712f9,Seikichi,49,100,75,43,94,40,401,
33a8204c-6224-497a-974e-712f89de0b7b,Seiko,99,29,16,55,58,44,301,
6ae1e337-b5de-4a70-9057-d94fba2d6fe6,Sekou,86,75,68,62,86,49,426,
8f9a9011-6b4b-4b09-892b-9e84cc39006b,Selbert,77,62,49,72,97,34,391,
88d8e680-ee54-4f1a-ac73-da3bc819a0e9,Selbert,94,83,94,87,57,53,468,
122e9019-66c5-49c0-ab0a-853184dc8283,Selbert,44,78,75,100,64,61,422,
2d1f6cc3-b444-49eb-88b8-7b6552ab2f19,Selby,64,84,63,4,72,0,287,
672e1b39-666b-4653-84e2-d8b4550f3cb6,Selda,63,61,71,89,30,43,357,
096f8166-1347-45ec-b579-8dee39f20b9e,Seleen,37,8,88,34,99,38,304,
003875cf-5c4d-442c-a67f-7c50016aac3a,Seleena,25,10,10,18,23,43,129,
6f39ef02-4417-41ec-baab-ebd6184e0435,Selia,85,61,12,42,67,56,323,
6c4cbb7d-1b73-4817-94ae-1ff665e6086c,Selia,5,36,19,56,10,12,138,
6e07f9cb-b478-4fc6-a5a4-69992ec08b47,Selim,4,29,42,38,99,11,223,
3c2e3103-cd62-47f4-845f-25a3cc10dd89,Selinda,45,5,9,61,98,75,293,
9985672f-439a-462a-8776-14ca74ecd60e,Selmer,17,68,39,92,92,46,354,
aab4cad3-24be-4a68-8032-1f3364aab22c,Selvin,87,73,65,71,22,69,387,
49f1a931-d4f9-4502-b84d-a46f8073e48f,Selwyn,95,99,87,13,42,84,420,
9ab27cf7-7022-4cbd-817c-07a593903e73,Selwyn,58,55,96,94,96,9,408,
f8bef902-8999-4052-95d0-4312ee2dbed6,Semisi,33,34,96,96,95,15,369,
7094803b-61f4-48b1-846e-3fa5145ecdcc,Senaida,63,18,1,72,79,77,310,
7e4bfbc4-dfd8-470f-b4db-6455968f6645,Sendi,17,76,5,76,85,85,344,
0c0b389b-946d-486c-a615-c65812e11deb,Seng,5,77,53,4,65,65,269,
e8f8431c-9862-4f2a-be1f-c58301967462,Seng,76,49,51,7,64,93,340,
b2bfd9e4-cda4-432a-a0cb-731289c184f7,Senia,59,29,7,43,96,45,279,
a75e3352-2eeb-47fa-8a73-63e979e04e80,Senona,51,24,92,45,45,15,272,
55d99f57-78c6-4d98-91d9-74ec0d7c524f,Senora,26,91,32,6,35,22,212,
809a9a00-66fa-4168-9619-23347edf06a2,Senovia,2,22,43,38,61,19,185,
8bad07d6-a575-4ae8-98d3-39b7fa5e2217,Sequan,16,13,22,14,7,21,93,
58f5f02c-f882-4671-b31e-a44dfed13445,Sequan,15,20,74,85,31,96,321,
4659e453-d8ba-4320-be12-491bd9b6cd74,Sequoia,97,14,64,74,49,6,304,
d32e7646-d00d-4dd7-ad34-0e769e3afc54,Sequoia,6,57,71,52,45,35,266,
a7e9758b-aef4-48f6-94a0-ad0fb621532f,Serafin,67,89,76,77,9,80,398,
02d4276e-6516-445b-a944-0ac7148b32de,Serafina,56,8,62,1,18,48,193,
517fc031-d5bc-4dd5-856b-dbc2b1ab56ce,Serah,10,11,1,50,19,26,117,
3b77262b-56ef-492e-8658-249d8c084b07,Seraphina,21,69,4,9,73,10,186,
5354366c-f31d-4b53-acfa-bd01dc2180d3,Seraphine,4,71,99,82,54,39,349,
9df810d4-e4ff-434a-9833-26da5838017c,Serapio,56,76,90,64,72,68,426,
57d2c366-d735-4f90-ad2e-acf4830650d2,Serenidy,70,48,28,30,24,93,293,
f2667616-53ce-4413-ad64-97114b15a11a,Serenitee,9,12,10,29,33,50,143,
5a66eeaf-092a-4eae-aee4-8aa15a15e8ef,Serenity,11,48,78,99,37,81,354,
ca76b483-6858-4ab1-9fe7-07804814d269,Serita,52,13,28,54,15,16,178,
9a672546-85b7-48b9-a5ac-a8c7d0d3992a,Seriyah,23,20,78,33,90,21,265,
fab0c881-fb32-4cbb-8bb6-17ebc628abd7,Serra,22,59,56,51,83,93,364,
ba07166f-1832-4ffe-9ef8-20d405ed05f7,Serrita,16,1,53,38,78,49,235,
00521dbf-069a-413e-b4cc-643c260781f5,Sesar,45,46,18,25,75,71,280,
17b3ce6e-1e48-429a-b29b-bad2d8418c8a,Sesar,66,50,61,20,7,10,214,
890abeda-d135-4ad5-aa10-bb08a73de66f,Seth,98,96,94,50,38,7,383,
29c7f1c8-2143-4166-89ce-d9e1e70fca91,Sevag,81,20,62,42,90,10,305,
f2f145a2-b42d-4171-b9e6-367573cd1abd,Sevanna,21,69,97,91,53,8,339,
1620e335-aa29-40ac-8ec2-7d257aa7d642,Sevinch,17,12,100,36,6,66,237,
126b7fff-e976-4bf2-834e-ea7b46ecf87d,Seward,39,9,59,77,99,22,305,
e872664d-41aa-471b-a468-6a114c893eda,Seylah,9,79,61,55,9,82,295,
bef587e9-171c-405f-a7d5-e7519874634f,Shaakira,11,92,0,8,34,56,201,
b5e17f3e-c01a-4f34-934f-cdc12eb0f4d0,Shaan,91,15,4,58,68,83,319,
2f8d3722-3f85-41a2-8c67-0973f3838cb6,Shad,79,18,22,54,46,71,290,
f8afe012-7ac0-4d4a-9f27-e339cdee9d18,Shadai,14,82,99,15,34,31,275,
2f78cddc-1d1d-4a9f-9499-8b89fc60997e,Shadia,60,65,42,37,36,100,340,
bed4eae4-197e-48a3-a9bf-992420205947,Shadman,87,33,35,75,62,46,338,
919e86da-2ba8-4c26-9c9f-d37e69783972,Shae,5,80,62,5,6,92,250,
c20b5628-14dc-4719-b5dc-98ca71390699,Shaft,62,84,84,64,32,82,408,
e7114d1e-345d-47ba-a92f-fa53896adb47,Shah,65,33,12,48,40,5,203,
929cd613-3794-4f48-b558-d75d88fc50fd,Shahab,52,81,60,54,94,95,436,
b9f3b00a-1acf-49f6-91f6-c654aa1cd944,Shahd,99,22,52,75,88,74,410,
7cf50e31-ca75-479e-ae8b-5526987fea99,Shaheim,20,76,29,46,77,35,283,
8ef76a0b-a055-4657-bfdb-9e37b37641f8,Shahin,75,93,60,89,78,24,419,
b6175c15-fcef-4ad1-9d2b-7d262510e3e2,Shahrukh,3,98,88,65,35,94,383,
7cfe6baf-6aaa-4ab3-9328-2166f8b1a063,Shahrzad,71,53,15,75,69,71,354,
e7a3452a-342e-414f-a1fd-f124a8d3cfdf,Shahzaib,67,85,28,66,79,0,325,
c05fdfe2-d90c-418c-8577-069823f41b4d,Shaindel,4,53,14,57,49,71,248,
93162ce9-50d1-483a-9e6a-82f1f558f7d0,Shaira,60,25,9,79,82,97,352,
09f52e3b-1890-4fde-87bc-1d5bc8f6802d,Shaka,75,63,26,10,71,99,344,
9661845b-fd4b-42c0-85b9-2b4d58fd0fb1,Shakara,27,33,21,10,44,22,157,
75b5be9e-9251-4be6-b32d-03226da4ec7b,Shakeeka,100,11,43,23,4,38,219,
2756dfec-5bcc-4087-a979-0c69500b218c,Shakeem,50,21,66,74,63,34,308,
18709a8f-c7c3-4841-b6fa-ab393a02fb27,Shakeena,90,21,88,94,88,65,446,
95d03f06-b0f4-4a33-a165-d957b950820c,Shakeera,96,42,7,98,43,41,327,
c3837191-c877-4b7d-b421-13a40680cd7a,Shakeeta,49,100,72,78,18,22,339,
6ab1650c-8972-460f-8560-05635862fefe,Shakeil,64,42,24,10,44,14,198,
66a317c9-2590-446e-8229-0952b062edc4,Shakeitha,57,52,21,40,68,13,251,
fc38e3a1-33d4-49a7-b271-944af907edd6,Shakema,6,36,18,16,42,86,204,
28f67dd1-044e-46f4-b94a-189c4ca28ff7,Shakeria,52,88,32,37,29,53,291,
62d7e63f-28ef-4494-b0fd-fe69e0433dca,Shakeria,52,25,49,62,70,58,316,
237a7b15-b1fc-4f71-a90d-5564a2791bc3,Shakevia,62,41,70,32,41,93,339,
aface28d-546c-43d9-9b02-588f716b7598,Shakevia,47,4,43,90,48,90,322,
02c9aad0-32c5-4980-951c-df82be88d30e,Shakiera,0,18,41,99,77,46,281,
0d423b9f-62c7-4783-a916-931942126892,Shakil,45,76,72,78,84,90,445,
6d39dd71-1835-4ea7-b02d-18ac1dafb553,Shakina,30,61,50,6,2,35,184,
cda04d24-9236-474d-a6bf-3731b1abaf0d,Shakina,79,22,84,58,89,11,343,
a016bfff-801e-4980-9681-e45175632df6,Shakiyah,28,75,95,70,34,24,326,
04b4595a-4809-41f1-b19f-86ac1babe9d9,Shakiyla,47,71,22,50,57,34,281,
4160c5a8-a357-4b3c-a7e8-41c68e409f52,Shalane,85,81,58,4,66,0,294,
fe9912fe-fb83-4ddf-937a-d2ccb7af88f4,Shalawn,92,12,63,72,22,65,326,
a21830f5-f59f-4aca-8e60-c3823f03a122,Shaleigh,87,76,36,67,51,95,412,
e0230ea0-250f-48c3-b87d-e828880efb58,Shalene,73,0,93,5,72,25,268,
29ddc9bd-e386-4351-9d36-4aa617b69ed9,Shalia,27,80,47,68,26,10,258,
4c6d5744-bc3c-418a-b582-c33a808eba95,Shalimar,21,85,96,30,6,19,257,
67246c3b-cf8b-4a9f-999b-1a712448bfd8,Shalina,27,49,43,58,92,31,300,
16dc242f-f1c9-4707-987f-d716bc6a47f6,Shalini,29,40,97,99,24,74,363,
15fa6f8e-9ced-4864-b589-33553cd38954,Shalini,57,96,95,5,5,75,333,
0dadacfb-add4-4dfe-800a-a62c3538f853,Shalise,82,88,34,70,35,12,321,
deab5194-60ec-4a9e-8ef9-b3592536191b,Shalita,36,54,9,20,17,93,229,
ee73758a-546b-4f38-88b5-d33d55526a44,Shaliyah,71,43,29,36,97,78,354,
161f6d86-9083-4694-a5cf-47cde35ed0ad,Shalonda,61,48,47,43,69,52,320,
4650104a-628f-4e67-804a-1447978e4f2c,Shalva,59,3,72,6,27,92,259,
2aa7ebe2-db40-4d4f-8414-4d3b5dc2f377,Shamarion,50,14,7,45,45,82,243,
db0e61c5-4ae4-4379-9563-8eca62e62f2b,Shambrica,21,42,24,13,97,5,202,
5f901a9b-3bcb-4b46-801e-552974cdefd7,Shamel,62,49,25,3,15,92,246,
c2710d6b-38f9-4d0c-8ffc-7f5d25dbbb5a,Shamell,57,2,79,12,57,88,295,
ff9cd156-a31c-42bb-8457-8ecb36068e8d,Shamiah,56,94,88,39,2,56,335,
ea7d37a7-c087-4632-94e5-96fbd17c93ac,Shamika,64,74,60,87,6,96,387,
1e16be8b-b3b4-4701-8558-3bdd1a86af84,Shamila,3,17,44,9,7,32,112,
68c36a28-77fb-42c6-a82d-f5e802a2f017,Shamila,92,76,34,56,24,1,283,
fc1a3978-472c-4825-8b33-e532858b3f92,Shamira,74,29,51,62,8,50,274,
4c6b4999-3259-4a4b-9c59-0c5421d5671a,Shamiracle,8,95,49,14,63,7,236,
2e6c36a7-b6b0-44bd-a95b-4a322e6a4469,Shamiracle,9,27,25,42,40,91,234,
abebc94a-1bf8-4cb5-9f96-c11a137adf3d,Shamon,30,23,97,76,83,40,349,
461b3a6a-10ea-4140-a463-f6212e160b94,Shamond,23,49,92,44,86,87,381,
c926d5d1-4f50-4136-9bc6-3c741170cc02,Shamyah,4,64,79,35,30,6,218,
409238c7-671c-47da-9be0-ffb27f274ae3,Shanard,8,57,20,50,42,99,276,
735f3a5c-4e81-4979-9852-4af7c97e5fc8,Shandee,98,97,43,93,81,67,479,
c103c828-0b6f-4e74-b8a2-b7fd113200b5,Shandra,35,100,16,89,95,87,422,
284cdf6f-7088-43c5-adf7-b0c3be8b3bbf,Shandrell,58,10,41,10,27,12,158,
0c7bd565-e059-4dff-9615-3806aef452c1,Shandrika,20,49,8,63,61,86,287,
a2eada7c-d167-4b85-afce-a5840dc45307,Shanee,83,41,15,23,61,17,240,
e10606b0-0a9e-4f7b-a10d-f3a9a166e3c8,Shaneeka,98,89,90,62,41,96,476,
a8bd40d6-f951-4ec8-a80e-78503927e556,Shaneequa,1,76,53,86,80,17,313,
5c4c2134-2349-4a54-b517-096eb057008c,Shaneice,44,91,19,32,56,73,315,
bf29aa4e-e019-4c55-b75c-51cc68a4ecf2,Shaneice,13,13,7,2,31,19,85,
066ba447-8830-424f-9953-79c10f8f58b2,Shanekia,99,30,49,36,19,77,310,
41f3f74f-c10b-4f0a-9db4-2a930074baae,Shaneque,1,48,93,56,18,82,298,
b43927eb-5c27-4d12-9ca6-b40c287504b3,Shanequia,76,91,35,88,41,74,405,
ec751fd8-dfcd-4e14-9e2b-c528930d8488,Shanette,34,28,11,38,52,68,231,
324ab2dc-2930-4432-b305-628796657caa,Shanice,87,21,41,58,43,37,287,
fe71933c-77c8-451b-8acb-5697a5bd2115,Shanice,41,89,17,16,55,22,240,
44896972-567a-4a73-b6e2-2fdad671f677,Shanieka,32,10,99,74,75,70,360,
a88fad68-a9dc-40b9-b679-48fdf5a55705,Shanin,0,18,0,26,12,57,113,
0453c758-9299-4b02-8437-ff8dadfd275b,Shanique,77,28,68,76,48,43,340,
34757a9f-b2db-4887-9445-21b28e402f66,Shanita,73,15,20,39,22,73,242,
04704675-10ce-4a3e-94b6-56bcab9a6c74,Shaniya,96,80,76,83,53,63,451,
ab4fd094-290e-4919-aab7-49b73f7ed8e1,Shannan,39,93,19,16,51,62,280,
6f65e8ec-bfbf-4940-8862-e3f64975947d,Shannell,90,10,75,3,90,3,271,
186223ce-728f-419a-8e79-bd8bbf1de34c,Shannen,78,1,47,90,66,0,282,
d6e02ae2-9bf1-402b-84da-865bc0eb9824,Shannon,68,68,89,68,65,79,437,
ffc4c9b8-40c1-4814-8196-e99409b362fa,Shant,27,29,31,58,16,82,243,
34780a65-398f-4efa-bcc6-b0be2d3a14a9,Shantall,79,30,72,65,80,13,339,
ad7f41a6-48fc-4e48-a5aa-9339a3af05ef,Shantay,54,6,8,71,59,35,233,
b8e95a8c-dbe5-4102-a1fb-85c78f38bd14,Shanterica,96,56,99,57,72,86,466,
ea2bd7fb-1d3f-46e3-accb-04b73d4bf59d,Shantrelle,47,22,72,6,61,27,235,
5535b243-cafa-4d13-8e99-02be40bfdd55,Shanya,9,28,51,75,49,93,305,
1f2ba08a-010f-4352-a9e5-42fecb97fe91,Shanya,20,77,64,16,72,40,289,
da68dab0-ca01-4e47-a7dd-389115a3a698,Shanygne,50,49,20,68,21,26,234,
58932c2d-fcf8-4c18-a7de-b54927c36532,Shanyla,44,86,76,35,60,54,355,
5286516c-a29b-459d-965c-2bd50939c654,Shanyla,8,83,56,69,47,27,290,
b1d56c53-847d-4f9f-bba7-5e4249d524ce,Shaquan,40,36,32,17,18,97,240,
642249f4-8305-4ac0-842b-5c43063f53fd,Shaquandra,30,95,49,72,98,6,350,
c2c48b37-4c71-451e-b9af-1b85696ccb04,Shaquetta,68,58,5,35,67,92,325,
33b15518-1d9b-43fc-b446-fa46947cbe72,Shaquetta,38,87,50,47,100,92,414,
b0150bfe-efbd-4535-985a-3591fde38793,Shaquill,51,20,61,74,65,2,273,
7bc82b4e-f9a5-478e-b002-d22873738d87,Shaquille,7,12,34,75,36,99,263,
fc2001a9-7ab7-46ce-a12b-076b60263db3,Sharaya,86,72,8,5,45,94,310,
88005bd2-e287-4218-9496-432edb8e8e1a,Sharayah,0,46,46,36,51,71,250,
9d5363e0-fa51-443d-aca5-7bf6bd590a27,Sharda,54,37,49,26,2,1,169,
94a4d644-3eb6-407a-861a-a75b0a9ee794,Sharda,77,76,55,40,64,28,340,
4600ce5f-41ba-424a-8542-560bb3ede3dd,Sharday,65,46,78,60,25,0,274,
82c9883e-0b0d-4698-9fd6-a4665d0d0f9c,Sharday,2,63,55,85,16,82,303,
a1acba9d-5862-4068-91f5-b52677783c83,Sharde,30,82,11,70,51,60,304,
ccb265ec-a84b-4e4e-ac67-75782e5bcaa5,Sharde,95,36,32,54,98,14,329,
c147c537-6648-4ea6-ae55-67360e6e3b7b,Sharee,63,43,69,57,90,1,323,
b55501b6-2c04-4230-a105-03897d7cdf75,Sharell,10,74,16,61,24,8,193,
d1e784be-0374-4adb-809c-2bb5b6ecd96a,Sharema,15,41,48,30,15,0,149,
a662e6f0-9ed3-4a9f-81c1-1e71d1932bc8,Sharene,8,86,24,47,3,15,183,
77d25f23-48d3-4ded-989a-5231d47c09c4,Sharene,53,62,90,98,27,84,414,
b53f2366-96fe-46db-8116-6fa6dc59aeb5,Shariah,30,74,34,63,51,18,270,
57c903bb-c517-4d37-8413-de1adfafa986,Sharie,16,51,53,7,11,69,207,
56cf29cb-60d5-4ebd-8bef-afa138002103,Shariff,98,46,40,45,6,73,308,
1f448608-851c-4edb-9006-5916090a5fb3,Sharika,26,21,20,5,56,96,224,
f9497a65-3123-4534-a1a3-e4db079190a0,Sharine,3,5,33,53,51,72,217,
f8916fc0-476d-4969-a9c6-b19143152090,Sharion,26,44,2,31,39,87,229,
25d2ddc6-9f3d-4280-96f5-a35cf32d881d,Shariya,11,99,14,91,71,32,318,
7e3e5be9-d406-4b46-a6b3-932495afaf68,Sharleen,85,30,71,2,2,45,235,
ae189264-4ccb-40e5-96c2-44b354492aa4,Sharlette,31,36,37,54,4,58,220,
fa22f8a1-af4a-4bfb-b44a-3f7c1e5cc2c6,Sharlize,89,21,44,30,83,47,314,
a4e7fae8-3e73-444d-aa0e-7e4e0801f6f9,Sharmila,64,65,36,83,17,48,313,
697ff1a2-79bf-4dc5-badf-15d1cc496f5c,Sharmila,30,93,42,64,98,30,357,
08e7a773-000c-4599-a618-3fd4dbda3a15,Sharnae,100,62,96,86,41,99,484,
de496cae-949a-4bb2-ae5b-cc3c2d1334ca,Sharnae,75,11,60,61,31,54,292,
d47ec2ed-16b8-4393-a32e-69161865477e,Sharnice,94,43,92,80,11,40,360,
12b3df07-5e84-4835-8431-4d7d039c76d1,Sharonica,72,35,52,37,33,26,255,
9dd45805-8675-43a1-b9cb-003d7386d84f,Sharrie,97,41,83,45,92,24,382,
0b6da1f9-6923-4475-bda6-c6595c68ed1c,Sharvi,54,58,51,23,21,91,298,
b3fb272b-aeec-46b5-af78-697883072cb6,Sharyn,83,5,72,94,25,76,355,
0c04da6e-69f5-4da7-b903-ee78a3b350c0,Shashank,33,97,59,93,25,7,314,
a0fb52a7-9179-4d89-85fd-eccb22ba92bf,Shatavia,86,63,65,11,31,18,274,
49db32bc-8994-46a5-a17d-7b5551f2a5f7,Shateek,93,27,43,25,32,42,262,
ba310348-acc3-43ca-a05a-60646c9fbe5a,Shatema,88,27,66,37,77,69,364,
af2ebb28-5f46-48b1-9e25-944a0a59cb85,Shatema,38,47,73,8,4,82,252,
2f1bd505-78de-4b76-8d12-832b84e781b6,Shatina,11,78,25,78,82,24,298,
30dd408e-8b22-49d8-a29a-3f363737cda7,Shatoya,32,25,63,96,96,53,365,
03cbcd1e-b259-4b93-ae96-bc7b8e728090,Shaun,50,61,63,91,23,4,292,
a7c5e818-8084-448b-a656-aab125b7564b,Shauna,7,29,55,16,100,38,245,
a443f576-21ba-4208-b1d1-7054f343989a,Shaunt,48,67,53,4,7,3,182,
65d46bc8-69c3-4e0d-ae15-db1deb81b84d,Shauntal,33,49,97,27,71,91,368,
eb599356-4d3f-488d-baa5-545ffe5a76e2,Shauntavia,45,49,99,89,39,15,336,
035263ef-7915-4ed1-9290-4fa5b3a5860c,Shavaughn,53,20,14,86,61,77,311,
d89f6583-63be-4748-b84e-7e9695c06c86,Shavona,41,74,81,10,82,100,388,
9109f541-076a-4651-94f0-ec9146685ae8,Shawanda,82,48,51,51,27,28,287,
21ea32c9-19af-4d11-a10d-7c6fc521b0fb,Shawanna,59,29,44,57,47,86,322,
c7ce1bf9-fd0e-4235-a2eb-89d0121eb802,Shawna,88,93,66,6,7,58,318,
c8d23c4e-bea2-494a-a0cb-d2da26192a53,Shawnice,97,30,88,11,81,68,375,
47b19149-cdde-45af-a4e6-4202a3cdc484,Shawnie,91,29,99,59,18,40,336,
6d96f63e-627e-4b5f-9585-30b01495d88d,Shawntae,4,40,66,27,35,65,237,
9c88a7f5-18dd-4746-a0c6-27d20b44393d,Shawntee,24,34,10,28,37,97,230,
3532b7f5-1ec8-4714-87be-23af8da1ecdd,Shawntrell,45,5,89,16,52,83,290,
38ac0bff-12e6-4205-8302-e6664488ef4e,Shayaan,53,46,66,25,72,66,328,
b0eaf79a-117b-4813-8316-4a3d31248ee2,Shayanne,26,17,9,97,99,2,250,
1d346ed3-9fa1-47ed-a8f4-42dd9ed680a0,Shayden,20,36,81,25,78,65,305,
4a7f1bc5-abf8-4d64-b972-1b1c32bcd128,Shaylea,95,97,95,82,59,8,436,
d627be77-71a3-4df4-9902-ecfec0da5afa,Shaylea,84,4,39,97,45,71,340,
542cd2b0-c912-4249-9581-be5cf9c72315,Shayleen,57,11,56,42,63,99,328,
66fa2226-77a5-4ce5-bf36-8dc7a4112283,Shaylynn,10,21,47,36,81,95,290,
f0b4cbd4-fc31-4714-8fad-3944d5f551a8,Shayma,64,72,21,13,12,47,229,
917c26e3-fed7-42ae-bfeb-6e81cdcc91d4,Shealyn,13,81,66,45,94,40,339,
938b3dc8-08c2-4d1e-a18a-ed41ca8002c1,Sheamus,94,22,48,24,76,33,297,
d3b8c2da-5323-4788-82bd-481e2172d547,Sheccid,46,18,74,93,63,69,363,
432481bf-3a1c-4fea-b140-41c9d07f517e,Shedrick,78,14,23,23,89,2,229,
24e8a186-9dfe-494c-a82d-ccefb4b5d9b8,Sheela,86,77,36,99,63,7,368,
154c2d62-bfa2-4f5f-98ed-753f92d77b95,Sheena,85,27,55,86,52,24,329,
04086caf-ae44-4e61-8adf-f8a3f8ea0e65,Sheetal,61,41,98,29,67,4,300,
4d2b8d7a-eaca-4a05-b5a0-f046131a63fa,Shefali,73,82,30,64,47,46,342,
2cc4a8b6-afac-4be3-b3c7-0b41e97b7715,Sheila,27,100,66,11,2,58,264,
0e7fca9e-9f0e-41ff-a391-6591f8b4930d,Sheilah,75,81,39,56,53,96,400,
6332001e-e618-4339-8c01-7b4dfa356c4b,Sheilla,1,78,83,43,47,30,282,
786af295-6b5e-4f55-ac80-3b456a3871a3,Sheily,33,15,91,20,57,8,224,
463740a3-c692-4095-9711-606e90a62485,Shekia,8,8,9,29,77,42,173,
996fb266-6467-4479-8eaf-9e6e37e43efd,Shekina,68,87,96,91,1,29,372,
fd176230-dd0d-4c7e-b2bd-cbe89001db92,Shekita,37,56,28,61,14,18,214,
d6904f90-e27f-45a0-8153-ce57e1332713,Shelby,12,52,93,65,69,94,385,
63089806-2c73-42bb-b721-30d57d123eb8,Shelena,97,58,83,76,42,70,426,
383b5b72-6133-4120-82e3-3c35185ac022,Sheliah,69,17,24,18,32,50,210,
a9a85ba2-63a8-4dc2-af97-519ed2c1f78b,Shellee,48,80,59,53,51,65,356,
31fcee22-0e16-4569-a818-76773d80d646,Shellsea,10,1,51,98,37,99,296,
866bf6f7-2db7-48ca-a18e-b7c11eff13c3,Shellye,76,18,92,76,33,69,364,
5ec9e768-7858-4ac1-8e3b-cfa4bc4d9c70,Shelvie,63,57,95,15,40,15,285,
b878c7e0-0de9-418e-abce-4e1a416a0b39,Shemekia,85,71,60,16,55,52,339,
fcb461cd-4d30-400c-909a-86ba5f768b62,Shemekia,12,84,98,14,25,69,302,
8aecefc8-8e6d-4bf7-852d-0a971f26cdd0,Shena,50,83,32,89,23,75,352,
0f9eb917-1698-452a-a896-6a62b37c8d84,Shenae,30,41,84,73,13,73,314,
14671d77-f5f9-4098-8922-18dd67d38c18,Shenelle,3,15,88,62,51,19,238,
07f8fcbd-a31d-4452-95fb-e129336a9ae1,Shenelle,27,86,22,12,14,63,224,
bcfc2065-a3c5-4980-a0ec-5970143dc664,Shenequa,1,18,18,67,0,0,104,
e3a57bc7-eba2-41c2-86fd-299c06f71c74,Shenouda,5,40,22,32,78,19,196,
af00ad25-15e5-48c0-98dd-0eb401937466,Shera,6,58,98,35,92,10,299,
cd77a5e5-8648-44df-b397-fd0f16ac13fd,Sherah,41,60,48,91,57,2,299,
4bc23a4d-ef44-46ee-bd21-97e6e0979049,Sheralyn,95,67,58,61,4,77,362,
b50f3502-a30c-4f44-a770-21e8823ffcfd,Sheralyn,67,67,82,47,50,26,339,
5f60dc4c-6352-4ce1-8f9c-28d61dfafb14,Sheralyn,4,57,69,20,31,21,202,
92a6da3a-6497-4204-a7db-9a7bd4860550,Sherece,42,5,75,52,73,83,330,
31dbd091-83ad-4ad2-b65b-8176640d2df7,Shereen,71,88,16,54,18,42,289,
1a4e6b54-c414-4f0d-8958-b5d9cbe013e4,Shereen,1,8,8,0,55,12,84,
698b63fd-6a21-45ca-a486-84dae8b7db16,Sherene,47,0,21,51,59,99,277,
e6646916-2934-4fe1-bbdd-8e4780168556,Sherese,58,84,16,89,72,11,330,
6af9db41-c2ce-40ab-8202-63d12a168818,Sheridan,13,45,36,17,46,72,229,
b9b623a9-ee53-4a1d-8d11-a2a5f9705a50,Sherif,27,69,55,13,33,1,198,
96307f40-cc10-4b19-b156-fce108aab4a2,Sherley,6,72,1,96,6,30,211,
658bebc4-4a05-4da7-abb2-dea0eb852935,Sherley,56,53,55,56,57,29,306,
56e90286-7e55-4b1f-ae5c-fde0aa22269e,Sherlynn,16,25,47,44,70,97,299,
630fd906-605c-485f-a977-658307a4427d,Sheronica,54,80,30,18,96,89,367,
c71001fd-ff52-44cb-9987-5efc032de5f3,Sherra,100,82,18,60,71,3,334,
26623c91-2c1d-4198-b210-65b17575e77d,Sherre,14,26,26,67,66,84,283,
f1fc2e77-1ec0-4851-9b8d-8bed5d1642f3,Sherri,70,47,17,77,83,96,390,
62f0c0c8-38b3-4f30-8769-ebff4940e61e,Sherri,61,60,94,94,6,37,352,
ab02be94-fdc1-4052-b217-5b2444360a93,Sherri,68,83,48,68,46,67,380,
46c0f73c-674e-4561-9f80-e0ff5c34e8f2,Sherrian,70,60,86,3,7,40,266,
d01cd449-bb36-4176-902e-cf30e5ae9b63,Sherrilyn,42,54,6,87,80,64,333,
2b3cacd1-dfd1-4a05-9ef8-f03da7645499,Sherrita,86,28,71,92,49,77,403,
58fc9b31-dd24-459f-be55-9ce7c5a95e0e,Sherron,86,80,31,81,32,34,344,
e2cccbd0-70f9-46b0-b25c-267cef9349e1,Sherrye,63,16,90,44,13,88,314,
8a2b30d7-8e75-467e-99a8-745b4828901f,Sheryle,5,12,22,67,16,4,126,
c3dad904-96d0-45bb-bd91-b229e337d912,Sheva,11,78,94,58,45,6,292,
80536e20-c335-41d9-b449-bfcb7bb0f583,Shevy,91,88,80,23,52,91,425,
e62a49b3-0f54-481b-ab0b-bda42683e230,Shevy,93,48,81,74,99,29,424,
968299ce-9959-4972-b410-b6182e5366cf,Shewanda,27,16,4,30,46,19,142,
5b50a7f0-f42d-47ac-a1e3-a751b6b91157,Sheya,41,84,36,44,18,38,261,
497eb25e-fcfb-4e89-8085-54b7b2b44f2f,Sheya,47,64,18,53,83,24,289,
7c58374d-7f0e-4444-92ae-62966f01901c,Sheyanne,75,32,52,15,70,20,264,
0c3cb843-1fec-47dc-91b7-1e44a47404b1,Sheyanne,79,3,15,57,75,97,326,
d3bad129-0682-41ef-93b8-bafc4ac02bfe,Sheyna,91,96,8,53,98,57,403,
1c768a8e-ebd9-4c0c-8cf8-981f9eff245b,Sheyna,1,82,43,31,95,13,265,
7736ec1a-e96e-49c8-afae-d608fa03acc7,Sheyna,33,38,76,100,52,97,396,
df590ee5-5729-48a6-bdb7-28fbc9bd4c96,Shian,51,55,9,59,87,29,290,
7dfcd06f-3ae9-48c0-8321-c077e746b5ce,Shiana,23,59,13,41,74,49,259,
c34a9c6b-9bfb-4dac-84b8-9f738ae1281c,Shianna,84,92,15,56,78,49,374,
11dcaf8c-4377-43a8-a48c-0691dfd3e7ed,Shianna,66,75,83,34,25,41,324,
64ff5bb8-f5ff-4799-959b-a11ed3c06f40,Shianne,9,79,21,39,74,74,296,
84aad1ce-b995-412b-a612-bf790d279dcb,Shields,97,98,47,7,24,40,313,
706c1546-10e6-462f-a4fe-3fa291e97a28,Shields,99,98,88,34,73,29,421,
4205edab-9ac0-4e8b-8c8b-48355bf96fca,Shiffy,88,53,63,34,45,17,300,
a80c57aa-ca4a-49a4-9cf8-e29de7383e64,Shifra,46,62,87,26,100,70,391,
21b2e634-6410-4bf5-867e-2ec5189a56c4,Shigeno,74,73,41,35,27,73,323,
c8e82610-8404-4322-b14a-386b1e8f0df5,Shigeo,3,78,98,17,79,11,286,
c986322b-c075-4637-abd5-5ae2a2cf452a,Shigeru,42,49,29,9,9,33,171,
4c1e9988-3bce-43ae-9a31-f7f1c7e9c76d,Shigeto,57,74,41,23,39,77,311,
3a4cc183-5bd7-4cfd-b931-213581f5478f,Shigeto,50,6,49,72,36,99,312,
90283117-7b12-4f01-9177-c8e9ed7c6539,Shiheem,10,73,9,87,35,5,219,
1a1e7d90-edf3-4eda-b6bf-f68d65c53a50,Shila,45,39,99,60,32,4,279,
5312c693-e8f8-462b-a6c4-f9f57099b2fb,Shiloh,6,22,26,66,79,38,237,
5cc968aa-47ed-4571-a339-7ab1b4b0b582,Shilpa,64,99,48,38,37,40,326,
dfa0e068-f1dd-4ea3-8b68-9d36c5cff11c,Shilynn,10,29,85,61,3,15,203,
b79dc7e8-eddb-4c4d-bddc-e3889904cf27,Shin,24,10,71,6,8,12,131,
e0ecde3c-0b0a-4997-97f0-ffc042b45325,Shina,55,47,68,53,76,84,383,
9c915894-fab7-4b9a-883b-a117feb7e318,Shindana,62,53,64,38,57,67,341,
d5aea530-ea25-4f8f-8e6f-644f81346085,Shir,5,82,29,91,10,13,230,
649f5ae4-9aed-4535-b340-d7153de24bc7,Shirel,85,42,20,24,56,9,236,
dea3c552-6fd7-4b45-9a31-662fa0c39357,Shirl,77,7,4,53,17,3,161,
dc3420c4-cc86-4be5-9801-07d46de7ca40,Shirlee,83,99,77,98,56,68,481,
f827f6ec-1d77-4e4c-abda-8fe537b4ca51,Shirlee,13,4,77,64,11,61,230,
f21f290f-d7a6-40a2-9915-87b286048f7a,Shirlee,28,15,16,28,15,100,202,
db0db50a-a75c-494b-8a4b-b907de08b87c,Shirly,25,27,42,13,48,68,223,
9519a306-191a-4add-89ed-b0a82c4a933a,Shirly,83,76,31,19,27,97,333,
143310ea-b235-4eff-aed2-f6588c2a659b,Shirlynn,77,57,73,25,60,91,383,
964758c7-408c-4380-9677-89c1dbb66a3e,Shiro,94,0,40,68,61,33,296,
109913fc-51dd-4c2b-bc3f-11f1e394145e,Shiro,36,33,41,29,50,33,222,
f27c549b-5046-4582-831b-c1662a545554,Shiva,25,54,86,71,41,28,305,
859db194-61dd-4d09-8f6b-7f0b8bd26503,Shivangi,17,19,97,39,66,20,258,
19b1d742-d233-4228-916e-63d44dda6bb3,Shivani,10,94,55,38,18,32,247,
0e0a03f8-7580-45a0-8ba3-fe794d8cfad9,Shivon,66,1,26,61,40,90,284,
7df38a7a-a62c-45b2-ab19-1abc86f44b90,Shiya,100,62,17,10,38,95,322,
a4c4ddf9-5978-41f6-b39c-da1e0eb1cf19,Shizue,72,39,7,8,57,9,192,
79ba8bf6-01b5-4e2f-8c93-08550ff12290,Shizuo,38,65,36,18,51,49,257,
d8234fff-5962-4901-9b84-a84d857159a7,Shizuyo,38,85,1,58,23,25,230,
3a973a84-f7b7-423b-bf9c-7ca76a53e5bf,Shizuyo,90,48,18,87,81,20,344,
e1f5d7f7-8e7c-414a-bbf7-c95bac10f264,Shjon,14,31,44,59,70,17,235,
28b148aa-c662-43c3-8bfb-5415c8de7a03,Shloimy,7,31,63,99,80,19,299,
2250fb0d-ba1e-4f5a-b299-4388f6a6e3c8,Shlome,40,76,5,6,12,42,181,
c073f4eb-7802-43e6-843d-c75f25e6897d,Shoichi,62,32,35,11,10,94,244,
6f57ec75-08fe-4fdd-9686-fe2a51970834,Sholanda,29,98,18,9,37,35,226,
80b44652-514a-43c6-abc1-9b35d301ac6c,Shona,83,65,81,78,92,85,484,
b15b4957-e2a9-40b9-a2cc-9d324bc0b9ca,Shonda,19,62,59,2,89,34,265,
7cca8720-7bc6-4367-ba45-75571f26632e,Shonda,59,79,41,19,93,4,295,
36372459-9d7e-4d5f-a6a9-dc09343f56bd,Shondra,53,67,23,84,66,75,368,
e5e09423-478f-4c7f-94cc-0f7929c64e53,Shonn,75,44,46,86,11,35,297,
f09f0d50-dea2-4831-8ac2-dbc7223d055b,Shontae,61,7,85,30,54,74,311,
8e2ed60f-1201-45d4-9d3f-d6ded4f20633,Shonterria,37,79,26,62,83,53,340,
80906761-6c26-4c49-b5f1-443fd5dd90ee,Shooter,58,32,62,86,85,66,389,
a623a152-f610-4101-a6b6-14a38bd11260,Shozo,48,82,78,22,69,55,354,
32ce19d4-ce4a-4bc2-97bb-2c803d7d572a,Shozo,7,17,4,52,67,34,181,
bdae17bd-c82f-43e2-bddf-f09405e021c4,Shraddha,73,100,89,61,20,62,405,
63020115-81f8-4cd1-b860-adcea46cca9d,Shreyan,76,52,1,96,24,4,253,
266183a6-671d-45ba-849d-a13d2def1aa9,Shriya,29,55,10,9,46,81,230,
aeb14a1c-4fd0-43e9-817b-37b3e46e67d4,Shriyan,7,85,87,55,21,94,349,
9427784f-a5bf-487d-b7bb-a8b72ecc0205,Shu,100,57,88,46,92,62,445,
fa60887e-1207-48f1-aa66-a927ded8daf3,Shubham,37,55,65,89,23,86,355,
6dc4999e-8716-434b-84bf-7b51c231af18,Shubham,26,95,38,17,87,100,363,
80a32a7b-b986-4e44-9e53-d181c3fa1461,Shulamis,20,49,38,50,46,24,227,
a50fb8d2-6111-4608-b4ab-4c36d2e4683a,Shunda,27,88,31,37,99,8,290,
445ef9ce-a58f-4588-bbae-ad4009be9574,Shyasia,30,0,47,47,37,0,161,
f51d00f0-9c29-417c-8f4e-22a4ed4c3d55,Shylah,22,6,19,99,13,41,200,
bb058c78-e6c5-4137-97ac-7edcc102ea9a,Shyra,81,80,94,54,61,91,461,
204481c1-c406-4955-bf1a-f545b87119e0,Siani,47,64,34,28,77,73,323,
c25ee0b3-3659-4d7d-a086-0c742df65fa2,Sibel,21,22,17,94,93,40,287,
23c718da-5f2d-4283-add2-c23cd03756a0,Sibyl,50,84,4,50,16,91,295,
3429ffbd-7d31-4ff6-848c-7a22b215109f,Sibylla,43,45,39,15,52,86,280,
abb3af5a-7001-45ea-897e-573de9594cc2,Sicily,45,25,10,42,53,80,255,
eec65782-d664-4ac2-9f32-930a5eb182b9,Siclali,91,53,6,96,76,15,337,
29e6ca69-9eb2-4edf-ba25-7e78f5d22b72,Sid,58,63,94,59,90,14,378,
8574cf92-94f3-42da-83c0-874700908d53,Sid,81,18,63,56,22,60,300,
1621433d-bc92-4ac7-a8b0-c333e60f3b67,Siddarth,17,27,74,37,1,86,242,
685512ee-6405-40d5-9fc6-96cfa7b4531a,Siddhanth,63,81,62,1,82,97,386,
eb17cebe-3126-4042-b61a-7f61f2d23d5a,Siddhartha,90,17,43,78,22,52,302,
76850555-ca5d-40d8-a0a2-94a2199c3b04,Sidney,74,93,69,76,52,4,368,
72c41eb4-8629-4747-8a67-dd71f3bd380f,Sidrah,60,40,51,15,20,25,211,
0c59fee2-5f61-4ff4-bf45-832c5b03e184,Sieanna,88,28,41,51,33,54,295,
9973ef59-67f7-46ad-a848-ef3f07c862d0,Siegfried,44,80,19,35,8,74,260,
9e24025b-82c8-4e11-8246-1c7091a38baf,Siera,26,37,66,80,32,42,283,
5cca39e1-fbd2-483f-9ae0-e1aeab9b4a9d,Sierria,30,55,27,57,97,97,363,
cd901e7e-bc3e-450c-85a2-92a609460564,Signe,86,32,16,44,26,89,293,
feae85f5-b1a7-492e-9b6b-93b91474a2f0,Signe,19,37,77,33,44,21,231,
13375fcb-acf7-406e-adad-47f489ac8bd1,Signe,39,19,63,33,64,78,296,
6263de57-760d-4d88-a36a-9db9deeaf7a7,Sihaam,92,41,31,11,70,71,316,
c3e06abb-e4c3-4540-9dd2-299209a337c8,Silbestre,45,79,85,26,9,67,311,
8867ee25-d8e0-4d79-a87b-e51de5e38ce7,Silbia,9,35,75,98,21,15,253,
1689fa9c-ce46-4054-9047-8a9857d11de9,Silka,92,5,49,43,74,83,346,
95bcf554-b54c-4682-9db5-d2adeb7944af,Silver,63,23,14,41,82,87,310,
aca76ce1-e048-4230-8194-2db41a6a5f28,Silvester,65,24,61,5,22,55,232,
29cd40aa-2fe7-4caf-bc15-1c3983aac90b,Silvia,61,65,94,64,10,49,343,
5688c844-c7f9-4db9-9930-86d43264916a,Silviano,42,43,71,16,70,29,271,
6dc24574-87bc-490a-9763-2cda06aa510b,Silvina,17,13,40,57,21,95,243,
f530991d-ac8c-43ce-842e-2fc6aa0a61ef,Silvino,53,6,79,51,49,14,252,
104a89b1-daed-4681-bf84-ac4b4ba46eb5,Silvino,89,46,80,0,72,65,352,
5b624162-aeb4-401e-bc3a-b79926c1597e,Simcha,84,90,84,26,34,20,338,
a2e4f16f-adfe-40fb-9188-93f40d7324a4,Simi,42,72,62,61,75,39,351,
5f9130e9-1803-4972-93a1-857e0acd17e7,Simi,59,67,12,80,77,3,298,
9cf28abc-6a2c-4e6f-b34f-9cceb65ecef5,Simone,2,57,28,34,95,81,297,
b547d65f-8e88-47c7-b91a-12e3881e6f95,Sinclaire,82,89,47,54,79,1,352,
dac83aba-4f7b-419a-883e-a363bf6d7bad,Sinjin,93,55,94,35,32,30,339,
a83a594f-d8d6-475b-856d-21610c97b6fd,Sinthia,64,23,4,52,94,71,308,
48c93234-c4e3-4fce-ab2b-7f03a17df6d1,Sinthia,27,91,89,73,81,28,389,
0aa25e1d-c012-471e-8fdb-7a69714d49ff,Sintia,93,28,59,98,32,14,324,
caab2335-01d6-4481-b8d5-acff8d1166c9,Siobhain,52,86,30,5,95,81,349,
f3bbd33b-45ef-4495-82d5-c8e1470aed60,Siobhain,45,77,90,4,31,84,331,
b89e5672-3540-479e-a7d2-a1b486872319,Siobhan,68,9,9,18,40,47,191,
683a8c07-47ab-4e3b-a90f-c17dfe1b9573,Sione,56,97,53,73,14,86,379,
88a16ff1-ee41-405b-ab40-67d96cbdb940,Sione,16,98,9,40,23,59,245,
10c8596a-cb4f-4f22-b580-2aac15f11595,Sireen,33,55,28,93,25,28,262,
0d31676d-7ea2-4ddd-bb69-5d57de31dd21,Sirena,43,72,30,36,17,42,240,
e55ee69e-4904-4d6c-ad45-ad5ea2844484,Sirenia,24,15,66,54,44,58,261,
4d30179c-1440-4bfe-ae15-a9a4da2f33a8,Sirius,37,96,35,4,15,21,208,
b2341001-4197-456a-8f5a-151a3dba3614,Sissi,37,18,18,51,87,59,270,
7f8f6537-19c4-42e1-9c65-d106f580969f,Sister,16,95,32,41,93,32,309,
0e2d57f4-aae8-4907-80ae-e6bf145d9e35,Sita,48,17,41,80,37,22,245,
7e80f0bd-e14b-423b-a0e9-43566f50ac83,Sixta,39,78,18,65,26,4,230,
f7ee4f56-d33b-47d0-ab4e-b67f53c51ba0,Sixto,36,87,24,40,10,8,205,
358c40a1-6366-4e1c-8958-cc65fea1a42b,Skai,79,20,67,55,87,20,328,
766f7a93-ceb6-489c-b710-cd4a1b9b212f,Skip,32,95,90,24,27,76,344,
14d5f57c-fc10-4fb2-9044-ce52cb3469e3,Skyla,65,38,3,65,75,40,286,
9f9218e4-271c-4779-a0d7-1b66b69599c5,Skylah,3,63,97,2,100,79,344,
f1fac76b-75ee-4067-b63b-91a0b02f76d2,Skylar,86,74,25,40,81,44,350,
cc838ca7-3354-4b9e-b72a-0f3e4db419b0,Skylee,0,73,20,14,41,45,193,
c536a13c-1178-4b64-ab7a-436a69b5eb90,Skyleigh,95,52,25,34,60,46,312,
b207380a-fcc0-45a8-9b8e-86d31d0f13e7,Slaton,88,21,59,83,61,36,348,
61fc7b1e-2ebd-4810-adb5-876937df9642,Slayde,80,39,34,46,10,100,309,
d9cde783-6a0c-4fa6-ac2f-c18ee5c37afc,Smantha,69,58,73,55,92,33,380,
ea347789-5532-4f13-bdbe-d3bf7b3132a7,Smita,64,5,99,83,36,86,373,
b611ee77-8d40-42fb-82c2-522bf0397ca8,Smith,48,16,15,92,74,59,304,
887ff8ba-0183-4ca8-aa8c-edffe2b58c9a,Smrithi,1,1,9,44,43,21,119,
16bd68f6-11c1-40c6-a98e-2aa154a2168a,Sneijder,49,32,37,59,23,58,258,
34324cdf-b437-43c3-934e-1ceab787abf4,Sobeida,27,41,18,38,50,75,249,
0855049a-d1a7-4393-b804-3e501f97d6b9,Socorro,16,67,89,54,26,28,280,
9e781953-34ab-40bb-be34-d2e6d3fccefe,Sofie,77,72,94,47,64,1,355,
bed38336-4ac6-423e-9c22-a51d17f7a4e6,Soha,48,84,79,25,74,35,345,
cf568128-1d81-4982-a97c-1468197a670e,Solana,63,47,60,45,49,79,343,
5a074fd2-5268-4ff7-9c59-ed4295c53e45,Solange,53,69,1,37,35,53,248,
ed834b9b-0abd-4074-8edd-a5f65d72711c,Soledad,56,48,4,78,18,1,205,
525ef102-8e49-4760-b75a-c71dc073d65c,Soleil,90,38,89,40,69,94,420,
75b9f558-8b69-455e-8a8f-80d15143cf03,Solmayra,58,62,36,88,0,67,311,
c9d42402-33ed-4780-a41e-7eb1468b635e,Solomon,41,92,75,71,80,45,404,
c80db747-ea7f-4cdd-a667-0ed9728e206a,Solon,94,44,18,14,93,62,325,
e2fb4e91-22a0-432c-ba04-120e8796653c,Solon,38,24,17,20,84,64,247,
39a44a56-73ee-44b0-9e5a-baedba2625b0,Solveig,34,45,91,31,2,85,288,
8c25780f-0d95-4753-aad5-a8b6b7a3a825,Solveig,94,41,6,27,35,76,279,
fab722a0-e364-4ed9-be9b-7744c69584e0,Solveig,39,22,57,59,16,43,236,
1c18571f-34b5-40e1-9ea9-c519a037ec6d,Somaly,87,36,47,1,31,41,243,
a5ccf1d0-f216-46d2-abad-8dac00b9a8f1,Somaly,5,27,49,8,61,74,224,
0d5af31a-6d92-4e8d-9e1e-44969276064f,Somaly,29,54,56,98,45,76,358,
9cfe1b54-f622-4776-983c-a5d95939fcbd,Sommer,95,94,88,62,59,74,472,
b55525f7-5e7b-4b95-8a04-645941614907,Sonal,19,51,18,94,48,3,233,
a9eaab19-c838-4ea1-a5d4-b47e5f4e71fa,Sonda,76,88,2,51,79,72,368,
e784a8f4-4c6f-4108-a163-07b8cf9a9912,Sonnet,79,4,70,38,34,24,249,
6f86fb80-f295-4bbf-88c5-a124a9941b6f,Sonoma,47,57,54,69,51,42,320,
01329685-6c44-4931-bd78-5ec23af0f983,Sophal,45,82,69,39,67,34,336,
87c52f54-f6c5-4ded-9267-c4d63d1ae4d9,Sophana,68,25,26,89,40,99,347,
49450995-cea4-4f7d-bc5e-626bb74b6f14,Sophea,81,73,83,1,98,91,427,
b71c390f-9930-4d7e-812f-e8c8942dc5d6,Sophia,55,18,23,75,61,1,233,
03223f63-be1c-433b-a8c6-74e8edeb7b26,Sophiarose,90,16,51,77,83,84,401,
0cdcb5f9-f8df-4089-aa76-1b0e9ce9b974,Sophie,12,29,22,14,68,44,189,
809ff334-da01-4152-b278-318745df26e6,Sophy,9,70,53,84,28,24,268,
fed5f30c-a365-49f1-8f78-56118db9ab18,Sorah,97,93,34,68,71,47,410,
76930c37-1ed4-4859-af0f-ba24d847f220,Soraida,99,52,57,16,58,74,356,
7b28f3b8-0fe8-4b69-8dbe-a7a865806d66,Sorangel,55,90,85,79,43,25,377,
5699cb5f-7d57-460e-abd1-d6f944eb82fe,Soriah,25,61,100,60,55,60,361,
9e60faeb-64a7-4e6f-944d-67047a8c6e12,Soriah,68,86,87,30,13,1,285,
46a486b1-ff63-428a-b565-11a88ebc9f83,Soriah,98,16,28,47,72,87,348,
72a1081a-b3f0-40b3-944f-bc300830b672,Soriya,1,60,88,71,30,70,320,
07397c9a-5415-4670-9ddf-446cc6f16869,Sostenes,82,0,30,85,16,35,248,
fe202427-bbb6-48ab-9f53-6546d0aca463,Sota,76,21,56,8,91,46,298,
e1cafa4d-2a68-4171-84e1-4fff523f6327,Sotheary,33,41,43,62,26,50,255,
8e625c7f-8127-4293-a0a4-5d5802697c17,Sotiria,21,83,12,11,74,40,241,
f0ddc6eb-f1a1-427a-904a-32f27bc76c06,Souleymane,51,73,7,17,75,24,247,
9af9efc9-553b-4b7d-880e-273a70fed47a,Soumya,91,31,23,46,65,71,327,
48714594-d1b6-4f94-9ba0-edd6714b0a3b,Spence,7,0,76,100,53,23,259,
a3efccfe-6c30-4ec4-80fe-81bedeea67de,Spenser,76,76,96,57,79,17,401,
3b7ce783-482e-4576-a9de-4764d5e85150,Spenser,40,27,21,96,37,14,235,
c13905e0-3407-4cb2-9331-05f073afb689,Spirit,25,51,28,68,36,8,216,
a8f8f5dc-6c9b-4cd0-92f1-6919eeac7e26,Spirit,72,81,85,6,2,23,269,
0b8939d6-b877-4963-8b22-d5b118c07c40,Srija,82,86,34,30,84,64,380,
87152508-b23a-4847-8357-43a419e05500,Srinidhi,23,13,64,35,27,81,243,
d566e0ba-f263-4a69-a724-f3bbc78c2a30,Srinika,53,54,39,6,68,80,300,
338795c4-ada3-4b07-8672-d87c18954b52,Sriya,15,88,83,18,92,18,314,
c540f282-9870-4a2b-a1ff-9379829efa60,Sruly,77,17,48,59,99,69,369,
00a9bdfd-5496-4e74-a121-73291a9c88c5,Stacia,40,48,97,97,4,53,339,
6fb9fb8b-cea5-463b-ad41-fb80098f25d6,Stanislaus,67,100,40,97,75,29,408,
a2df81c9-a910-4856-b21a-ca9ddecec70b,Stanislaw,85,54,41,0,16,87,283,
7b7efd1d-8eaf-4440-a85a-9b78114b514c,Stanly,4,94,84,35,28,86,331,
bdbcc47e-e899-4d56-9166-a12ca9294d93,Stanly,80,19,92,67,53,54,365,
198726f6-286a-4fd5-86b5-7c41da3683fd,Stanly,12,55,81,84,35,27,294,
9f586f15-bf25-47b8-936e-45f4fee9f0fc,Starasia,92,45,60,48,62,2,309,
d0e3629d-9922-4b6f-bb1f-1fcd98664f38,Starkeisha,30,62,23,29,67,62,273,
38bda8fa-fd53-483a-95a8-60af59c9e37b,Starlett,24,36,92,18,38,40,248,
3a2e5277-7792-49a8-8693-56f40d034a69,Starling,66,41,44,33,24,15,223,
7b34c379-9592-4a77-870a-0b6b7ee416ce,Stasha,77,59,55,24,24,27,266,
237178b9-1706-4bbd-8ffe-af6ec5df14e4,Stasha,73,44,56,47,70,54,344,
44f9b320-cf86-476b-ad81-c2b7556305cd,Stavros,69,29,11,21,62,38,230,
5c0f649b-407d-4461-a802-2a9c0fd4848b,Stavros,79,16,29,7,52,40,223,
13696579-45b0-4701-bd81-b0acf573bf03,Stavroula,45,65,6,66,59,12,253,
89d46f9c-42dc-40cb-8c44-e8b1425f46dd,Stefan,64,96,28,53,75,74,390,
3e078cc8-a299-4565-afcd-4fecce95dc46,Stefani,85,48,11,44,67,57,312,
03eb4826-85d5-4584-9d8d-aeb1f1ef3212,Stefanie,36,54,23,88,16,77,294,
3f54ebbb-4bc5-4b34-8057-70d44878b19c,Stefanos,35,86,27,96,76,46,366,
6d2207d8-597f-49c4-804f-9d53ca3e0ec8,Steffan,79,46,21,33,39,0,218,
f6fe1fe8-e31d-4f5a-a10b-ce5f1d158cdf,Steffani,71,53,87,82,76,21,390,
9a787ef8-1e5f-476a-9677-7e8cc710a0ac,Steffie,92,10,53,63,24,88,330,
18899b8b-12d0-457c-99ec-28d67cdb93bd,Stehanie,51,60,1,79,70,0,261,
1416e22c-87e3-4d34-8fa0-f0455fc1dd45,Stella,9,98,0,83,7,50,247,
ecfdf105-6916-43c7-b07e-9f172dd2b3bf,Stepahnie,41,99,12,95,40,1,288,
8d4e0248-33f5-46e4-9041-29efce33b377,Stepan,68,25,0,9,71,55,228,
00fe8f2e-fa3d-4be5-9889-4d38614ecf90,Stephan,27,67,20,74,63,36,287,
84f83618-90b6-4d9e-a855-d2b2501c11bf,Stephane,48,97,60,42,86,73,406,
1007cb49-cbeb-4204-99ee-358747c69b4a,Stephaney,81,72,63,66,91,26,399,
5c0e52df-6e4a-47cb-885c-1e266a79917d,Stephaney,24,48,77,99,46,71,365,
5c8a2a9b-d066-44a6-9238-2bf253237bb9,Stephannie,23,73,51,0,38,11,196,
16d94018-ae91-4149-8da7-5a2c8b28e68a,Stephanny,41,44,34,8,13,71,211,
9808f75a-072b-424b-be88-0dbf94f7f2d1,Stepheni,49,64,26,99,87,18,343,
88c44d4f-f064-4ddf-8e8a-5689d763c93a,Stepheni,57,38,79,97,79,99,449,
5adf0689-338c-4bff-bc1d-9e06df307dc3,Stephone,71,69,69,58,22,94,383,
02264aa7-2f45-408c-8840-eb555de79013,Stetson,76,96,36,4,28,48,288,
3d972812-ebf4-4c93-9eb3-e017d8f232c1,Stevenson,95,99,14,13,68,76,365,
c808bb87-9aeb-4266-909a-2c2fad1d13b3,Stiles,77,22,32,31,80,20,262,
f79e592d-6e5f-4459-abd4-8a8600cc06d8,Stirling,78,24,67,100,86,100,455,
a5a01427-cab9-425f-999a-e3a4a522d432,Stockton,17,46,60,50,41,15,229,
ec88e4cb-9b94-499b-8546-43aca95472a6,Stonewall,70,48,39,92,73,54,376,
e2c7bbf0-8a62-4268-bd5e-2d7919e13c99,Storm,26,23,16,25,7,20,117,
05ea91aa-2fba-411f-b613-5de4340731f5,Stormey,11,14,44,84,89,17,259,
032e4fdb-fa25-40db-8b6f-0fc3b3fe63c9,Stormie,65,23,2,54,12,81,237,
541cbcf7-3c70-4e19-bfd8-cc466d0e2d37,Story,59,19,24,2,30,59,193,
c23f9579-1ca5-43ab-8ce0-10da0c9547a6,Stoy,38,13,69,76,55,29,280,
11a267f1-348e-4458-8f71-e927235ce36d,Strother,76,42,66,23,48,68,323,
0abde225-fd40-41dd-8ff7-95e6c04d26c9,Sua,80,44,37,59,12,17,249,
4519b706-78ff-4c4f-8e8f-b9b242da51b4,Suad,6,25,29,24,27,57,168,
9e7cf626-c4fd-4e60-a697-688a036d1298,Subrina,36,59,56,57,47,46,301,
226d9b4c-0be7-4eb5-930d-de1be6ae946e,Sucely,96,91,65,97,8,36,393,
3f549dfe-7edc-4792-9411-d4fffcdce850,Suda,74,11,31,100,56,70,342,
11cb79d6-c83e-454d-baf6-ac02612a9cbf,Sudais,34,96,61,46,86,76,399,
d8774751-eedf-4a31-944b-6887e93fff24,Sue,87,89,68,79,70,54,447,
9401b69f-8384-4c19-938f-1f2559f3ceba,Sueann,27,29,30,45,57,3,191,
86053abf-a971-458a-a57a-5471da4963ab,Sueanne,27,56,52,43,30,66,274,
0a7d49fb-9567-4c4f-8577-cc396d9cf029,Sueellen,6,84,0,64,17,62,233,
7aeae4a1-1d33-4b13-aa71-ba4702563049,Suha,68,17,53,69,0,48,255,
58854541-5e75-43b6-a66f-7f3c1cd3ba39,Suhailah,8,80,35,59,50,4,236,
6077ff8b-8689-49ac-b989-d63ddf4d61a2,Suhani,41,57,54,0,47,34,233,
2429850e-042a-4984-b4c4-a2a75b788dbe,Suhas,96,3,5,28,64,27,223,
488302ac-1205-495e-96fa-91b730ecc2a6,Suhey,7,100,7,48,84,79,325,
5cf0fc86-b6bd-4ec7-86b6-1d8e4e900766,Sukari,81,46,48,29,52,14,270,
31af0af1-c349-4cfb-bdb5-98bfde2d7948,Sukhman,51,2,58,45,73,46,275,
c44e49ad-a145-4d56-a21d-d6ab12e36d65,Sukhman,0,80,1,5,54,68,208,
7de7e273-1fb0-42b2-acd3-6063ee01db34,Suleima,88,43,71,32,66,57,357,
4fffa3c2-d42d-4432-b068-366bca59e861,Sumaiya,100,27,22,35,88,97,369,
0c61cb2b-2adb-4b99-8720-705e202fe821,Sumaiya,45,12,93,35,49,54,288,
a90daf35-9ecd-4c12-86ee-958073acd2aa,Sumayah,15,18,50,14,70,5,172,
ff2bfbcc-ef2a-4bd5-b453-ca0bd667e9bd,Sumayyah,34,22,78,86,7,66,293,
db4e2f2d-6621-45cf-b563-c477e70ba24f,Sumeet,100,45,5,59,4,16,229,
5bfb2aef-e8e8-4df7-b2cb-e4b42857bcc7,Sumie,88,47,87,7,6,70,305,
fd9fe737-6f40-4f3c-83fc-9b344ac4d11c,Sumner,10,64,37,59,52,30,252,
ee67f347-7cfa-418f-97d4-b1d0a48cf42d,Sumter,15,28,71,72,36,38,260,
b4cd5d48-fd0a-4d86-9db9-c5498c440916,Sun,92,24,61,54,63,14,308,
fd49873a-78f8-4709-82d5-191a56d3f4c1,Sunday,0,64,3,72,17,97,253,
3a3264a8-4cff-4c80-8839-25cff9ef0e79,Suri,30,96,32,6,96,9,269,
a924a083-6fc3-44a0-961d-c176b66df6a2,Suriyah,58,95,84,17,34,12,300,
2d4dfe0a-83f1-4e2e-86b8-885171bc4c7e,Susan,82,76,0,65,41,4,268,
808c7c1c-2a34-47fd-bb92-c6219461fc13,Susanna,16,22,35,1,80,97,251,
d0d4758f-b6db-4ee3-a37d-fd60f0e0a283,Susano,1,20,30,42,83,42,218,
a956a5b1-61d2-47cd-82b7-e90b5cc20712,Susette,58,96,64,4,42,27,291,
b45dbbfe-8489-4ee6-b6df-fad5160e0a4b,Susi,10,39,11,26,28,26,140,
eba63c39-27eb-4b08-b1f1-36d91d014bba,Suzanna,19,63,88,69,93,95,427,
17737c00-06a0-4446-a0ee-e2f43782331d,Suzy,50,7,12,51,72,28,220,
d3a0243b-95e2-4a5e-a077-61948cf2f4e1,Suzzane,27,28,47,13,99,32,246,
c24e8cb3-278d-4018-8328-3df42eca7b96,Suzzette,10,54,49,80,28,32,253,
011bdd2a-7c60-4cf8-9acb-2e6c0a25b1c4,Sven,43,85,97,53,12,53,343,
042c0e31-68bd-4181-bc56-d839c6165758,Swara,48,71,55,54,33,4,265,
c5c92bc2-72ec-4b98-b78e-94479bb579c2,Swara,35,29,1,42,94,7,208,
1a760078-71a5-4b6a-ae8b-03c27152632b,Swati,36,49,30,66,3,31,215,
13187742-f77b-4196-b09f-2f91cc2e1eed,Swayze,79,45,77,64,97,16,378,
8af9426c-4439-42bf-9682-831375d42a02,Sweetie,7,53,35,2,3,84,184,
04f2bcf5-49d1-4c0b-9ec5-4f949b3ce191,Sweetie,44,51,24,90,25,85,319,
5b51d0a1-cf4e-4eb2-b1f3-baac15aebb2f,Swen,32,34,79,30,99,10,284,
1b2a6b40-4408-45b5-b70b-7353d88c2839,Syanne,76,11,15,63,99,45,309,
d6c44ea6-9288-49ec-8cc3-0618bb541f82,Sybil,87,39,81,0,96,6,309,
e153504c-63de-48c1-8691-a6e403849d67,Syble,45,58,6,61,54,5,229,
b3e7e662-d657-4c88-a7da-75bb5c432c45,Sybol,19,48,42,58,10,1,178,
a3484f36-400d-4ed6-beec-70188c89616c,Syd,75,56,47,36,60,91,365,
93594d2e-c5fa-4943-9396-363b15133181,Sydney,38,35,42,67,94,11,287,
4c385d02-0204-4fcc-ab8f-cc6986cc8baf,Sydni,3,98,77,14,48,67,307,
2abb2159-909c-4fb6-a1cf-2db20a9a9909,Sydni,2,3,2,88,1,27,123,
81124eda-4779-47db-95fa-915da34a9f40,Sydnie,50,50,36,32,98,59,325,
2006df90-c177-4252-ad3d-cfd76485ea2b,Syler,63,92,54,43,21,13,286,
d98abdf9-523e-4185-8c5a-b15a4bf67fe9,Sylis,63,38,41,11,69,43,265,
81888991-8698-4ce5-9b31-e0bd69888e20,Syliva,23,24,30,68,8,57,210,
4be30908-3315-42bd-9ae4-16e6bb20af1a,Sylvan,95,53,82,13,76,38,357,
24bf42d3-cf55-4341-b290-0bf508da7b39,Synai,67,15,71,20,41,47,261,
c4e28ca8-5e5c-449c-89ac-0529848cc0fb,Synai,97,26,98,16,64,83,384,
0bf18ca2-4b44-4a80-ba7c-696f06ad202d,Syncere,95,35,82,31,47,15,305,
bd7d4131-6174-47b4-87f4-f4eb6dfbcb03,Syrena,1,56,68,52,31,92,300,
18e1563e-0b63-4477-a157-1fa2d5eef8ca,Tabias,15,73,65,91,18,23,285,
f5c15841-3784-4f84-ae29-71c03ec27490,Tabita,100,75,44,81,70,12,382,
6b04f6b0-c9df-47ab-bb40-3be72ef8c1d3,Tabita,17,40,61,83,92,62,355,
3b8d2658-368d-4430-9f7e-3c7089613324,Tabitha,95,48,20,78,36,32,309,
adc22a03-b4fd-410e-9359-30a33752c1c0,Tacuma,79,39,98,67,55,36,374,
6dbd3094-f754-424b-886e-3ee5c3f8eaaf,Tacuma,15,87,30,84,66,66,348,
642a04fa-b54d-491a-93c9-bdc2097e70a1,Tacuma,0,96,0,18,52,43,209,
af9b5623-9ee1-4090-ad66-6d657ec72780,Tacy,83,53,89,49,13,18,305,
50c8338e-4d20-417f-80fd-544cf3b36c41,Tadd,63,85,85,16,48,45,342,
92ca5151-39bb-4094-8250-635db130ecfc,Tadeo,44,76,30,17,90,85,342,
8fa937db-8cc1-4e23-89ea-026af82668bb,Tadeo,19,76,17,24,6,13,155,
7ad1c20e-e62b-4afb-9a85-375a8a2ed295,Tadeusz,29,13,12,38,35,51,178,
4d388b61-16a0-4deb-b233-1ea37454977b,Taelynn,15,40,7,82,53,70,267,
c01d0420-06b7-410b-9034-547936ef745e,Taequan,67,65,35,57,94,3,321,
574db7cf-fc22-4c77-884b-129a0b122440,Taequan,94,65,69,25,4,26,283,
10f4b5eb-cb74-4e2b-9382-8d7759bdfb12,Taeshawn,38,21,89,56,99,3,306,
0bd250d9-b1a2-44a7-9b8e-128dbf34621c,Taevion,46,52,83,62,5,41,289,
680a672f-51fb-4799-b6ba-082dae952a6b,Taeya,85,17,49,82,23,6,262,
df2387c9-0a11-4af8-a705-ac43732369de,Taeya,86,27,44,6,86,85,334,
849a522d-861c-41df-8271-a2b013b07470,Taft,3,3,72,76,97,86,337,
7e86005f-a5fc-4b14-a077-732dfd1ed272,Taheera,69,37,64,91,47,6,314,
eabb2b1b-d77d-4e16-9d02-0403d8f65405,Tahir,27,9,9,5,56,27,133,
6c3e45a2-71e2-4e75-9532-5d40c334badf,Tahira,33,25,66,34,5,2,165,
41f8b6b2-9f37-4ca5-8fe6-38535de89ece,Tahmid,49,48,63,20,92,21,293,
1a53684f-23cd-43e1-9670-c11fa6e93dc1,Tahmir,62,11,4,82,20,26,205,
a85d9dcd-c246-444e-b4fb-5c7269df472e,Tahnee,42,22,45,63,56,68,296,
a076ea1f-fb83-4879-9177-24fa1e6f6a29,Tahsin,22,59,54,80,53,100,368,
e750b974-2c69-4ad6-bfea-8c4413cd3aa9,Taia,88,75,21,76,58,64,382,
c065b8f3-e13d-4eec-9afc-c3ef0eb280f0,Taija,8,59,45,32,59,89,292,
4f78873f-93ec-4ead-b593-c13a0a5d4e02,Taijah,72,19,77,61,36,9,274,
393c8734-1d27-45e6-a820-ce1d404ddec6,Taimi,3,83,2,100,39,95,322,
006926f2-ef41-4817-b395-2c8c7a957dbe,Taiquan,60,44,3,95,30,66,298,
95efea6d-d0bf-42da-9774-8a4e3ab7ebb4,Taira,85,63,85,27,70,49,379,
68446a59-72a9-443f-9784-6a76162360e8,Taisei,13,83,99,62,58,2,317,
288c8cc2-7460-4292-87de-686041e16acf,Taisei,87,78,53,66,42,70,396,
1bc88b5f-7353-4290-b0ba-f6f287fb8a64,Taisha,81,34,27,71,94,63,370,
3edce4a9-a36a-49e7-9818-49316596be90,Taiwan,11,48,84,66,84,42,335,
88f4dc0e-a222-4e86-8cd2-06e198dc4123,Taiya,98,1,45,14,52,28,238,
d4baf921-66b1-4012-a1b1-6939244b1b75,Tajae,80,97,94,86,10,24,391,
072cfc4d-2179-4958-b8a2-1c5cd37df95f,Tajanae,24,19,76,71,93,2,285,
a96ae1f5-6943-4da7-9ed8-002edf59b445,Takayuki,37,64,63,92,37,33,326,
182fdd5b-d50d-4861-a417-fd225dfb39b8,Takeo,99,90,9,12,71,64,345,
b0991a92-5ab0-4c42-b170-81d11fe76df1,Takeo,32,61,31,6,17,61,208,
b5a557cc-2b52-4176-a624-4ea6dc6bb06f,Takeshi,21,58,55,90,93,65,382,
7ca305f9-0c08-481f-805b-10ae84642fee,Takia,10,54,37,67,99,87,354,
283fc48f-1a81-415f-b1f8-a4aab2c31497,Takisha,54,60,32,61,52,74,333,
0ddf3bbb-f78e-4bf8-a78f-062e73a631d4,Takoda,59,80,8,51,60,91,349,
e81073e6-de48-4b90-bd66-412a8805f01e,Takyla,3,7,28,85,21,27,171,
2e92521d-009a-4644-b54b-3269ca0de0ca,Talan,0,88,78,16,19,88,289,
4ff0b17b-3e67-4738-8646-affc38fe0201,Talar,26,57,50,35,59,42,269,
b74d26a8-8eab-486a-8920-4260571ba427,Talar,37,6,47,76,18,66,250,
494de327-256f-474b-af2a-f824109aca18,Talaya,70,61,91,20,1,70,313,
be5369ed-5c52-45e6-a79f-2104f5de61ba,Talayeh,63,17,61,10,4,72,227,
fe165867-65ba-45ba-b509-06634115cc6b,Talaysia,95,98,53,24,82,95,447,
6b5489aa-1c9f-4c99-bd42-656b7b32a7d2,Tali,64,81,37,28,88,92,390,
21794cd0-2bcd-4507-9d3c-c2ba689ca653,Tali,40,16,47,18,38,19,178,
e5d33d13-b0bd-46f7-a535-192c5b1c9288,Talia,58,19,28,100,97,94,396,
25c9e768-354d-4692-93e6-4a4f6f7c60a9,Talin,62,72,45,50,98,32,359,
7d408fb7-7a51-4933-970d-0ec46b000b07,Talin,74,0,57,19,38,82,270,
996904d4-d02b-40ea-a64f-c6ae323353b5,Talina,20,38,41,25,48,0,172,
fccf5dc3-88ff-4612-914a-5d3449d7c8b8,Taliya,97,89,69,45,6,83,389,
be9d127a-9355-496b-8e27-2cb2fac8f67f,Tallula,37,36,70,28,33,45,249,
250546dd-8724-4214-960e-2c951168bbc1,Tallulah,27,99,30,44,91,66,357,
85238302-0786-41a1-8096-b5d06e746334,Tallulah,91,89,86,26,85,80,457,
647e99d2-0a6b-4d10-b283-3011336bafc9,Tallulah,61,52,14,28,13,33,201,
9da3e843-8b0e-409e-943d-77b3f64f0be8,Talor,82,58,6,19,41,67,273,
431485e4-311f-4f92-be7a-dd9ecc6eb40a,Talyah,99,39,46,69,94,58,405,
672f6b0d-ad6f-47e6-83ee-2f2b8e00fffd,Tamana,0,89,79,30,5,96,299,
9c61defc-68eb-407b-97e8-d2e428d16e9f,Tamarah,93,11,100,66,92,30,392,
73e2fae8-d045-47b1-a1ed-3dc4200166c1,Tamarick,100,43,81,15,100,15,354,
4bf5edd5-c200-48fa-9139-3e5238d86e31,Tamarion,41,9,92,83,31,19,275,
771b262d-fd64-416f-b852-886080f3e320,Tamarra,31,49,15,23,9,0,127,
e8461616-f4c3-47d4-ae92-08d002618fc9,Tamasha,96,64,45,67,62,18,352,
01fffbb7-0df8-4689-a574-64a73922f9dd,Tambra,2,4,64,21,19,9,119,
947742c5-8eba-4368-b156-5768bec39a57,Tambra,14,37,44,30,39,92,256,
0d3ad068-a840-4f71-812f-698d7ffabb58,Tameca,91,52,88,51,24,44,350,
98f4a6fe-ccf3-4bf2-bf33-80bf360db3b6,Tamecia,9,31,15,52,13,92,212,
e9985eed-5006-4971-9562-d028d14ac28e,Tameem,98,40,38,16,26,40,258,
833df5b1-f54f-4076-9e12-d23354cfd0cb,Tameisha,9,76,59,24,66,25,259,
aa3592ac-9107-4636-87a9-c58ab7a55ed5,Tameka,73,46,46,98,31,90,384,
9c621683-47d8-43e7-ade4-e591d9391f9c,Tameka,37,75,48,43,64,32,299,
47816187-9885-4bde-9766-ed4b567e5e6f,Tamel,24,61,1,2,71,87,246,
a464a542-8d6c-45a9-86b6-767bd4ded471,Tamela,85,79,38,29,28,74,333,
ac840fa6-c238-4909-bc5c-7186400a83d4,Tamela,15,64,89,93,94,84,439,
db6a0f12-9fb5-4777-b5c7-1669ad143217,Tamera,6,54,26,65,90,30,271,
905073b1-fb19-4523-8de8-3fc339026cd0,Tamesha,20,95,35,10,0,39,199,
d8f8e21a-56f1-41bd-bdd7-42159ff93311,Tami,77,60,33,71,61,82,384,
6a744174-aac4-4b15-a55b-6ad65497e09e,Tamieka,9,45,31,55,91,67,298,
e5caa0b4-648b-44a1-99e2-d34dea3246d9,Tamika,49,29,70,92,5,24,269,
ce4cfc2f-9cfc-4a63-b480-3cce9584ce9e,Tamiko,42,92,88,49,66,76,413,
6da4d96e-fdb3-4aa6-8adf-690806154323,Tamitha,52,41,34,47,78,48,300,
4119bc8a-86fa-4dd4-a194-386e6514628a,Tamiyah,77,30,37,64,28,83,319,
5a4fd3d8-a4ba-42aa-a0d9-84646bf3b32f,Tamlyn,61,7,65,12,33,1,179,
57eaedb1-7535-4862-a9fe-cc8a663e5b87,Tammara,39,16,72,99,79,5,310,
cc022b50-b81c-497c-b499-56c1f676ff1e,Tammee,61,8,91,63,67,68,358,
90623d30-f224-4737-b880-fca083c34bb0,Tammee,64,31,43,15,88,17,258,
8305678d-b04f-4e09-a806-4024f17bab2e,Tammie,10,62,15,2,3,83,175,
5eb30af8-f6f2-46f5-97e6-c2abe9629b10,Tammye,51,42,77,53,41,44,308,
2037aea8-b5d2-488f-bf86-64a80b4e71e5,Tamra,77,27,29,99,79,96,407,
bcc0a6ae-88d5-4d1b-8c12-5a4002639b8e,Tamura,19,96,78,37,67,83,380,
acfa6263-0835-45a1-88af-26a58679cf42,Tamy,36,32,82,6,46,76,278,
ca495a69-942a-4156-8c1a-d542adf9873a,Tamy,28,70,33,79,9,89,308,
0348a16d-e9e6-4fdd-948c-d0a7a5c040b1,Tamya,12,42,100,17,42,67,280,
066b4e3f-7f2b-43f0-8c2a-d5afae8cfd61,Tamyra,61,73,2,91,23,51,301,
54c34e1e-70c8-4713-924b-3db4db999dfe,Tan,55,78,18,83,29,96,359,
acac78b4-006c-43a2-a75a-fb7161901cc2,Tanairi,44,4,79,40,100,50,317,
b5120889-fd44-4d2f-a70a-ce83d0091335,Tanaisha,87,55,21,27,30,76,296,
f52fb80f-0785-4aaa-abda-863b09fec43b,Tanaisha,76,50,70,72,16,79,363,
46d8fe71-3169-4b54-86e3-22edda504736,Tanaisha,94,60,49,82,12,55,352,
3868af4c-7373-4b76-bb8d-7b4f09193ed4,Tanajah,35,51,0,89,89,80,344,
fac635ac-11ae-463a-bbb3-8c2e60dd3aee,Tanda,11,95,39,82,81,83,391,
cc010880-3372-4820-842e-adf3b74ab759,Taneshia,98,55,78,53,10,47,341,
d370352c-bfaf-4730-84a5-49dfbd2e457c,Taneya,62,34,16,51,20,29,212,
f7781bc7-4a83-4ee3-a941-15f7a041cbc4,Tangela,43,10,80,68,77,72,350,
ba4a1bd3-c787-4966-8e23-8869131bd4c7,Tangela,1,28,100,86,41,52,308,
279b2f3d-6438-46b5-a2cf-baa8ff99ace7,Tangie,26,94,88,43,50,26,327,
61bbcb5e-2c00-4436-97f8-8b00b0d4e1ba,Taniesha,52,68,92,18,55,100,385,
02f1c397-7421-4868-84c2-952b29b9aaab,Tanikqua,95,34,71,91,33,1,325,
91010d70-460e-4cca-9411-b4f8ece53fac,Tanishia,26,4,97,79,96,92,394,
f6bd6470-77f8-4633-9c34-5391acc4c7b3,Tanishka,8,19,46,44,83,34,234,
a7aa41c9-d331-4820-95eb-f7a8cee1e87a,Tanji,26,74,35,24,46,16,221,
7f2350e8-ae05-4a7a-b600-a849d318131a,Tanmay,61,90,36,16,51,54,308,
eb6ae407-6d6b-4391-9416-b05667de7fe6,Tannaz,13,7,92,100,79,9,300,
f8ab7189-fdb6-4e0b-84f6-35b420702fa1,Tannaz,11,68,85,20,31,19,234,
0affc146-a1a3-43cd-95f0-dc6b885ba9a1,Tanner,59,39,49,61,8,97,313,
20cc6ea4-2380-49dd-bce2-966a7ad088a8,Tannya,89,81,42,37,27,77,353,
1090a396-a2f5-41ba-b158-a8dc1cf80361,Tanvir,25,29,85,49,11,81,280,
31a260a2-0a38-4d11-8da4-3db789779c38,Tanvir,82,42,15,69,93,77,378,
68cc31bd-4952-4d11-84eb-c5b578169059,Tanyiah,20,32,11,35,32,43,173,
16a00741-208c-42d8-a689-38918b9c0d6d,Tanyiah,19,29,46,51,27,76,248,
d04a91dd-0f21-49e0-a1e0-2bc0d2b31fb7,Tanyla,6,59,20,99,95,14,293,
83ac1a59-9c7f-41bb-bd3c-a8c1a63289ec,Tanzania,87,81,99,75,52,9,403,
53768d73-6708-4083-852d-c768c5f6e387,Tanzania,45,80,42,62,90,87,406,
bc927133-4f37-4409-ae92-ea70abe2b929,Taquana,0,98,35,28,13,27,201,
fe2a4e65-4908-486a-bdf1-4246d173e38c,Taquana,58,80,87,66,47,33,371,
3daaf3e3-0bbe-401a-b8d3-ddb0a460023a,Taquasia,20,83,37,24,88,73,325,
a1f75dd6-cf3d-4113-bb4f-d66610f3bf51,Taquila,31,96,98,12,42,32,311,
e6fd821f-abc4-4975-839f-851c28a86493,Taraji,35,57,95,25,47,94,353,
8f985597-c3f2-40b8-8c23-9705b189be25,Tareva,5,76,42,26,9,5,163,
a8a62f03-61a8-4957-8951-c37f122983a7,Taria,98,95,35,82,37,84,431,
f680891f-1475-4bce-8401-ef1ed09998ab,Tarin,80,29,19,3,80,57,268,
7ae6db54-13f4-4ffd-8bcc-3c65ec263717,Tarin,54,19,16,86,58,52,285,
9990b7e6-5338-4ecc-8370-b1568d2c6b4d,Tariyah,32,91,0,0,33,36,192,
edca2fbf-76ba-4599-8d98-3858a91a1a51,Taron,83,87,69,99,84,14,436,
2b4a55e3-a398-43a1-bdd8-b3fcf384095a,Tarra,92,37,46,97,98,42,412,
c06bc2a2-b969-4a34-aca6-33f2e562f2bc,Tarrence,35,14,4,77,89,20,239,
90ad5109-27a9-4b6c-8d5f-cd9bb8a50325,Tarvaris,26,49,70,53,62,90,350,
89f19a62-bfbd-4bb6-bf20-0fd5555e4a9f,Tarvis,73,77,12,33,25,89,309,
8323397b-d94c-45b5-913e-540ed3aeae68,Tashanti,45,33,15,25,76,38,232,
ad59aaf3-fb07-4f3d-9c0a-497adc5a3022,Tasheen,18,45,79,81,94,51,368,
a134f6f6-8de9-4218-851f-990e8c28c807,Tasheena,12,90,99,53,46,86,386,
9d6644d2-d7a2-427e-b89b-9ef9186c7d9f,Tasheka,41,11,93,81,14,89,329,
cf2f5110-ef6e-4f97-8642-a88e9b0df645,Tashia,28,81,46,68,4,31,258,
a780dc3a-2dc6-4f4d-94d9-8e97519c375a,Tashima,55,83,100,25,34,46,343,
c0afbf97-7818-4a77-bc67-d3f9b0cbf12f,Tashon,59,94,39,64,43,16,315,
ea279db9-ecd0-4421-94c8-4de93ba8f921,Tashon,27,87,62,46,98,11,331,
cbc506f0-d3ad-49e6-af15-dd60b119e9b9,Tasia,34,10,26,38,84,72,264,
df68bec1-f08a-418f-8daf-fbdd17fa6aaa,Taslin,59,65,59,42,72,48,345,
63c2730a-75e9-4371-b1d5-3e4fe26af2e3,Tatanisha,37,61,88,24,79,83,372,
960f5ac2-f520-4fe4-b0aa-e852e89217f7,Tate,1,62,26,68,29,7,193,
075aefe9-fb2b-4e63-b329-5fdf9682fe8e,Tatem,74,56,87,93,70,79,459,
65a6abc1-2d8e-406c-b39b-d35a11cbdc7b,Tatevik,71,26,38,25,12,46,218,
9f610e6a-261e-4cfc-8b8f-097ecc9f0cb8,Tatia,26,45,15,29,5,84,204,
3ea3c363-966a-4826-9d73-a7729f4f9ac3,Tatianna,22,38,57,38,88,71,314,
88f6a6a1-b36f-48d7-bbb3-706a74f545ca,Tatiyanna,74,31,93,97,100,16,411,
7cadadd1-363a-40c6-9719-d55d421bdb4f,Tatsue,52,68,8,52,61,67,308,
b7b36b8b-4d99-48dc-b4ad-9cc46cdcbcd0,Tatsumi,66,44,6,37,34,11,198,
145bb621-2302-4a2f-828c-21a84d883b1e,Tatyana,14,40,79,81,62,98,374,
73d65ec0-fd51-4118-8090-08fc89755cd3,Tatyanna,43,40,85,31,49,11,259,
1845f39a-2a87-4774-9df5-5b5c6689ddb1,Tauheedah,21,0,66,24,3,34,148,
1b2a4a8b-2140-4e7a-bbe6-8abeff0f3227,Tauno,55,38,77,99,97,47,413,
ad72fc57-deb8-431a-af62-a4fc2cfae6f8,Tavare,72,29,59,23,52,90,325,
73437bb9-e150-49c3-a24f-173f66b02dec,Tavare,95,14,44,90,75,59,377,
926ed537-698d-404f-b206-203cd43d93e5,Tavaris,72,66,22,43,84,100,387,
25af8ce3-b726-4bc1-8239-00fc553ec667,Taven,57,4,88,55,4,51,259,
52f0d006-616d-4fa7-b5fe-dcf8128b7d3f,Tavia,5,34,66,76,3,21,205,
abc3b5e1-f723-4cb1-b7cc-459f8444e6b5,Tavion,46,16,62,68,11,89,292,
7860c2e4-f18f-4c7b-9808-3958aeb9248f,Tavion,19,27,46,33,4,76,205,
bb90549b-7814-4067-b741-ef3572602963,Tawanda,84,96,60,75,65,62,442,
4305115a-37d8-4629-87cc-a259cc644009,Tawnee,53,10,38,97,65,76,339,
45f9037a-690c-4e9c-a082-95cd7600224a,Tawney,73,32,47,77,23,7,259,
74017777-b7cc-4868-944f-33e8c35e428c,Tawni,94,72,94,48,40,51,399,
44f88cc0-e3d2-451a-a000-a3e4c7109606,Taya,20,84,70,74,9,54,311,
3b00a0cf-c352-4fbc-b55b-556168c2d8fb,Tayah,32,84,68,80,49,53,366,
59adcf38-bde8-4f7e-857e-279c7cb2c64f,Taylee,89,2,81,22,8,94,296,
1093610a-1e87-49cd-bff0-78fc44cb6c66,Taylen,67,46,88,88,22,4,315,
93c9cb70-fcd1-40d9-bc1b-e29c6796ee67,Taylen,91,20,16,96,34,93,350,
b06c4f28-9b0c-438d-9013-60b47fc44d17,Taylor,63,25,28,26,10,72,224,
69c6837b-454b-4776-b2c2-30c59fc6f90c,Tayna,51,19,48,54,85,96,353,
4ae3713f-1f88-410c-8e4d-6615d751fde0,Tayon,90,84,15,35,96,58,378,
976ff1d7-6528-49dd-815e-031daabdd62c,Tayshaun,46,14,59,38,40,54,251,
ccbf08ad-b1b9-4fdc-a915-6c59168cea37,Taysia,50,70,77,68,17,55,337,
fb778abd-bbb4-4495-be7e-4473aa8e7db8,Taysom,48,12,44,100,87,22,313,
78013488-09b4-4d0f-8fef-3ff6bc89130b,Tayte,61,70,90,3,13,94,331,
e07b3c89-9abe-4f11-b519-b7023adc6eff,Tayte,38,48,56,83,32,34,291,
a5b43234-4b37-4b67-9f48-e96307b467b0,Tayte,4,84,56,9,32,97,282,
57be466d-a829-427c-8539-408bf773987d,Tayten,17,52,91,41,54,85,340,
4b3d9be3-72ff-4e4d-94d1-c15f0010c1ed,Tayveon,86,9,33,80,55,80,343,
783f7ba3-5540-44f7-b570-d2cce60daa64,Tayveon,63,5,58,74,41,5,246,
26a46ba2-92e8-43f3-abe9-eb80bc8b0c2a,Teagen,100,66,24,39,66,85,380,
b5a02dbd-ad15-481c-a69b-9e01fad79c30,Teah,9,19,81,52,87,84,332,
7d163710-e0f9-4c4c-866c-71c8c6788a7c,Teah,73,85,86,47,97,77,465,
53ddf4b7-e172-469f-9a75-483ed637b90a,Teana,71,15,86,50,72,51,345,
feb4495a-dd59-405c-a49e-77c6c9a86d1a,Teasha,51,38,29,1,22,72,213,
a96d9c42-d7d4-4851-91ae-34f8e24f14a6,Teasia,70,70,55,60,37,96,388,
96343ed6-04c7-40fa-abc3-f090d22a973b,Ted,95,91,41,45,43,39,354,
6d277e56-58f5-4263-b32b-db8a92cdfe3a,Ted,18,31,56,78,6,73,262,
9c48a89d-b35d-4f86-882f-0a5b3b23df57,Tedd,90,17,32,75,31,22,267,
464c0b7c-916d-44f1-88f2-c4599802f330,Teddie,48,47,39,82,76,54,346,
b022acd3-e388-44a2-95da-cdea82e7b2e1,Teddy,78,89,17,25,50,30,289,
d9920629-d888-4cc4-af49-55e8be1107b6,Teel,92,39,66,82,5,57,341,
18f43132-c6db-4c42-b5df-782675e7e50d,Teela,40,90,60,49,89,92,420,
b0a25840-60ad-4e88-beaf-b512f6d1c31e,Teena,7,51,18,33,61,65,235,
666bcd9b-62de-4186-8ff8-ef7028806fd0,Tehila,40,18,70,52,86,6,272,
d6c5d0c3-d904-4f79-8672-766613688e8a,Tehila,21,82,8,54,45,16,226,
2551c282-95e7-4a0c-95ce-917c9b2ab48e,Teila,1,55,25,53,25,63,222,
b55ba329-5222-4f35-a14a-237e35d4b592,Teisha,85,81,40,80,52,22,360,
39e1011d-bcac-41bb-84c4-7dbe676b2243,Tejas,61,44,59,5,38,73,280,
ac797b7a-33b9-45b3-8e65-a5e1a1a7812a,Tejon,13,82,88,61,64,71,379,
7eb80149-ff3a-4a59-8c37-cb6d87cc1125,Telicia,0,19,48,75,100,51,293,
36d700a4-200e-4509-8b70-e6c44215e969,Telisha,85,20,98,5,59,71,338,
6def5891-0d4a-4791-8fc2-a957142e026d,Telisha,20,65,89,22,17,5,218,
91efa29d-c859-406d-97c8-51d352816cd3,Telly,24,56,90,10,41,18,239,
db82a984-318b-489e-8236-7c27656250e5,Temesha,73,32,55,43,62,49,314,
918f23a3-1d5f-4e60-a0dd-d115bf1cb60b,Temesha,81,92,64,55,34,50,376,
af2cbe32-c722-4720-942c-98162b49e5d5,Temika,64,32,31,8,48,33,216,
91db2dfa-7eee-4c09-a3be-63b2d00c4853,Temika,50,83,43,98,99,14,387,
3ae69084-9021-40a9-b1d2-0eb7d73f2dfe,Temima,35,55,94,44,91,45,364,
c29d3455-fd7d-41b2-963f-4d662a2c21b3,Temisha,66,78,99,74,15,27,359,
6bdd6eb2-5029-44df-a425-6293e474864c,Temitayo,82,42,30,92,90,52,388,
0927d798-5d26-4ed6-9923-11bd4b5ac68a,Temitayo,36,84,88,93,56,75,432,
2a4d090d-22e7-421e-be4f-92e3197bfe75,Temitope,75,65,69,90,6,25,330,
6f011247-75fd-433a-a4d4-45063c281e47,Temperance,70,13,32,89,63,4,271,
011b70af-6516-4d8a-a22a-0776b2568373,Tempest,48,67,11,74,1,35,236,
70798329-f7d3-430c-bd17-92a2598c518d,Temre,89,26,65,85,3,48,316,
fb979f1f-7d38-4e4a-b046-bbcbe27b0042,Tenesha,98,6,73,47,37,61,322,
696e44ee-5918-4d32-8794-061959f79f95,Tennyson,58,11,89,89,56,43,346,
ce298034-1a2f-4383-a212-af57f2faec2a,Tennyson,1,74,55,99,97,30,356,
19c3cc0f-c8f0-4abb-a454-3fc53e7e5272,Tenzin,77,84,54,100,3,90,408,
2c0f90a6-b6d0-45cf-8937-f7cdf23f91c5,Teofilo,63,9,78,42,25,91,308,
05dbf9b4-c38f-4199-a9e3-a9e5e2453058,Teona,74,59,25,78,23,71,330,
7eac4cfc-c8ce-4a53-9753-f380deef483d,Teona,14,11,74,47,45,88,279,
a322babe-b0b8-4a68-bb46-c24e7f0f3f0b,Tera,11,69,89,91,1,26,287,
e1cf1bc3-7062-4e18-8387-fdeb099aa00c,Terah,25,50,94,1,25,53,248,
af1de879-61fc-424b-82c2-23a91a666623,Tereasa,13,82,30,83,14,97,319,
9db28567-8cd9-411a-adce-607d6b8cd0a3,Terell,20,72,96,87,62,5,342,
fd35c0e6-1c3c-4ae1-80c5-319d983562d3,Terese,90,3,59,28,28,68,276,
4875a221-5966-4d5f-8590-190713ba6f33,Teresita,33,52,58,95,42,32,312,
eb112fa0-acae-4f04-8881-97122e6d2f13,Teresita,56,6,58,18,56,29,223,
f0b9bd8b-c915-4fbf-8c98-965a6ad0dfaf,Teresita,100,26,6,78,88,38,336,
feb011be-3b8f-42c9-b42f-a47fe044c3e3,Teretha,46,32,91,93,21,19,302,
ef715eef-4aa0-4d8d-acfb-2225229221f1,Teriana,85,38,0,36,53,54,266,
742ca7bc-2145-469c-a79a-a318951e7bc1,Terika,62,15,75,36,78,89,355,
6c7b922c-13e6-4cb1-93fe-c33bd1bfa485,Terika,35,17,93,57,87,35,324,
29fcc059-922d-48dc-b457-9793b5560eab,Terilyn,54,77,46,93,68,51,389,
2eba2691-5fd7-4f25-8818-af1dee97bb9e,Terina,70,41,85,88,24,40,348,
8ec81f1f-30b9-4e6d-b895-d8ca3d91640a,Terique,47,86,76,0,98,58,365,
f5549eef-f405-4e6d-857b-6b2d1e2399e3,Teron,55,65,65,69,53,95,402,
2c20fb90-3ffe-4ef9-b6ca-01ba3945d520,Teron,11,87,43,1,60,66,268,
74cf03bc-c2c6-4a24-98fc-6925790e0306,Terral,36,55,94,62,29,78,354,
478507ad-2e8f-497e-9888-14344bf7ce08,Terre,43,17,10,21,44,84,219,
97db7f48-e5a5-43e8-bbb5-15bd624efdfb,Terrea,96,84,29,45,14,11,279,
d0af8fc1-ee0b-41b0-a6a1-44b7e47b435d,Terria,7,27,97,83,79,24,317,
ef895b38-0e57-4464-a00b-3be6cf6e5978,Terrianna,80,36,82,79,87,23,387,
866f442d-f25c-4582-b5ac-859161fd49bf,Terrilyn,43,75,18,64,84,48,332,
d83c6849-115c-4296-99cd-59c3481aae92,Terrion,50,24,21,56,10,78,239,
598c441e-f9f4-4808-b403-50afd77d4bdd,Terrisa,69,70,95,33,62,50,379,
51c53198-9844-40ea-a4b0-cbbc26e15c5f,Terron,18,82,1,72,11,93,277,
7b1a4bf5-02c4-4202-b8da-76e7a010081f,Terry,22,50,69,84,4,30,259,
2245b584-c74a-4967-a2ca-8f762f210e46,Terryn,99,2,19,79,96,96,391,
a783a8bd-e96d-49ed-b276-57cb6c626958,Teruko,86,56,73,35,36,94,380,
4f52aac2-01d3-433d-97e4-365eeb9c3e3c,Teruyo,57,83,18,91,53,55,357,
daadbafc-d9f9-407a-9cc7-cb6bba1c444d,Tesa,93,4,33,15,38,63,246,
724549f8-d0c1-40d4-bf5f-e0f1fae2ef88,Teshia,19,30,55,30,31,26,191,
a70b131d-f54b-432b-a07f-b4c50fc2edf3,Tessie,31,100,50,31,36,91,339,
643fceb9-135f-4bd4-a208-73433054643e,Tessie,33,58,1,66,73,93,324,
66d19687-10fa-4a3b-b2d3-5f0685921d60,Tevin,27,62,61,7,48,63,268,
1adf3489-5443-461f-837c-cad9ee07c419,Tevis,31,8,93,56,99,69,356,
6d4ed9c4-b25a-4eac-9398-3c12b187a090,Tevita,70,19,45,51,7,30,222,
94e1b7a6-3c0a-40ee-b07d-bacef1b8a045,Tex,95,97,14,63,21,52,342,
5ca9641d-1be8-4210-a362-7afaf82901e9,Texana,70,91,78,18,61,49,367,
c2aa9362-fb05-4881-8850-d4efa8494f68,Teya,66,11,8,42,83,52,262,
aeab72b4-7ead-4457-a927-f4250f633bcd,Teyla,34,53,80,64,28,59,318,
d0f75f15-8cbc-47d0-a80b-7e3142b8ced6,Thaddeus,0,41,41,81,66,89,318,
d0321932-138c-4337-9e63-7babb60e3df9,Thalya,26,4,14,31,3,42,120,
55d92456-bf90-43c7-9242-db66710903ec,Thamara,67,20,87,49,3,74,300,
f41398cc-fb5b-4881-b799-c4a9d4cc73cc,Thang,21,70,71,71,84,93,410,
9ba57ab3-f01e-4acf-bce5-213f8caf3468,Thanya,91,22,27,0,25,84,249,
6be17d83-b9f7-4135-9abd-09a1a24ed550,Thayer,77,70,91,43,88,26,395,
a781597d-c848-493b-be28-09203b643fc7,Theadora,67,46,33,31,19,94,290,
14d3bb47-025d-4c17-934a-6a2f730bfde5,Thedore,69,15,1,99,74,19,277,
79eea5cd-2f3f-45ea-acf0-c32fddcf48b2,Thelma,48,98,85,67,36,23,357,
939d5ce4-fd65-4712-ad84-c167438a6ace,Theo,91,63,83,83,39,7,366,
5ee9aaa3-3ada-4c9e-86ad-d49188335b83,Theodia,74,67,68,21,85,41,356,
65539a4e-b60c-400b-b861-29877ef5ee10,Theodoro,37,2,94,16,73,15,237,
fe5dd26e-e90e-4dac-a9c3-6c5a55d9b733,Theophile,15,84,47,4,14,73,237,
11b5313d-0bb2-4594-bd24-2fccfb813c49,Theora,66,71,63,82,83,53,418,
b39a5a0f-af44-46e5-b905-bf627cc0c0f9,Therion,64,54,93,33,79,99,422,
310aa72d-1be1-4fa9-8e3a-38ff9bf817dd,Thersa,85,15,79,86,81,79,425,
c188d9fe-3d45-429e-9812-2c76f6567c64,Thimothy,14,59,76,19,7,88,263,
c43b9832-dbde-45f1-abc2-9c10b92fc082,Thinh,47,44,99,18,14,43,265,
77595e31-a474-43cb-a479-03f8a3723299,Thoams,12,65,25,49,72,19,242,
17aa3c84-3fcf-42a4-852c-6fde1502b720,Thomasa,46,47,63,100,66,62,384,
029d5e7c-3d7a-485b-bc28-ee1307925b23,Thomasa,73,11,61,55,55,28,283,
19bfe62e-c999-4475-a598-96aafe37b6bb,Thomasena,98,49,24,99,39,0,309,
b5f98eec-ee94-40ef-9e1e-a711cda70d7a,Thomasenia,33,78,68,100,92,92,463,
f1fef034-741b-4a5d-9133-72687c4722ea,Thong,85,12,73,14,5,99,288,
7d8a426a-6a00-4bfb-b887-a8331877ee6a,Thressa,89,50,65,59,54,96,413,
9938783d-5525-48b1-a8e8-09c18850e55d,Thressa,93,81,26,83,98,66,447,
63cd145b-5b96-4e75-8f20-acab9d6fad09,Thuan,79,79,19,3,52,42,274,
3a6992aa-1bb3-49da-9433-5b3fbe64e3b6,Thurman,75,77,55,39,39,74,359,
c8314e23-cabb-4549-bc81-2058266d1982,Thurmond,42,80,71,17,67,98,375,
c80b052d-0db9-48d0-8cfd-53247180b014,Thurnell,17,72,75,53,53,55,325,
350cb0ec-c864-4961-8ac1-d038547925ae,Thyra,7,66,99,77,31,21,301,
43336502-9d04-4a51-93ac-1be824e8efcd,Tiani,69,89,15,26,68,49,316,
3041b362-a87b-4df2-aeee-a274c7adcd54,Tiarah,73,45,100,62,46,75,401,
4f4d94d2-5181-47c2-8709-4ede97e31ccb,Tiarra,97,65,58,63,8,4,295,
f3acafb0-6d17-47d7-9984-3c4dbae4d570,Tiasia,86,5,36,30,14,41,212,
99109fff-471f-4667-9314-2b4e09c1ceb3,Tiberius,57,33,60,72,96,90,408,
a7a618b1-e4b0-4069-96da-9ff78af09f11,Tiburcio,7,21,7,73,84,28,220,
ae25f964-8253-400d-8cc3-e6d9765515a4,Tiera,87,23,59,56,23,88,336,
c62e667a-3b71-4d33-9823-fe0219294e6a,Tifanny,52,95,37,75,67,2,328,
e2c48883-6731-4b48-bdf2-5db25f000259,Tifanny,55,75,0,41,15,52,238,
f695d1dd-cd7c-430d-b4ab-0e971e662658,Tiffaney,29,40,51,12,22,5,159,
dfeb33f5-f39e-4393-8daf-7a849d454e18,Tiffani,92,27,20,58,87,97,381,
457a11c7-8dea-4353-8941-af58aa599826,Tiffanie,70,54,13,68,92,98,395,
0fb7a7cd-f70b-4fd6-aea2-6c662ea0f416,Tiffini,53,71,7,61,13,78,283,
a6e074c7-89a2-4410-88e5-08ee8f1aafb2,Tiffini,17,17,91,63,90,73,351,
a09d5d95-3d2c-40ed-8071-66d4815e0936,Tige,53,0,82,47,45,24,251,
779a7023-24e1-4882-98dc-0f013ca2bc5b,Tiger,71,55,100,79,56,34,395,
4b1d3e21-54f2-4345-ad12-f3692d552521,Tighe,92,19,49,18,66,73,317,
22410210-8e34-4e1f-a976-80c703f5086a,Tigran,18,38,82,25,13,53,229,
c30cdc00-4f51-4685-ba1d-6c410bdc6bf5,Tiheim,90,70,95,95,38,51,439,
2a4e5c5c-2368-4f9f-a12c-b6aeb740f825,Tijuana,91,1,61,8,71,15,247,
2915f49b-2e53-488a-b936-980d6919b144,Tikisha,17,99,34,81,54,80,365,
062b75ac-1fca-4fea-8182-26bec1f3f080,Tila,19,50,30,58,56,95,308,
75a80a4d-dea0-438a-9a3a-599a7ba99169,Tillman,38,17,88,69,1,15,228,
b13bdf28-32e9-47ae-a624-25a25acee58e,Tillman,78,54,41,65,55,64,357,
1c1bea04-38c9-4f0d-bbc9-c590d5462650,Tim,70,88,8,28,40,20,254,
3f4b1181-79b2-4533-b010-f8cc24a9042c,Timaya,43,73,31,42,55,25,269,
765bffb2-47a2-4654-9a37-deeb06fa4d53,Timberly,42,2,24,14,58,1,141,
d4cf4460-5e6d-4cf9-a344-0562d41a5acb,Timothy,36,47,71,95,85,56,390,
5a10a799-05b7-4d08-aa50-1e238039d056,Timya,44,67,70,37,92,84,394,
811625a0-d318-4b60-8b24-45b3936d4af2,Tin,61,90,38,11,67,88,355,
59f92ce2-050e-4f36-a9e0-7728215f22f9,Tina,47,21,80,5,84,61,298,
ac206f64-bd7a-4da1-9e4d-fdd2022f38ae,Tinamarie,73,5,29,76,7,25,215,
b532d17d-90ce-4f4b-a483-206c89cf7576,Ting,59,97,26,41,77,75,375,
c49efe48-630d-4eb6-b5c7-41a8f44bf10b,Tinisha,70,74,20,23,43,29,259,
cc6e46d9-0017-4ba5-876e-d4b823a1daf0,Tinnie,89,28,82,8,13,21,241,
91788b9b-eed8-4b7e-aed1-563bd57f6f5c,Tion,10,52,90,82,64,78,376,
c8986250-4ee8-4504-91ac-226554ee5a21,Tion,93,87,32,3,54,14,283,
254829b8-cadb-4c06-be54-30111a7fbb79,Tion,80,46,79,13,97,91,406,
2e5ac36d-0a92-490c-8435-1239c6209be0,Tion,87,55,5,69,35,9,260,
86ac27ac-b843-4f4c-a11f-1f5290968fb5,Tionni,58,89,48,49,64,56,364,
b295b693-f02c-4b2c-85a5-32418b57b7a5,Tiphani,36,96,28,35,31,29,255,
e35baf6b-3394-4015-820b-9fefe28e77ce,Tiphanie,49,13,2,77,98,27,266,
a02d8d47-dfbb-441e-a178-2e5198a607d2,Tippi,0,46,20,88,38,68,260,
61885379-37ef-4f37-b702-c0cfe8ec599d,Tiquan,64,46,65,72,55,32,334,
83da94b8-dbb7-451d-a3d0-66da0b123238,Tira,89,66,50,64,93,9,371,
ce1dca46-ad4f-46f1-bb8f-00a7f5bc26f8,Tirso,13,1,54,80,63,44,255,
bc1690e8-66cf-4567-90b0-31d1f2fc3dc5,Tirzah,77,54,30,55,21,9,246,
42e55f66-cb1b-4cd7-8378-6e6964e3809e,Tishana,73,80,41,41,75,63,373,
b356d7fe-a782-43f6-ba66-9f333325efe6,Tishana,29,41,30,81,90,29,300,
56d524c2-32a1-4359-a1db-8b13e39ba1da,Tishana,12,34,22,29,85,36,218,
0a93c35a-ce6a-465b-8aa2-9d01c02f722c,Tishana,65,100,78,21,93,87,444,
cd13ccb0-e1f0-4760-83b3-0a279e091895,Titan,13,69,21,83,64,78,328,
5bc444e5-71be-4fce-b4ef-fc5f576bf0bb,Titania,26,99,73,67,35,17,317,
28391681-3803-4482-bc72-b5db040b484b,Titania,78,2,96,91,39,73,379,
f53db971-83bc-4f51-8d7f-855d7d0c19cd,Tito,40,44,41,4,67,34,230,
f91b64ae-5701-4d47-92b3-4ce462a548d9,Tivis,3,97,20,32,21,39,212,
b77b82d0-c6bf-4601-b251-8363278c015f,Tiwanna,58,28,97,31,46,96,356,
d98ce4fb-46c6-4258-9459-f3b4ed544f38,Tizoc,0,62,6,27,26,8,129,
4b33743d-8a48-40cd-be10-f9e20af57c28,Toan,48,62,73,89,88,63,423,
b52e2b5e-7cc7-4b13-83d2-41ed7af2f4cb,Toan,83,75,100,35,79,90,462,
8aae3abc-e052-402e-b4f0-06d2093a8ce6,Toba,27,37,52,84,14,90,304,
95a6e00a-dbee-446d-ab12-57fde75f3c3d,Tobey,77,26,51,93,23,45,315,
e8ca6d11-a7f8-46b7-86ab-b918a2b1a10d,Tobiah,0,76,48,20,33,49,226,
2d26d082-dae5-4caa-bca0-5e912348f7fe,Tobie,56,24,20,48,92,43,283,
f57d09b1-88cf-4c78-8e24-37ade7804e6b,Tobie,60,71,40,84,1,48,304,
72a1f3bc-a4bc-4c7b-aee5-4a1fdf3fc211,Toccara,37,97,82,26,70,35,347,
3848f0d1-5ea8-4559-8c9f-b7504b120d96,Todd,24,17,44,36,77,40,238,
f192405e-f9e0-4b33-9313-c98623acb0c5,Tollie,52,21,15,40,46,57,231,
702251df-a8ef-44ee-bc86-7e104042466b,Tollie,95,89,27,43,34,9,297,
cda8a8c3-dffc-41d8-9527-e7a1e2e1fda9,Tollie,75,40,98,90,17,92,412,
a8208d8f-0efa-4cc5-bfe4-ca7b67b409a7,Tom,73,82,80,44,87,33,399,
36f379ef-021d-43f1-a750-ab7ac51fabe8,Tomara,100,53,58,81,92,96,480,
ddb01a22-910c-49c0-bbb9-3bd1e9499d75,Tomasa,0,95,50,57,72,9,283,
d66909cf-e67a-4e04-a9e2-d0b155d39c4f,Tomasa,76,24,66,75,87,40,368,
a8e06990-361c-465a-8e1b-d63eddba33af,Tomasina,72,94,42,90,39,73,410,
2ba3a05a-0c6b-44f0-8e27-d5c35f80aa9c,Tomeca,3,30,94,12,20,40,199,
ccd9655e-c223-4fb5-a3e5-d07b796941da,Tomeka,18,86,6,48,61,21,240,
226d9f27-221c-462b-98c0-d2bdebe002a4,Tomika,72,6,65,72,71,89,375,
5c7fd797-20f6-47d2-b328-09cff0b490d1,Tomiko,66,74,58,66,57,71,392,
68618837-a185-4513-915e-da84d4595d96,Tommie,36,19,98,84,85,49,371,
bc27b529-eda0-474c-b299-05d6e7e4378b,Tommie,26,0,35,31,47,36,175,
7296ed12-1ba8-476d-bbf7-22d93976915c,Tommye,64,54,94,4,22,50,288,
4f9f0736-281d-4fdb-bed5-bc5932a14a69,Tommye,40,91,21,22,3,92,269,
0abc8a51-667b-47ba-b59d-9a4f75974a88,Tommye,94,57,36,50,85,97,419,
fefb3077-9809-452d-bc90-e28b69a790b3,Tonianne,60,33,23,76,76,84,352,
d58b806e-65ba-45f3-9294-e88b49f3e62d,Tonna,86,99,87,53,82,71,478,
44fd2417-cb5c-46ab-a73c-9a62dbf59e65,Tonnette,76,59,28,10,32,87,292,
6f604237-70be-4da5-964c-0f432a382fbc,Tonya,62,7,1,4,72,50,196,
4fa0358a-1bfb-442a-abf2-233c5ae8e840,Tonyia,59,51,4,0,73,61,248,
b426e56a-037d-4b34-9050-b8428b4d7e0a,Tor,97,93,82,85,19,38,414,
42e5e9e9-9e40-4c6f-8dc0-83afb58f6ecc,Torao,8,39,57,25,28,49,206,
911a5d67-d11e-438c-b98e-831015e0a56c,Torian,78,78,94,49,9,92,400,
faea18cb-f74e-4526-a6dd-b6e1df56e360,Toriano,13,65,19,15,48,88,248,
47d157d4-cd79-46be-bec8-8f809a8654f2,Toribio,11,80,76,51,31,31,280,
f1fab5f7-cbbb-43a4-85e0-2cd5c5e0b42b,Torrance,9,99,96,91,23,89,407,
66766ddd-e6a3-4819-bfe1-a70d4c8ee6f7,Torre,86,92,70,14,69,97,428,
c5c3aa8e-c1c0-42cd-8c79-204262024f73,Torrence,55,61,75,82,43,10,326,
f9050f39-36ee-42a0-85c6-5985e3643102,Torrey,81,28,60,23,54,2,248,
4fed9222-f205-4449-aa43-f37652860a71,Torris,73,11,58,69,7,97,315,
c26684a5-9d51-4f67-a7ba-aa444b7a29c6,Toru,71,54,54,19,98,86,382,
50e5689d-f717-43b6-af70-a5ade3f3bd4c,Tory,99,36,4,6,30,50,225,
16edcc8a-1dcd-47c0-a88a-0962b02fe68b,Toryn,42,63,95,67,73,27,367,
b6559718-feae-49ad-b59f-af2ca4d42c82,Toshia,37,84,5,63,83,61,333,
7bfd0a16-5849-48dc-8ada-8d64482d0d31,Toshiko,42,18,45,30,73,74,282,
acd7112e-df9a-4178-a703-48240d9e8e86,Toshio,17,22,64,8,45,48,204,
15b196e0-865b-42ed-b5ac-f072ee2dc25f,Toshiye,89,23,18,92,34,42,298,
1f0b40d4-5e94-4708-984f-e223fcbeb8b3,Tou,57,44,67,56,53,27,304,
0e8d8dfe-8d37-4aa2-917b-4acc76831b90,Toua,71,67,65,79,25,24,331,
2e4f6863-9d79-40ba-823f-fcc917705467,Toussaint,92,16,26,2,32,42,210,
81549aa1-e7fc-457a-8931-5173d4c5c01d,Tovah,87,89,49,45,93,86,449,
2a5a114d-45ce-475b-8fec-3823b4ca8f71,Tovah,75,62,39,48,18,53,295,
c3b4a9de-a4a5-4d10-813c-e4b835ee3175,Towanda,3,72,56,66,83,13,293,
da39ea6e-e0d3-41a3-ac5d-79cd148d30d3,Townsend,20,48,39,54,41,92,294,
158b2682-43d2-48f4-a208-c7c1f66e6b1d,Toye,29,61,13,45,79,81,308,
bedb27e1-15a1-4609-8b0a-6abe495c370f,Toyia,91,92,47,5,65,36,336,
790746c0-901e-48f8-a35b-67a8029a8ed0,Toyoko,71,16,47,61,28,85,308,
7152c9ed-c743-4ac8-b0ec-160d9940b657,Trace,70,78,53,66,51,26,344,
bb770da4-02c0-4677-a304-37b98cc82555,Tracen,83,82,90,66,38,59,418,
3889ac01-8e86-49e8-8726-3b924b34ec05,Tracer,100,99,20,22,32,72,345,
a0a5c65b-b5ae-4fba-b1d3-bdc82ed9cf96,Tracey,48,15,21,75,99,66,324,
f92aacfd-e2b1-4f3c-b80f-9f7e3b8a79e1,Tracie,25,100,85,74,74,3,361,
665c164c-ab4e-4abd-9259-34120e6c4e67,Tracy,41,96,43,18,33,34,265,
e52ed88e-e408-415d-a950-b580ef05e1a4,Tracye,42,82,69,57,60,59,369,
adf05d80-a4e1-4dd4-b4a1-dd748cf83d4d,Tram,13,20,0,50,63,40,186,
978cc9cf-33b7-4956-a2be-d82e50221699,Tramaine,11,11,79,62,20,15,198,
5122850e-a985-4939-8788-789d71818664,Tramaine,47,4,67,27,27,20,192,
16a11921-367b-459e-8264-010cdfe6c04a,Trampus,60,55,44,18,2,15,194,
d38e859c-e588-47fb-b96f-012beb5cebf3,Tranisha,33,83,8,17,66,70,277,
9ec5d29e-6f02-4ad5-8cf9-d9c62d633479,Traniya,92,10,45,3,47,44,241,
35d65c7f-8f74-4c94-9025-3d8df1dd3548,Trannie,79,91,22,58,1,74,325,
bb7deeba-0442-4d24-a631-5b2b94d8c37f,Trason,32,1,18,31,57,36,175,
3a6a479d-8e43-4f79-84d7-bd92bf3af051,Traven,96,34,81,29,56,51,347,
57b4a6c2-3615-4c76-8724-4b1f099bcb5c,Traveon,7,16,74,86,68,74,325,
4f5aaf85-d5cc-48d5-ab18-878afb99b589,Travion,19,74,2,69,7,82,253,
21351532-cad1-42de-940b-336857c2a8a2,Travion,71,67,15,91,33,32,309,
29bdaba0-dc73-4157-9ab7-379e311ee063,Travonte,30,54,12,68,64,100,328,
4a41e344-3834-4c88-af98-1d4c644c03b8,Trayton,98,69,94,58,24,96,439,
bb27821a-9e28-40f9-80b8-2d564ddb7d2b,Trayvon,34,92,41,36,94,7,304,
4fdd97f9-4f33-4809-a934-e56e3668c50d,Tre,61,48,29,20,77,41,276,
9b2e0bc4-117d-4481-8f13-aa1af1105736,Treena,22,90,77,19,18,66,292,
9391b95d-97f5-475f-bf71-6dcc45887040,Treena,77,8,29,56,100,17,287,
6c61a9f4-16bb-49e1-9030-d722ff8d8751,Treg,84,84,98,4,23,35,328,
695f2420-fbee-4775-9598-a8177b0c34b0,Treg,96,52,100,24,55,80,407,
f2b143b4-d9ec-4d4e-a208-dc95ed0dab5b,Trellany,38,8,2,42,59,39,188,
a2ee16c4-257d-40ca-98c7-07e620cf760c,Trellis,8,95,67,74,49,70,363,
db1deb1b-997a-4eef-a72a-976be2ab0ff3,Tremain,57,93,23,35,78,100,386,
0a2641b6-dabf-4962-bf05-180f5a22d13f,Tremain,85,86,20,75,12,98,376,
24cdbd8b-a393-437d-9e12-8961a4575b28,Tremain,34,68,10,21,6,58,197,
edea1975-9506-458b-a8cf-2853cf0780d3,Tremel,38,27,96,75,59,90,385,
1e485e54-d422-4c7a-aeb4-aead1650f296,Trena,47,22,57,78,45,34,283,
3de8b835-a79f-42ac-a3bf-3aec90aa6d99,Trenden,95,14,75,79,83,27,373,
54690d11-b445-4a95-aba0-0ed4958ad709,Trenden,3,37,25,76,56,94,291,
af5f80d3-04f7-45eb-9333-24ae9631dc5b,Trenell,71,13,50,80,32,45,291,
f134a290-b612-4b21-a8db-701fa569239f,Trenia,37,11,37,59,68,75,287,
7d58b6e3-bc9a-43f4-b0d4-6d43ed776977,Trent,83,30,3,36,50,23,225,
fc583160-858a-4e25-92b9-ee85b038cbc7,Trenten,71,61,53,51,63,78,377,
551a83da-aa45-4549-8e57-bd44ede82d98,Trenten,97,69,21,21,36,79,323,
cadad49b-9740-4437-9dc4-21a429ea13f2,Trentin,86,90,65,68,11,29,349,
3008e703-8324-4532-a3ff-942431524171,Trentyn,100,92,7,98,72,43,412,
67dee004-ed38-4c17-8ab3-515c3b921351,Trenyce,44,15,66,38,82,67,312,
6d071117-81a0-44ae-953c-302c245ce4db,Trequan,54,72,67,13,69,49,324,
327b987c-9165-43b8-ad30-e79bc9775ad9,Tresea,63,92,76,98,64,37,430,
4b7aea31-997e-417d-831b-76ebe3f3ffc6,Tresean,25,71,77,91,27,37,328,
6feeabab-7337-42ed-ac81-b5019e49dbf8,Tressa,48,53,85,69,51,98,404,
408f5e3f-4ad3-45d5-a173-f257c88acd2d,Tressel,55,77,69,89,38,72,400,
1d2d0d89-e51b-4014-8678-63f77d2bd4a9,Treston,55,0,53,46,32,43,229,
06b27247-2669-4bae-87c0-9a07380fa14a,Trevia,24,16,71,99,82,23,315,
f028961e-8be0-4b14-bb95-64e0c30c5bb1,Trevian,76,5,37,48,98,53,317,
da512ba1-d7ec-43c7-801c-34478b85ce6d,Trevino,87,5,46,34,6,13,191,
f00c7bc2-07a3-4ed8-b091-5feed2b62c11,Trevis,75,44,45,52,20,4,240,
e751b05a-647f-4276-8355-1444e00edfa7,Trevone,75,64,44,81,35,99,398,
f789fa72-1a37-48f0-b1e8-6c4019235edc,Trey,56,67,66,98,38,88,413,
25735524-c1db-4473-93f2-ef8d5b7d20ab,Treyton,35,69,98,73,22,14,311,
9c99ae5b-b925-4b86-bd39-71a6c3ae26a9,Treyton,46,3,15,59,50,36,209,
6db69616-e085-40a9-8519-a459eac14fcc,Treyvon,53,95,20,41,95,55,359,
d5936084-1a59-40c7-8c8e-986eb353943f,Trigg,51,50,77,99,37,36,350,
426511f3-5a83-4189-9418-ac8d92793fcb,Trindon,37,35,7,97,29,1,206,
23371bcc-4da8-4c0c-b94c-5c379aa2bf55,Trindon,49,29,69,91,39,49,326,
eb8e1fb2-9d50-4f7c-acdd-2a4e069f6030,Trine,42,50,16,0,55,73,236,
7446c7ac-9be7-4865-8d40-d53d0e5d89f4,Trinh,52,61,9,12,11,72,217,
8e1e9d14-b69a-4422-be67-8847213f8a36,Trinh,82,28,100,1,67,17,295,
8ec689d8-4cee-47dd-9725-6e2b3f025617,Trini,27,60,40,29,69,45,270,
e2a790f2-e344-41b7-ba90-451bc803dfc8,Trinidad,45,45,28,76,35,34,263,
b39f12f9-cc47-452b-9d34-6a153610ce77,Trinitee,6,54,78,82,4,82,306,
77bbf5ae-83f3-4e4f-b4fb-f1be529cf88b,Trinitee,64,29,26,73,59,7,258,
b2244412-020c-469d-95e7-e3c336029694,Trinity,61,13,22,21,39,55,211,
c49fa953-7a5e-4576-aa92-77ccbc6f57b0,Trino,23,50,53,94,57,47,324,
8eef1c9d-c139-4601-bc17-b855b2bd4510,Tristain,23,99,42,32,34,75,305,
b5de5980-f928-4069-99e0-854a191885bd,Tristain,52,29,79,63,29,76,328,
26d6ee39-eef4-4188-ba51-b02fabf12c6b,Tristan,84,4,35,50,47,69,289,
f0f78860-820f-43ad-800a-7376a7459451,Tristen,64,52,38,87,33,12,286,
8b76eff9-8cb6-442e-a7da-f0571c990fdb,Triston,62,1,7,48,55,91,264,
5f1cba67-a045-47b2-aaa9-b7e038b1f35f,Tritia,68,14,46,97,27,83,335,
b7971115-a84d-40af-a21c-5f50aa75a90a,Trong,37,25,81,58,12,57,270,
2b6f7199-cf7d-493e-ba13-e2b862b2408e,Troylene,76,21,31,81,52,74,335,
c29ed9c6-072c-4b09-9b65-2081bef4851e,Troylene,40,62,38,45,74,37,296,
a236984a-ba55-405b-98d6-dd8ff36cf436,Tru,76,88,77,59,68,33,401,
222fb715-800c-4305-9d2a-664f1fd0e853,Trude,16,84,25,12,88,44,269,
ee8bc20d-1b2a-43aa-a4df-469e1ffcdbeb,Truitt,64,10,14,95,1,99,283,
e1108480-48da-406b-b2aa-7f763be87ec5,Truman,12,26,36,69,13,57,213,
d32b81b0-317c-40ed-9410-c7dc5eda8b29,Trysta,51,94,6,28,2,6,187,
b4825e30-663d-4442-bc0b-3885b27a2641,Trysten,6,7,30,41,94,90,268,
d6f2c42a-d5d0-4e54-9661-17944d91d1e9,Tsering,64,48,81,52,70,38,353,
a4616c86-3790-4b2b-ab6f-2053c3eee695,Tsugie,76,51,76,52,92,57,404,
b9a3c457-15b7-49d9-97c6-ae424ad97dd0,Tsuneko,30,57,55,25,25,43,235,
09ab2bca-ed06-421c-a882-2db8fa1ea103,Tsutako,12,89,46,20,48,3,218,
c6200c04-f91c-4d66-949d-faa98b23b728,Tsuyako,53,41,22,0,76,26,218,
ed33b875-3727-442b-a681-2599f1384880,Tsuyoshi,83,80,53,35,94,18,363,
2a96c56a-f7fc-45c1-91d5-b508fe7462dd,Tsuyoshi,7,55,68,79,35,74,318,
6a50e4f9-aa68-4498-9ff6-1af9bcafa2c4,Tsuyuko,36,93,40,10,9,66,254,
37a7d6fd-76c5-4889-82cf-cd11388f6ced,Tsuyuko,64,22,28,1,26,5,146,
5d758927-55b6-46d3-a9cf-10708fbcf7fe,Tuan,33,70,88,35,81,45,352,
1e1f36ad-e37a-41c5-bce6-ddd84f4bf9a0,Tuesday,22,66,92,2,48,8,238,
9bf9d0f1-840b-4fd7-8983-89eb40cb22e6,Tuff,62,20,65,93,58,16,314,
a54c4115-4850-4833-8554-0b33cc1a93e1,Tula,31,98,40,73,16,81,339,
ecc09d9e-e24a-4d01-a18a-37eb39358797,Tuleen,9,71,61,80,0,42,263,
0f0058c4-46ef-4172-ab8c-15135824b065,Tulio,9,93,3,99,2,5,211,
38f534ee-c4b2-417e-adbc-0958eb301fa4,Tullio,18,81,59,53,39,49,299,
55daf2b3-8621-4677-a1bb-50b8eadb24b9,Tullio,52,48,6,30,92,13,241,
01e6626c-d3de-4d58-ada5-3e3c4d187450,Tully,85,85,48,0,96,26,340,
5e138714-4365-4309-9c43-a6ffeea1246f,Tully,90,41,67,83,14,60,355,
2b594fac-04ef-4fd9-8945-f93c57ff1bb1,Turquoise,14,20,62,20,81,100,297,
c0fa5bb3-0ecf-4120-985b-1d0183185ca9,Tuyen,97,48,20,92,96,5,358,
9d3a5757-424f-4441-8de2-7b1ad3928722,Tuyet,32,75,15,48,35,71,276,
e760d77e-b0fd-43bf-9f8c-13dd65c7f39d,Twyla,57,15,100,49,22,71,314,
24ee13cb-c554-45d9-beff-7192f8da96e9,Tya,4,14,99,93,8,8,226,
d0e8ab87-4194-4d77-82e9-18804d3b5902,Tyanna,59,65,9,76,87,38,334,
f610d59e-4f12-470b-a331-89f9fd12961a,Tyanna,73,63,66,53,8,85,348,
6d406ba1-c901-4fd1-9280-60d831cf238f,Tyashia,29,75,48,99,40,17,308,
2297a510-13bc-44d4-a2af-9d875a683871,Tycen,25,36,78,78,64,24,305,
3da04864-478e-45fc-b04e-68d2fc23bd36,Tyden,0,52,21,38,82,45,238,
10728d84-8612-4287-bbfe-72345a264351,Tyhesha,3,70,6,2,43,65,189,
58333cde-d54d-4b91-9638-cd00d9616b58,Tyhir,48,63,47,26,50,82,316,
b25ed6b2-1236-475c-9480-d897616f2ef0,Tyja,61,83,3,9,6,12,174,
37e83f02-6ade-4705-8047-7159ce3b4be7,Tyjae,64,78,37,82,12,78,351,
cb59f843-7649-4b0b-91c1-f5850e6d99d0,Tyjuan,0,42,67,7,5,50,171,
4271a23d-3b13-47d5-9d85-8681a3d15872,Tyleah,33,56,70,60,38,59,316,
1ab8dc35-2bf5-41d5-ad9e-a0b4392d2d55,Tylen,65,11,98,51,63,29,317,
4e6df8ab-b616-4710-a0db-d1ee95c4aa7c,Tyler,12,76,69,19,67,88,331,
bd3c789b-fd52-45ef-abd6-371b981d3d83,Tylia,14,56,84,79,12,59,304,
11712460-bc9e-4e98-a2ff-e1da480a9a8e,Tylia,50,71,28,1,16,47,213,
b747bbde-94cb-468a-83b0-4a15836e0d16,Tylon,9,24,27,41,84,56,241,
a8b33e60-5d9f-4e24-9d10-a139e585d652,Tymarion,54,53,27,62,1,17,214,
ca57b339-8726-4e65-8a08-a9f24d9e3a29,Tyna,31,69,54,61,82,12,309,
2b78395b-1aa0-4004-b178-7a1a5147046f,Tyna,79,28,41,57,100,11,316,
98d80267-8d91-4a5c-9743-5b8da0c3c6ce,Tyna,0,7,27,19,81,88,222,
3751dca0-213d-48de-a127-5c28038eca1d,Tyonna,46,58,50,50,90,54,348,
f06da8e3-5d85-46cf-b9d1-802c9529eccb,Tyonna,49,54,95,91,77,22,388,
dffee857-5185-48dc-a88f-9442dad0e0a8,Tyrah,55,21,9,38,85,41,249,
b65dcb12-eb63-403b-a301-5c48ff5af5ac,Tyran,18,28,72,14,31,11,174,
0d3994e9-5809-425b-a657-1736c2e5fb5a,Tyrease,48,85,51,74,46,33,337,
7acc00af-08ad-40e6-8197-5567bafe67aa,Tyrece,88,76,13,61,52,81,371,
2c6dbb42-0d69-4f58-a72a-57d46dc390cc,Tyreece,47,65,49,40,70,5,276,
6de3de61-79d7-4a56-a3e4-59340190805d,Tyreem,17,86,85,75,44,91,398,
03c0d5b5-3569-4a74-a5e7-334ab7807d23,Tyrel,15,68,99,87,60,92,421,
2d01e5b8-49fa-4cca-81dd-64e39a6c2214,Tyresse,96,8,31,41,91,28,295,
0780a871-6be0-4b16-88c0-ce63c6dc0596,Tyriana,16,100,86,86,71,34,393,
225afe6b-8c26-4ee5-8e56-007ea49c9bf7,Tyrie,32,15,87,41,25,97,297,
e953e929-6487-4fff-86af-93e0a6fa7660,Tyrielle,42,31,58,67,70,68,336,
a3772a78-b6ad-403d-a9a1-fe4aecff8d66,Tyrik,45,78,88,83,81,20,395,
ad11f210-7e6e-4dd4-a8a5-96b01311c29a,Tyrin,9,33,4,2,82,45,175,
3f4253ee-3795-42e3-bf59-b6862c658d20,Tyrique,51,49,75,69,95,58,397,
80d845f7-8ddc-4dce-b795-e874576483d1,Tyrrell,70,42,74,57,29,45,317,
0e08b8b4-e883-48d3-8d4b-9111675e747d,Tyrus,80,25,95,34,73,82,389,
49176d11-fa7f-4b15-9518-a2c6552197a8,Tysean,65,65,96,6,27,89,348,
339d2f8b-4a0d-4084-a40d-b13f87b28248,Tyshae,25,84,98,35,9,0,251,
0d125f06-657d-4cd3-9443-f7c7516b0ef0,Tysheem,32,37,15,36,98,55,273,
497b5d4d-50a4-4a1f-9500-928de20a5945,Tysheen,84,9,64,30,18,54,259,
9d93d2a3-d4a8-4e88-83ce-12cd4bb35f59,Tysir,93,92,99,19,14,15,332,
11334e48-ed1a-43d3-8bc2-05c962f40e1e,Tysir,76,1,20,37,50,55,239,
d14d6521-023b-4c55-a583-3a88e985d781,Tytan,91,73,2,98,21,29,314,
d6786e53-e342-4334-806d-84dc9497ac22,Tywon,19,35,91,58,97,50,350,
cf238a73-d7f4-4f05-9155-f2aeeb61e58b,Tywon,5,81,34,89,38,56,303,
de43e1b0-e2fc-4910-93ac-e57449fe1ca6,Tziporah,86,23,28,38,7,38,220,
69e6064e-7f5e-4617-8620-cde033f338bd,Tzipporah,56,27,18,69,76,54,300,
aece17e2-9cf6-41cc-8f80-05c40285daf1,Tzivy,75,81,8,34,2,50,250,
6f03e3b0-c416-4665-9bdd-47d0d3f5380c,Tzivy,78,0,27,43,64,38,250,
f266b47e-09ba-4218-a8c8-b79d726d8eac,Uday,21,100,8,5,60,67,261,
4e8a7b63-a3a4-4ac9-a2c7-14b84648a602,Uel,29,83,70,73,87,97,439,
b2048a7d-49c0-4120-ab26-68f46c791eb6,Ulysees,88,34,41,28,29,55,275,
fb3e2884-1802-4eda-8136-a632ed3d883b,Ulyssa,37,38,56,60,15,11,217,
dbcf51f3-bf2f-40ea-ade1-791463628ce5,Ulyssa,27,94,38,56,34,37,286,
a4d468ce-4dc5-4e1c-946d-bc006fb1cc6e,Ulyssa,98,22,95,49,10,92,366,
f46b27ab-81ee-4679-a891-27f9cf13c9d5,Ulysses,38,26,1,92,2,83,242,
819284a8-6b61-4935-bc12-f9f849a7b2af,Umar,25,49,12,9,54,61,210,
dd039bb9-0038-4ae2-9957-7177225a4502,Unknown,44,77,94,12,73,14,314,
d1c4e8f6-ae0a-427b-86cf-87fd2b4888fb,Uno,27,84,35,35,7,21,209,
44e16051-2d45-490c-891b-07fb95dc4875,Ura,54,63,87,78,74,79,435,
5ba4d8cd-19e0-4730-b3ae-6d7b21bc059b,Ural,45,79,89,53,18,3,287,
6c492cda-8eb5-4ea5-9ba3-5658d432babe,Urban,80,8,97,21,88,98,392,
84de1d62-b262-4781-ad07-c41d49e8d19d,Urian,8,74,32,40,83,3,240,
fcc5e514-044e-4352-ae27-faf160494241,Uriel,23,84,41,66,54,45,313,
05346bf6-138d-4abf-9c30-1fd156938b83,Ursula,19,93,51,64,83,13,323,
123fecc1-6702-4e40-a513-d1c3127ccd3e,Ursula,3,36,57,78,96,34,304,
6cf186c5-ca97-4eb3-80e1-9f737e5ef1ca,Uziah,65,79,47,24,56,35,306,
77ddfb88-9513-4e7d-ba8e-90ac717f5d79,Uziel,57,28,68,17,32,65,267,
c690dd06-b4cc-4876-b060-4bc1c6d23d25,Uzma,59,62,95,25,36,31,308,
ac95aa47-377c-48f1-9608-41b477650d65,Uzziel,60,12,45,89,70,73,349,
ee335da6-aaa4-4c64-866d-bbcd44965794,Vaden,37,25,66,9,15,85,237,
22762cd0-2e1a-4d9d-8a0f-b619cec1e358,Vadhir,62,50,45,55,62,23,297,
05bc9dd5-4af9-46b8-a6cc-7411c4374c19,Vadie,100,24,50,21,43,60,298,
f0436b0b-9057-4b7b-bb74-c98c38be0fa7,Vadim,57,94,95,71,96,76,489,
180ba4ce-f668-4e36-8e39-9e70d936ccf9,Vaida,72,11,38,17,68,38,244,
95e9a2c3-4e17-4acd-8bd4-e369878e9323,Valbona,27,38,71,33,92,51,312,
6ef399bf-ce7a-41d5-9e0e-497385990ee4,Valdez,29,44,92,57,34,53,309,
27427f05-e9b0-40de-9cfb-970323d22662,Valdez,86,74,41,17,33,21,272,
71ce6380-7fb7-4634-b2d6-44ce54742224,Valen,95,96,64,27,95,72,449,
a202c45c-36ca-431e-b3b0-08c7703539d2,Valencia,11,73,49,7,72,11,223,
aad6d0a1-bf8d-4ec4-82c9-20ffbdcd07cc,Valentina,75,0,69,30,7,29,210,
4e5702d1-ab8e-4d55-a259-f56e8eb3a56b,Valentine,37,46,17,92,59,20,271,
f5430f08-75f8-4610-939d-50890dd0f9db,Valentino,17,23,97,78,22,15,252,
e9412370-f231-4887-ae55-cb3cba5a0ec4,Valeriano,97,1,26,83,16,0,223,
26b1ca40-79c4-4812-a3c0-2756b8f76b73,Valicia,26,84,0,13,43,69,235,
cc868fa7-9b81-4410-950d-6e3a0da7f648,Valli,6,2,0,18,88,23,137,
4b15d3f2-b97b-4131-9039-03a500321357,Vallie,19,98,2,75,8,58,260,
d7ddbc7e-13d9-43b9-be52-3d59af513de7,Vallorie,15,86,69,97,18,30,315,
049c6121-91e7-4e84-be5a-053d78b085a9,Valon,80,11,95,59,83,0,328,
fcce9f4b-d5c1-475f-9392-841c9d219526,Valorie,1,3,97,44,21,9,175,
56960b0d-de83-480f-896a-110edf1bff6b,Valrie,23,18,18,84,40,79,262,
89ed8d0a-2182-4954-b05c-7f8a59a7c62c,Valton,78,88,40,22,18,49,295,
99dde5a4-9a10-4714-b183-de8343076fb7,Van,61,6,96,99,51,32,345,
4b647dc6-b4e6-4c8c-b751-ab94717fba21,Vance,93,92,95,62,7,51,400,
e6cb21e9-7118-43ff-a482-c554937a949b,Vander,10,94,24,46,13,90,277,
ee61c898-06fe-4130-8817-a5a782534b23,Vanecia,51,10,41,28,28,57,215,
16dc55a9-ff38-4bc2-9702-bdcdd4165c9f,Vanella,83,40,16,75,11,98,323,
13b64e09-07aa-44ca-8343-a35740a4bceb,Vanesha,1,25,12,59,79,0,176,
c9e71980-b531-46db-b6cf-388c7a9d676e,Vanessamarie,48,89,37,29,75,41,319,
d852dd0b-2196-4d15-b722-2a30c9a99d93,Vanessia,100,78,66,41,2,52,339,
d4da568b-6a0e-40f7-bf16-9a1f081c6a7c,Vanetta,93,45,19,35,56,20,268,
09d9a299-3107-4b76-b180-f955b8825b12,Vania,51,11,44,87,0,82,275,
fba0c36f-68c4-4c68-9d44-ff848551e03a,Vanity,51,69,93,59,13,10,295,
e93bc049-1b35-4973-b753-6044ac807caa,Vannak,51,48,20,48,46,38,251,
51c40acb-ef53-41f1-8177-3caa43f90c29,Vannia,44,59,9,67,83,57,319,
2160427e-660b-4e51-937d-335f082e0884,Vansh,68,28,19,5,89,84,293,
0955ed8e-a408-46d4-8b64-dc4a3cc70015,Vanteen,10,51,20,61,6,10,158,
2cf69a2b-d5db-4091-89cf-0c05fbdc2d23,Vara,88,54,2,81,3,71,299,
d4a63c18-1fce-40c8-8443-5d9daa3df1ff,Vara,52,74,91,89,15,33,354,
eba62942-c506-4c64-971c-87698ac56945,Vara,26,55,71,26,30,64,272,
0a1b05ab-e266-4505-92e9-e7830888916a,Varnika,80,42,89,22,43,83,359,
9c2bcbf4-87d9-48c8-87d3-48dae6f07851,Varnika,89,74,17,18,70,39,307,
ed1eaf25-58d9-4029-a32b-aed1afba0e77,Vartan,95,52,40,10,18,45,260,
f392150a-ce38-48a9-8f54-a92d894cb9bb,Varun,98,3,3,67,72,91,334,
1168143c-2f5e-4081-83df-6af12a2522cc,Vasiliki,5,80,83,70,98,44,380,
795c3577-05ba-41b5-b6c0-bf028f280523,Vasilios,84,96,20,43,71,71,385,
6f5d5aae-47ca-4155-86a4-b5c40f3198de,Vassie,99,76,12,48,33,13,281,
cbe96a06-67da-4c4d-af94-417d54fe2d1c,Vasthi,36,88,31,42,97,14,308,
201da0b1-2fc5-431d-8c63-0cad568f6386,Vastine,79,47,13,64,1,13,217,
0d1e8a96-0a77-4955-8ec0-f35ea1f1fb51,Vatche,9,93,38,98,32,69,339,
0d2287f9-2439-47f1-be23-12b61e156d2b,Vayda,54,52,33,24,77,54,294,
dabc4b95-34da-4a8e-861f-001a4c7de67a,Vayda,32,60,43,84,3,16,238,
5bae344a-4d44-44ae-9283-baa2b2d255cd,Vayda,39,46,37,12,80,50,264,
2bd1fba2-8c83-44b0-9ced-865a744960be,Veachel,99,17,59,92,94,43,404,
b8f0b401-d237-4831-bd3e-61078c12078c,Veachel,4,22,10,17,21,73,147,
7693a239-6598-4f76-ba00-9a10e6aca478,Vedant,51,34,93,16,31,27,252,
a618cb52-c235-4d49-815b-10aa51712f45,Vedanth,19,88,39,89,53,18,306,
413b0fea-639d-4efe-a7d8-3834894179de,Vedika,10,52,58,17,82,97,316,
732d8cf8-d9ce-4488-ad87-99d36467eb42,Vedika,11,37,20,98,35,31,232,
1c414b3a-ad1a-4bf5-a766-a7b88882ed8a,Vela,82,58,91,12,38,8,289,
21fc6ec1-5a80-4be9-bdd4-661829e8ed2f,Velda,82,81,89,84,55,89,480,
16c240d2-0604-4f8f-b948-1ed63ae7f758,Velia,61,72,88,22,28,65,336,
4f9e4c9a-e167-4731-ae39-d681364cd579,Velinda,40,94,12,85,75,39,345,
01500bb8-7c55-46ae-a532-c9a512f183e9,Vella,56,96,89,94,36,22,393,
8dd78cb0-f9d0-4bc3-940f-35111cf417b7,Velvie,70,42,42,96,8,24,282,
0a74de9d-86cb-47c6-9d64-8940df7288cd,Vena,97,97,33,26,40,94,387,
91fef8db-7036-44d3-bb9e-8eaff124397d,Venancio,56,16,71,88,85,14,330,
d87d2f0a-8763-4ff1-9222-5c4d5b1a6b64,Venicia,38,25,46,10,3,48,170,
f323f5e7-29ad-4487-897c-2471f180bc9c,Venicia,78,60,45,26,28,16,253,
efdb5f84-9458-406c-866d-5d7c9eac4ac5,Venise,53,47,96,83,13,63,355,
75875351-b93f-42f4-bcf3-9b4fca0416d4,Venise,69,84,14,83,30,46,326,
dd9593e9-7ec6-4f7a-b1ed-bea8ab54fa1e,Vennie,31,40,82,63,50,32,298,
1cef7fd7-aceb-427b-96e2-5b7a3448e06e,Ventura,47,67,91,4,77,27,313,
80c357cb-3b1f-4384-a626-f2f6575dbb25,Verania,18,81,28,82,16,25,250,
2f809d56-4e2d-4867-ba35-317cad84aa00,Verda,77,43,74,38,83,89,404,
c7b4e271-58b9-4cec-a6b5-75c77f4751a1,Verda,86,32,10,72,31,64,295,
5a4134b0-97b2-4d29-98eb-bfeea4cd92ef,Vergia,42,83,10,6,26,9,176,
a14f7d67-1593-455d-a895-4380de8d3db9,Vergie,64,57,75,90,14,12,312,
4d17b628-ed0a-4fcf-9356-7379cc395042,Veridiana,60,85,92,25,92,27,381,
048574e7-7941-439a-813d-0ae92b27890f,Verl,38,34,29,65,81,10,257,
71d304d5-b386-4e70-9a1a-0fa5e7303153,Verlyn,48,89,35,74,63,60,369,
1caa5800-1323-489d-bb83-76f727486d1c,Vern,40,63,3,47,91,4,248,
12dfcd8a-ee78-4b72-b5a8-08c673fdbe1d,Vernessa,9,22,98,22,68,3,222,
c9957d87-bcbe-4bd9-9385-4cb0c600b443,Vernessa,68,40,61,47,37,90,343,
4ebc1e33-80a8-4fc5-b5a5-9942dc2229b7,Vernita,94,59,16,0,83,40,292,
76afa20c-bec8-4d52-aab8-96816a0e7bb7,Veronica,55,77,47,99,14,50,342,
bd8f0ae9-af7e-4616-9006-04fec07d0a1d,Veronique,56,24,39,65,71,28,283,
e9ae4da5-e602-4ae3-b87b-a0118a697472,Veronique,17,57,31,88,91,72,356,
a9f18a49-871b-49c8-be63-11daa58d32e0,Versa,43,88,51,33,14,6,235,
309288ee-c091-414d-a7b3-b98967563335,Verta,99,32,35,11,62,87,326,
1b35ca84-4276-43b8-87ca-4154df2a1e16,Vertie,66,37,90,7,12,86,298,
e5cc1ee3-603f-49c2-9f47-3673af5c7a9f,Vertis,42,67,59,59,83,79,389,
ffe475cc-65a2-4989-bcb6-850b0be036a3,Vesta,33,33,23,22,18,21,150,
215431b5-33d1-4670-a6cf-79eaab9d82b9,Vester,11,33,48,21,69,30,212,
f490c85a-6116-4ceb-9b73-d35283ecf735,Veyda,16,4,17,87,83,34,241,
8f088c3d-b89d-4bb2-963b-aea3cbb3e8dc,Vianca,78,5,3,81,54,0,221,
59c4f8f2-665a-4452-8710-f3c5f42565b2,Vianna,79,76,70,88,99,47,459,
5d579e68-2329-4a9e-bbb3-fe1998d4b598,Vicie,14,29,40,39,83,24,229,
10c8de75-ccec-4497-bc9c-4b2ee425fc4d,Vick,69,56,69,35,91,59,379,
05a53a7a-bee4-4646-aeaa-a41a5e14f217,Vicken,41,98,8,8,24,24,203,
f5df2295-4fa5-4212-957c-9dc8d57e57ed,Vicken,42,63,100,5,30,50,290,
c5703654-1fbf-458e-8ae6-6b29ce4e2dfd,Vicktoria,11,27,96,16,62,79,291,
519700c8-51cf-47b1-b813-4f988aaaf58b,Vicky,82,23,3,56,5,49,218,
e78d3b99-ee5e-49bc-ad7c-7cd156e54162,Victoria,58,32,81,15,49,48,283,
6d8269d0-1df7-44a4-a3b9-250726870a85,Victorina,20,54,17,1,14,92,198,
3e4b1dee-5a9b-40dc-bf8b-00d7178ea20b,Victorine,46,98,82,37,41,6,310,
d304b7d7-dbfa-4b70-90ba-5fbb65930528,Victorine,23,49,59,1,5,41,178,
1e148c96-820e-4e74-9299-b8d151641306,Victorino,30,65,92,70,0,34,291,
8e1727de-b288-4de3-993b-8b0ad950366c,Victorino,60,20,91,39,39,28,277,
89577dc8-a9e5-4795-a16a-454ead69878e,Victorio,71,63,53,58,1,82,328,
48425c04-54dd-47b6-853b-ffdf4550082e,Vienna,93,12,81,66,94,24,370,
49920f9f-87bb-48cf-b76b-ad5b47522589,Vieno,50,62,42,41,48,16,259,
676660a5-1034-4da7-92ca-8d8aa635a605,Viet,73,43,3,31,26,46,222,
09e358f4-6c38-49d2-ac99-9a1c96a2ee22,Viet,34,73,96,49,59,62,373,
b07e34f0-6388-4b2b-a431-49791c3c1632,Viki,92,57,27,7,99,64,346,
abe98777-82e2-4b45-bbf7-027ad76e68b3,Vikki,60,52,21,65,22,87,307,
7b284173-8505-400f-b75e-2a9b3caf7d71,Viliami,79,83,6,93,63,54,378,
71df975e-2ce0-4c05-967a-f6d61ce59e91,Vilma,56,38,25,59,24,64,266,
90c79da0-a95f-4e89-85f2-0f3ce747f166,Vincenta,46,93,9,72,3,44,267,
369a8a5c-525b-42b6-b09d-2844d9f72c97,Vincenza,43,6,99,61,94,20,323,
b5abfeb6-a0e8-485c-b652-a97da2280b4b,Vincie,29,45,27,32,4,34,171,
d85a2648-2ddb-485e-b225-5c03dcbb835e,Vinicio,93,66,96,39,64,10,368,
c1cbcf5d-02d4-455f-81b5-d3228d95fde1,Vinita,61,44,12,41,80,39,277,
63388c43-5c3e-42c9-b5c4-84056f2be44e,Vir,52,22,55,20,5,65,219,
c5c97ab5-0fdf-40a5-90e3-bae5bd1bfb2c,Virdiana,13,80,31,70,6,100,300,
b3e6f4ab-5316-494c-a92b-14b064ae5d2d,Virge,47,53,91,44,15,41,291,
e95dc7e2-ef8c-4e68-a22c-591497275808,Virgen,50,2,7,55,97,52,263,
8a81bbb0-e4f2-4385-9fb7-4738bc076b37,Virgina,45,85,12,45,75,93,355,
f53aac6f-9b6f-45e5-9833-63f639b0c80a,Virgle,44,84,0,98,30,94,350,
0767cb41-8472-4b68-af3a-de31a476a47c,Viridiana,74,92,86,26,49,9,336,
73b9ab61-7857-4d55-935e-f6a1867f2bc2,Virlee,56,62,60,21,13,7,219,
acc7bb31-6d2c-4d30-8182-aeb199ceaf50,Virna,0,16,29,85,27,72,229,
35919e28-cd65-40e5-ba0b-b442b04dba1d,Virna,71,47,64,86,79,98,445,
5ed122a9-9a65-4387-a3d5-21195604cf06,Vishal,92,26,5,7,84,79,293,
c0360a97-92a5-47d2-b6e3-6eeeb88b44d5,Vitaliy,38,82,14,44,87,16,281,
7c59d47f-183b-48e7-9eb7-889ff49530b2,Vivia,86,46,26,55,1,96,310,
a5350bef-4cde-49f3-863b-08dbf94ee66a,Viviana,40,99,34,62,87,49,371,
3dee31b6-317b-439c-b314-2b5458d69f34,Viviano,89,79,32,67,19,94,380,
41d17839-7d22-4473-a364-a95f6727bc41,Vivien,9,83,12,20,44,38,206,
e805fff3-49af-4993-8b95-d71877a4e13d,Vivienne,74,73,5,24,34,69,279,
a742d681-2ba7-4040-94ec-ffd74087a30d,Vladimir,65,15,10,11,59,1,161,
573503db-45c4-41b4-96dd-a933515c13ad,Vola,49,58,3,61,97,93,361,
b075dbdf-691b-4e49-a10a-3d4be5a4d731,Volvi,99,29,94,31,46,14,313,
73696699-66b7-4fe3-8682-c54c685855cc,Volvi,59,84,8,43,91,38,323,
1fed8544-4292-4dff-9966-6620960064f3,Vonciel,26,13,11,57,64,47,218,
23fb5952-14cc-4b4a-b745-19b1c0235eb0,Voncille,65,58,9,53,45,1,231,
cde08b81-d271-417a-b351-c80632de06d5,Vonetta,61,25,50,4,59,24,223,
10bf9380-9cc7-4d1f-89c4-38f84b2f4e5b,Vontressa,71,98,22,64,80,65,400,
f1c8d10f-cce1-461b-9304-e31e185540ff,Vung,4,59,94,50,4,2,213,
7a679d95-6a52-49de-b53b-60d0340015c0,Vy,10,89,42,71,41,34,287,
21514d22-eb13-4807-aee7-4d93d6d4c49b,Wachovia,52,73,73,17,27,46,288,
8ca1fd8e-a1b2-4b3b-9c28-376d32a69c44,Waddell,18,46,26,24,66,24,204,
be1182a3-c7ce-4a1d-956d-af5dd0e340e4,Wade,39,57,29,28,22,11,186,
7c0f4194-a14e-4e4d-96ba-778870bbab50,Waldene,78,45,78,67,83,89,440,
d6f06558-7110-4034-af53-3a498dabb223,Walid,52,56,37,100,1,27,273,
8f9c5d30-93cb-4b9b-b6d6-6b94920a5538,Wallace,22,47,54,52,43,2,220,
94d5257b-cce4-4d97-b7c4-8405c4a555ec,Waller,71,19,32,3,23,51,199,
8c5a767d-05eb-4975-b2bd-bfafd2c71b4d,Walsie,47,12,25,77,11,22,194,
563a4523-805b-43a2-a59a-451943c83cc6,Walsie,94,72,28,36,84,85,399,
7c34a745-8163-4e6d-ae8e-2115f24e61a1,Waltina,1,53,50,4,79,41,228,
05940efc-1732-432a-bc0d-644f120f2f39,Wandalee,97,33,43,9,45,18,245,
6a59b822-e871-4b8f-8eb4-4897b620c59b,Waneda,29,82,39,60,72,66,348,
f7c7e005-7817-4ed5-8593-4093bb969395,Wanita,10,0,71,36,61,45,223,
752d9b69-1a8e-4355-98ed-7af1d0993667,Wanna,52,59,16,67,18,28,240,
2bfa42b3-2da7-45f4-8b42-0f1c5b547e43,Wannetta,15,83,99,16,22,43,278,
89c2847b-d494-4803-a1ad-383191286353,Waqas,83,31,95,72,32,58,371,
f8b39b4a-211a-4d1e-a2eb-3e3ef5af50e8,Ward,53,80,76,77,15,98,399,
553c0899-ff66-4040-9d7a-ad0cfac2569d,Wardell,79,56,94,10,16,37,292,
3c2fe0b3-1b12-4919-930c-23b5ebd27b47,Warner,89,20,14,98,18,54,293,
cc02c7ad-68a7-4aa0-bfc9-b3abd35b905e,Warnie,40,65,35,53,35,9,237,
d8278900-3f96-40c3-900a-0ab81597a0d8,Waseem,95,0,75,50,38,96,354,
18965c16-4f7e-47de-bc74-9c1068ddf8d1,Waseem,15,37,54,3,99,27,235,
ab7773da-ba0a-4263-8700-f9ed329d494f,Wassil,22,87,3,41,14,64,231,
1306d188-06b3-46d7-a796-151c77eeb2fd,Wassil,47,19,14,44,64,17,205,
581bc510-b08a-42ab-8f95-da7af3f79dcc,Wassillie,15,44,27,50,18,54,208,
0de575cf-50be-43c0-a207-249235a65daf,Watie,52,100,83,35,80,37,387,
b0568003-5c23-406c-bff2-93d052bda518,Wava,6,12,14,41,6,46,125,
7858d733-f34a-447e-af5d-488532478f0c,Waveline,44,35,84,55,63,26,307,
4d07041f-ec14-45c2-b248-0b97e8db9eaa,Waverly,17,63,36,96,89,37,338,
d9a6bd65-e015-417d-891a-bb007ef6d6b3,Wavy,92,46,64,10,85,54,351,
be947231-319d-4edd-992f-6441344d6222,Wayde,3,72,31,46,91,0,243,
6450b41e-9768-4bb1-a6e6-9689939ceb0d,Waylan,13,26,32,23,11,0,105,
856bb853-e614-4c9a-a126-ba2954dd3717,Waylan,12,42,75,31,22,22,204,
bbfc7b8f-7807-4408-a2c4-1cd2556c43e9,Waylon,85,36,58,63,20,85,347,
fbfa1bf9-055e-4dd9-809d-b315f5e953f8,Waynette,52,37,85,64,25,74,337,
53f1906c-4fac-4295-b6f9-a980a54bab71,Webb,47,70,46,41,43,22,269,
f3e6ec1a-4e86-42dd-8ca8-0f9f38a8be75,Wellington,89,100,77,24,79,77,446,
851a0a8a-4488-4ef5-85fe-7d6037486533,Wells,82,49,25,82,84,26,348,
8e58839a-cec7-42b4-bbf5-590bf9582b20,Welton,27,45,38,86,52,52,300,
38467ba8-d6f5-4773-a0f8-ebe8b0b66b60,Wende,49,77,8,84,95,17,330,
291bcf94-257e-4faf-8159-57c55363650c,Wendel,82,3,98,93,50,39,365,
75f61b84-4eec-494a-b97b-6b3ff466c3d3,Wendelin,66,52,49,1,41,43,252,
31045a5e-bcea-4d31-ac16-f1572688a656,Werner,65,44,22,78,21,80,310,
5aa773e8-419b-4fc8-9cc5-a2213981bde1,Weronika,11,83,42,73,97,4,310,
e59408e2-948a-4ae1-8699-5e2ecf0506b5,Wesson,7,72,37,62,34,66,278,
30d0a9b6-2db9-4863-9deb-1a5834ce165f,Wesson,29,63,97,16,70,87,362,
b4b7352d-f7a2-45f1-b68c-c88265f8ba0e,Wesson,0,77,64,87,8,12,248,
ba3ce497-5b17-439e-b0b6-a03b1f585187,Westen,65,32,47,36,64,99,343,
a8c41440-337b-4f4a-b4d6-47e093225c23,Westly,87,55,34,79,41,28,324,
0563c6b2-0c92-4c02-bb4a-7495ecb0a1a4,Whisper,60,93,87,97,22,45,404,
948168bd-8205-4d7a-a695-06299d145f38,Whitlee,32,51,44,12,86,76,301,
5170135f-42d8-460e-92e5-c29dde64d920,Whitley,72,80,50,49,93,44,388,
0d26eff5-dd5d-481f-acb0-32d0ce3ad02b,Whitney,8,64,8,78,34,77,269,
9509d41d-2b55-46a9-bf07-d4de6d4ce366,Whitney,28,40,8,30,55,55,216,
4e418ca6-5d49-4fc1-9961-15e50b4d9732,Wicahpi,68,87,68,0,37,78,338,
c79bccff-bc83-4e4f-89e0-dd097dcf763f,Wilbern,35,76,4,24,18,76,233,
bc3a8579-f30c-4dc1-9bb8-34ca83c512ba,Wiley,17,14,99,27,96,84,337,
af90eec8-e8bb-449b-a4af-4f56eb466970,Wilhemena,9,9,79,46,49,24,216,
8ff249e2-299f-40d4-be9a-fe57523f53ba,Wilhemina,49,61,63,8,40,19,240,
b6f2c758-029b-4a16-a4fa-766964248968,Wilkins,13,27,13,11,47,60,171,
44d59161-4a8b-4f52-8163-d9a37f9e18c6,Willa,57,68,19,71,73,13,301,
13efa3db-7062-430e-b309-f34184f9aea3,Willadean,36,56,48,4,27,25,196,
19898411-bd15-47bd-976a-56bd92ef4953,Willadean,95,51,86,96,11,14,353,
8aee6236-d4b4-471c-b77b-d1015ba0dc3e,Willadeen,16,85,14,4,39,22,180,
d5e135ed-a372-46f0-8ae5-cd01d5bba5f8,Willard,88,56,100,4,67,88,403,
52da8e35-394f-4588-8dfd-97150368e04c,Williard,42,1,83,15,30,68,239,
c8c142b5-51f4-414d-b92f-894188a06129,Williard,90,96,90,23,12,66,377,
1f412535-6dcf-44f1-9f28-6dec5e2e56b8,Williard,53,44,50,85,7,78,317,
4df6f81f-951d-44a2-83b4-c920e61580aa,Willis,82,100,64,5,32,50,333,
90d00115-5b36-4547-8c47-a8d31d6031a7,Willye,28,97,6,37,79,93,340,
b3ef879d-273f-4a8a-8294-49a6dfbe025e,Wilmajean,6,79,85,73,5,49,297,
cbcce3bf-6719-4b4c-93e7-38302cb60fe5,Wilmon,68,77,20,34,65,35,299,
9d1868af-cc87-46e0-97b4-2aaa012d6e65,Wilnelia,71,63,77,58,60,48,377,
8aba61fa-0099-438a-a8de-29f4320eb601,Wilodean,67,99,6,4,0,5,181,
a32eead7-d84d-42ef-87eb-daae62f18f81,Windie,40,33,91,10,54,5,233,
3245362a-e755-44af-8a06-a056605ecb02,Windle,23,60,90,25,44,9,251,
b2fdfbe5-afb7-4bfc-a2c2-b270157c1310,Winfred,100,43,18,36,27,18,242,
2221b6ec-979b-4e50-9bd5-4ca552b5fc5d,Winna,7,25,66,98,32,26,254,
1cf5f681-2048-45a5-8276-a8e128401427,Winna,54,91,49,0,33,41,268,
7fb85666-8e2e-4299-8dbb-e7f340aa57f8,Winnifred,48,36,47,81,93,88,393,
f3d9e2e5-7bf0-490a-9b5d-b62eef21f33a,Winnifred,7,6,30,50,81,25,199,
71694fb8-6e1b-4bcf-9e01-f8e23632d881,Winona,21,44,71,87,4,77,304,
2e5cece5-874d-455c-b3f0-2ed33316faa6,Winter,69,59,15,93,73,8,317,
642536d4-284d-443c-9cee-beb07fb0b697,Wister,1,16,94,18,19,72,220,
b933b2e1-857d-4752-bcf8-efab37ab994f,Witney,75,75,95,75,11,44,375,
2f3c40d6-3642-4f11-a19f-c063046bb016,Witten,90,64,26,37,36,89,342,
989eb918-ae86-4b6e-9a36-abf13cfb9364,Wm,81,50,31,22,72,75,331,
cb781fef-7c83-418d-ae1b-8fb4c66c65fa,Wofford,13,34,19,68,68,32,234,
451b77f8-b901-43a6-8364-411744952e1a,Wonda,60,55,68,54,10,57,304,
ae47153d-e14e-4601-a17d-072d0cc09a0b,Woodruff,32,85,98,77,42,80,414,
c526cf75-7de7-4f03-bcff-234a2800971b,Woodruff,57,39,2,87,34,71,290,
e689cff0-d010-46f5-a344-6119d6e2e46a,Woody,63,98,5,73,68,92,399,
6a4f7b96-0313-4010-a0ea-d7c9e50a9a4f,Woody,47,35,80,15,88,7,272,
d4399a6c-96f9-4958-805a-0f541406460a,Worthy,61,29,21,81,48,40,280,
fc53defd-7e94-4b1d-bcc1-0d78ea7f8726,Wren,27,61,8,75,22,90,283,
14b344f6-03a3-417d-816d-aae4775d669d,Wright,91,25,42,99,48,83,388,
8f7aaeab-0c86-40a1-8931-7b152aa7cd8b,Wydell,78,0,89,14,12,39,232,
e1632631-8c75-4629-9b9f-e5974949c182,Wylder,70,31,99,2,2,99,303,
f5a2f58a-b9fd-4f04-9d3d-ff923964a471,Wylean,39,81,34,54,39,63,310,
eeb05369-4662-4ed8-b7a0-335116c676ce,Wynelle,55,76,27,17,12,96,283,
690d188d-ad49-4189-b22c-91f684b87d67,Wynston,68,35,60,28,44,95,330,
21e77229-17bb-4e9b-bbc4-932922ce4bf7,Wynter,28,54,47,92,83,84,388,
6483a314-f370-4053-be8f-9d33162410fd,Wynton,2,84,91,7,1,98,283,
e4679c5a-6aef-46ef-bf57-112653d583c8,Wyolene,49,96,22,4,58,33,262,
29518608-d8b5-41d3-a5d3-e0d166d8c070,Wyoma,68,73,50,54,24,83,352,
241aaae2-4cd0-4224-8447-34a65c340ec3,Xandra,81,10,87,76,40,24,318,
61b0defd-29df-4948-b73e-65aa88f0fb59,Xao,64,42,26,99,73,93,397,
5c465bd3-6b6f-4c8a-bc3d-fa10cf6789ef,Xaria,67,57,26,13,2,29,194,
aab73bab-473b-4b92-91b0-1a148df6895f,Xavia,36,31,56,52,66,80,321,
c58aa9f5-360a-408e-aafa-02e366d1ef1c,Xavion,56,57,61,96,8,27,305,
5d5e8949-1312-4b5c-a57e-71130a3a0e34,Xavior,6,59,82,22,79,78,326,
06b3d386-bd27-4990-bc6e-95539eb33c28,Xayla,85,31,43,27,1,75,262,
6fa849a7-79e3-4308-baeb-f3449226c308,Xianna,13,18,5,74,94,58,262,
f95abd7a-eb07-416b-8936-a2071524381e,Ximena,93,82,42,45,80,10,352,
48260f50-85d7-4a38-ab9d-dd53b1aa4b32,Xin,25,26,58,65,36,68,278,
00b6ded5-e404-46b8-ab50-5834fdf1be94,Xitlaly,65,60,45,87,6,82,345,
b6a1218f-7bd0-4733-82c4-8e00067cfa99,Xitllali,60,33,12,49,45,16,215,
d90bcaa8-92ee-430c-9893-3453bb7b4f3e,Xochilt,51,87,35,12,43,8,236,
c68f795c-44f8-430c-b2ee-141e6e47aa66,Xotchil,37,52,1,67,36,23,216,
1d895e92-4191-440a-8da9-43cc5755f9f4,Xylina,86,48,59,58,18,29,298,
f8cb5f03-9103-422f-8476-80fa84976165,Yaa,76,48,33,49,83,0,289,
c426c20b-28e3-4a16-89e7-e4a47cfdb2a6,Yaakov,64,39,43,22,61,86,315,
083303e7-570f-4ec8-bc4f-c520161f5a19,Yaaseen,60,93,24,1,96,49,323,
4c684a19-3d1f-4a3f-bbc6-a7141de14d08,Yachet,29,18,77,70,69,37,300,
4d2ee4f9-1176-4e41-82b3-b53b910fb78d,Yachiyo,11,86,14,71,63,82,327,
30710201-2e78-403e-80ac-8b633fba3b8f,Yadier,24,43,90,7,69,34,267,
6f3b91f6-afcb-4c3a-8c36-aefe2f1e2875,Yadira,93,37,75,19,53,71,348,
51b38903-08c0-453a-8900-1f61cbe3c8d9,Yadriel,31,11,87,82,44,92,347,
5ad3a8db-516e-457a-8676-9d0b884df3e7,Yael,99,73,84,18,92,82,448,
9a194a4e-28a6-47a3-a66e-4a8cb42bb744,Yagmur,37,13,71,58,89,8,276,
39fd3aa5-7c84-4d9c-aa47-92914964a7f5,Yagmur,82,11,26,88,52,39,298,
a76fff02-fdab-45f8-81b3-5436423c1f3a,Yahaira,40,49,80,88,26,53,336,
b5f7c6d6-5d59-4ed8-abd3-43e8a2102478,Yahaira,14,4,88,47,92,30,275,
fc6aee78-e9f2-4c45-9267-858264dc69fa,Yailyn,48,13,44,62,56,73,296,
b899fc43-160e-4659-969e-c3fbdefb6064,Yaindhi,56,30,25,92,56,35,294,
2a947d11-193e-4bf1-b31d-0582a7823516,Yaindhi,53,74,22,7,24,5,185,
beed1693-607c-44d2-aac1-fc42cdc85f00,Yaindhi,10,27,45,0,58,96,236,
fa089566-9bb2-4763-bb51-bc02148b049a,Yakelin,54,72,72,18,60,5,281,
0a608a5d-a6db-4539-95f8-a0b88885d80e,Yakeline,28,87,60,57,54,51,337,
5ed8f49c-cb2d-4487-8bd6-2ab9617ed82c,Yakeline,98,73,34,91,17,71,384,
f14ab5bc-c4a9-4dee-bcad-03625822b2ec,Yale,71,59,8,84,37,23,282,
dec85290-b027-43c9-ba0f-ddb4a69644f6,Yalissa,32,70,42,39,57,91,331,
a4e2fd52-bf08-4d53-b682-57d635946b24,Yamaris,85,94,17,85,30,61,372,
3646855c-ae0f-4deb-b3c9-66aec69f6254,Yamila,73,39,97,61,50,41,361,
b954806c-ee87-4b34-8bed-2075a41ad181,Yamiles,4,74,69,51,89,82,369,
8f8522ab-c33f-45ff-a0d6-6d9b8d7f9539,Yamilet,93,66,28,82,77,93,439,
3580501e-c1da-445a-80f6-e4380b23f614,Yamileth,85,47,68,80,77,77,434,
93651b03-aca1-4625-979a-9571d0f299e0,Yamilex,45,20,28,28,4,61,186,
3a8b44ce-d157-4860-aa42-eb829e6d2a87,Yamilex,21,10,28,82,65,97,303,
17c521e4-79fc-45d3-9122-2f8d1e6fa1f7,Yana,0,48,18,9,100,94,269,
dd736186-a324-4f16-95bf-2268580e8a52,Yaneli,45,3,75,27,8,72,230,
85ba4b12-e028-43b9-8632-4ee529dcea87,Yanelys,31,50,28,20,41,26,196,
b7e3ef6a-25a6-4b02-8033-d0bb944a38c5,Yanil,100,45,72,29,43,25,314,
45ce60dd-f389-4c68-bdc6-878b2944b499,Yanilen,2,71,37,89,50,78,327,
6fcf9f49-fd75-4021-8e0f-91fe1fd2845e,Yanin,55,28,73,54,52,21,283,
4a2c0f5c-a54f-4522-b031-357d9defc2db,Yanina,96,42,77,72,44,45,376,
89f4f207-2d06-48e8-806f-6f8e24068609,Yanitza,25,54,94,61,34,80,348,
573a1cc1-86c7-47a1-9885-ba759dedd103,Yanky,98,87,87,8,71,4,355,
406737ae-766a-429a-b744-288da3bf4a2a,Yann,49,73,54,95,20,34,325,
c5292955-81b9-4984-bb9e-a92e60a5d0d4,Yannet,49,86,16,95,16,74,336,
a37350db-d837-4bdb-ab0f-04186469b919,Yannick,19,47,97,79,24,64,330,
e283532b-d9d9-4144-b08e-333fd5ef730c,Yaquelin,60,80,35,77,2,87,341,
a2d0243a-c606-4ee7-9e45-5f1e4d2d97bd,Yaquelin,69,72,53,71,65,46,376,
98eeb284-167d-4d19-b2a9-af60871dc5ed,Yara,59,56,4,96,38,79,332,
bc8f7adb-cc58-44a7-924b-95a0db351073,Yareli,65,37,65,75,45,37,324,
10761d9b-f07a-4b0b-a931-049f2dea7f02,Yarelin,92,77,14,30,19,22,254,
03357b26-cde4-4a34-a2a4-5a422b7f5d87,Yarelin,60,54,51,94,30,59,348,
54f3e0ea-e89b-4f2b-b233-b0ece19e5dba,Yarelli,95,55,7,3,7,80,247,
cafa55d9-685b-46a5-bcbf-ce0086f5e6ba,Yarelli,81,79,84,88,96,11,439,
1cabff40-d1d3-452d-8d42-f3140444cd8f,Yarely,81,90,32,54,5,75,337,
1de47e08-b1f4-47f0-af47-4363aa6c67fb,Yareni,12,99,68,80,51,63,373,
8d3232b9-4cc8-4418-995f-a4382f0d0f4f,Yaretsi,80,99,49,36,23,40,327,
2dc022ac-b7dd-4a2f-8e43-afa6e189d38d,Yaretzie,66,3,25,65,100,50,309,
d58c45e4-79f6-4cc5-95bc-5286e9d68669,Yari,69,74,71,49,31,55,349,
36687452-93a8-4e8b-8923-08238efee001,Yariana,25,68,51,2,63,34,243,
9bacd98e-8778-4f69-b2f7-4fa6c365ddd0,Yarielis,30,15,92,3,51,92,283,
323d3b53-046f-4c86-9479-f672bb5e8a60,Yarima,38,21,32,88,3,91,273,
4676420b-54b3-494f-aca6-524ba69250b6,Yaris,89,56,41,64,70,34,354,
428a3b94-fd31-4816-91c9-a03b70e1e4a2,Yarithza,6,16,67,52,59,34,234,
eba96f9c-58b7-4c73-a530-05289d47e8b3,Yaritzi,87,73,16,12,73,41,302,
609e3173-bb0e-4b34-9c29-60550b8709c9,Yarixa,64,31,7,40,6,57,205,
22e13272-5194-49ff-a5b8-49779b48e273,Yarixa,99,58,21,91,5,64,338,
f8ff8bfe-97d2-4edd-a91b-e5089c364d0b,Yaro,56,25,24,16,84,55,260,
584ec70d-859c-4dc9-a9dd-f9ddcb8258ef,Yaroslav,11,47,99,57,4,52,270,
5f6532d8-3def-4ad5-99a8-b9e4243ee5e8,Yasaman,15,45,13,36,63,21,193,
0bccc85d-f2c9-469c-9022-00c5077c9d0b,Yaseen,59,74,33,58,79,10,313,
2cca6e46-c1cb-4437-97ab-00570d0109d3,Yash,75,40,15,53,20,75,278,
c61d021f-0a55-4626-8649-c50565077e3f,Yash,36,92,92,92,0,90,402,
5df3f024-d951-4231-8104-89500e641531,Yasheka,73,49,14,2,44,60,242,
48241366-957c-4e5b-bcd9-37d97acf2a00,Yashika,15,29,32,87,5,10,178,
e54fb2eb-d745-4b12-b20a-5203ddde2807,Yashira,17,71,45,89,4,15,241,
94ca2b6c-10cd-48df-872d-852edbd4e64d,Yasir,89,19,47,13,25,24,217,
9cc46c60-baf8-40ef-b0d4-306f114f15f3,Yasir,28,67,98,77,27,55,352,
95fbcc69-260c-4b44-b4de-54c3ad684c7b,Yasir,83,27,23,47,71,25,276,
d8675089-e604-4b09-89b6-932f860bac89,Yasirah,3,80,15,24,94,14,230,
444b3603-d21d-4c23-af26-e6a0c2a822c7,Yasmen,92,35,6,49,100,33,315,
ae6279bb-2669-4c77-950e-569528456d3a,Yasmen,35,83,70,89,39,97,413,
c3cb5672-d01b-4545-bfaf-692ede4c87c0,Yasser,56,24,11,74,95,21,281,
f2723820-580a-4bab-9e1f-7e66e491b196,Yasser,1,63,20,67,75,69,295,
d87edc62-d191-422e-8149-7801a19e341b,Yassin,11,73,3,90,51,97,325,
447e48d3-54b4-4b5c-9f77-f9e5e48a212a,Yassir,20,22,76,82,62,5,267,
b7aefb71-a0ab-4303-a78f-a4a1a62d3d39,Yatana,69,78,53,8,78,20,306,
93487a46-31da-472a-baa8-c3e401d668be,Yatzil,61,27,19,15,96,50,268,
e00e52df-96ea-402e-88f2-73a2bef3a3ea,Yatziry,59,54,26,44,6,70,259,
f357ce5f-4fc8-4eca-bd7e-c772bacd287a,Yazan,27,27,80,81,40,48,303,
a109bb8a-8f95-47d3-991a-44cc1fe6c220,Yazid,64,57,20,51,91,35,318,
bbba9697-9ed1-4804-a033-c5442ea7e522,Yazmine,29,25,100,24,66,26,270,
f76b346b-e75a-49be-8b9c-2133c2939710,Yazmine,4,74,45,48,30,100,301,
27907c43-a309-45d2-a4e2-3f5bba747864,Yazmyn,25,56,68,90,78,63,380,
40d09136-9e74-48ee-9049-f6814929901d,Yecenia,68,12,51,54,12,5,202,
012ba401-7bad-4ed0-bea4-daee44257a6e,Yecheskel,41,9,65,38,14,48,215,
cc90f60b-f119-4264-b5d5-73f4e9ee7a6f,Yechezkel,65,7,71,52,34,19,248,
0c06afee-825d-474a-836a-b03eecb9447b,Yee,39,96,27,76,62,32,332,
72d2fd1b-b639-48df-9ce9-9ab2300db270,Yeeleng,0,23,18,17,79,96,233,
1211d6b7-9bea-4ef7-87e5-06d29007cfe7,Yehudis,18,28,39,26,55,13,179,
f5b75934-349f-432a-aa16-63a7e879fcf3,Yehudis,82,21,48,3,65,17,236,
0b2c13b9-95a1-4389-9994-264fe5ddd3b0,Yeila,18,34,61,30,94,88,325,
f115530c-94dc-482f-9fd3-fe69d86c729b,Yeila,30,33,73,88,37,5,266,
593e7a1c-399c-4c69-8b41-b666bc95f57a,Yeilin,4,35,39,24,16,56,174,
63011a8a-5938-4180-a00e-01b38a551ba8,Yeilin,60,21,44,13,53,34,225,
ac6aea3a-9662-42a7-b41a-551cbdcf6ce1,Yekusiel,84,25,25,61,27,79,301,
9413dad6-3a4f-4c2c-b8cd-29c27f6f8137,Yelena,21,80,100,32,7,2,242,
733cfb21-6673-45f2-ad6f-8ebdf1eadf2c,Yelena,14,78,57,100,92,33,374,
ea56376b-f072-465c-9390-1b0ab5a3f4e7,Yen,98,48,93,66,5,78,388,
eb979780-0964-4ee4-94af-222f48606d69,Yena,91,22,76,23,10,4,226,
1b3de39f-f221-4ae1-9d1e-a77aaf887780,Yeng,3,56,43,70,64,96,332,
55cf1559-ab3b-4e51-a3bf-c68e60b5a41c,Yeng,28,5,13,87,9,93,235,
8d909b5b-5bfa-415a-ade1-0ec3e7ed833a,Yenna,7,19,84,61,9,31,211,
1220d160-8a65-41c8-93fd-2593a84f1daf,Yenty,3,96,65,45,32,36,277,
bea02b91-8c65-4f9c-a531-5f81fbdc83f0,Yer,95,40,20,33,80,72,340,
acf79b02-c2b2-4d85-bafd-9da8dfdfe796,Yesenia,98,52,52,38,67,41,348,
57118c22-10e3-44ad-a40a-dd7b6fe305fa,Yesika,44,46,42,39,21,32,224,
fe609f22-66bc-4224-95b2-0246d64eea36,Yetta,0,19,43,99,91,40,292,
31a67c7c-e7c6-43b3-8a57-1ed10a763c2a,Yexalen,19,56,55,69,52,38,289,
51b27fb9-4480-4c7f-982e-dcd1e481a88f,Ygnacio,97,35,92,46,34,12,316,
0b05e87c-03de-4205-931a-dd81fef44bc3,Yia,50,47,3,70,80,49,299,
83fc8016-af15-49ba-b047-17fc716925a5,Yiannis,64,7,35,21,0,42,169,
3ef36cb9-d902-4325-91fc-a5760f115e73,Yicel,97,97,70,29,39,60,392,
5ef4a4ad-7e2c-403f-b6d6-7cdba6a30f69,Yicel,55,47,98,2,48,90,340,
7b9cadde-2d4b-4176-9d11-960cd4eea1d4,Yida,92,6,41,15,44,67,265,
aca287b2-e315-4256-9202-4cfd50c27b6b,Yida,8,27,49,68,58,49,259,
e5a3b37a-055c-443d-8add-00a4dc94a0fc,Yides,22,29,90,30,8,98,277,
a6555a35-7e85-4da7-967c-0bd20e810b3e,Yisrael,42,0,68,45,41,1,197,
7bbb9116-4188-4b20-8512-107394a1358c,Yitta,28,76,18,95,26,63,306,
dca7949d-7c38-465c-91b5-35984dec263d,Yitty,72,72,2,99,47,64,356,
9b9f7a01-321d-4cfa-a5bc-e19b61a55c76,Yitzchak,28,15,76,36,44,9,208,
41338170-37a8-4d70-967e-33cb750f3e4d,Yitzchok,60,88,61,98,94,46,447,
3a8147a8-9d5e-41cf-85e3-6cac47b7f543,Yizel,78,71,36,13,79,85,362,
ad560595-34dc-44cb-a3b3-a7bab46865a4,Yizza,97,7,6,60,63,42,275,
6d94b11f-8316-4774-919a-8ccea22ceeb6,Ynez,48,95,36,62,9,58,308,
2870890a-2491-4a19-9196-fc964572f360,Ynez,67,48,26,96,61,22,320,
ac6ec822-a18c-4fa5-a0e5-3169b35fba89,Yo,19,39,63,3,82,2,208,
504f3b51-46a0-4628-9532-4c4594c81282,Yoana,91,11,78,69,18,72,339,
db94b4e2-9ee9-4f55-91f0-0593432777d1,Yocasta,89,21,40,85,6,2,243,
65afe9fe-4884-400a-9686-6c79290bb465,Yochanon,99,80,85,83,51,73,471,
3f60b286-9903-4898-9e5a-a8d2e8fe951e,Yoel,14,28,58,21,14,88,223,
d959951d-1dcc-4e0b-97fd-f0148513386b,Yohann,4,81,90,59,8,36,278,
b35f6da6-a072-43fc-9fad-be939945d2b7,Yokasta,53,11,44,19,6,48,181,
0865e2c6-4cf6-485f-82a3-01bdb5f9949b,Yolanda,17,87,82,61,69,64,380,
89ce17d3-9dae-4291-a34c-211a5b7879b6,Yolander,41,58,80,62,8,84,333,
e106c926-6b64-4e3e-bf19-7046bf4ac841,Yolander,88,73,69,49,83,93,455,
4b8d4c39-efc2-4e75-bd0a-0a32ca8993b6,Yolette,75,18,66,23,35,2,219,
fe1797b2-c4c9-48cf-8082-a639b6717fd0,Yomar,33,84,67,52,76,13,325,
8dee25e2-1cf5-45a3-8e8f-b4f7222dbf77,Yomayra,26,28,79,15,19,41,208,
7c7ad506-bc67-410c-a723-b8fda2681991,Yomayra,63,3,26,58,93,61,304,
82dbe82d-dacd-4898-9c91-a401a1b6a4ce,Yomira,96,51,44,29,37,84,341,
3fae2f3c-19d1-48ce-a1a2-983a0ae6cd67,Yomtov,55,85,22,92,17,73,344,
ad6fafe7-f68d-425b-b542-cedc7fa38344,Yonatan,14,26,72,52,38,11,213,
d0a6077c-fe19-4a51-8d3f-5fa53fe1fb13,Yonathan,0,52,57,72,15,63,259,
a1256a43-f037-49e2-a203-5212294d42cd,Yoni,36,28,18,12,10,99,203,
dce5825a-523c-4aa8-a1dc-db810f6e39fc,Yony,58,96,55,42,41,34,326,
b5cae93a-775d-423c-a5ef-40b50450e4f6,Yony,6,45,24,1,72,99,247,
e5fe4c3c-b2bf-4b77-a74f-01629416d431,Yoseph,50,23,27,39,36,69,244,
544607c4-33b5-4cac-affb-2fe85ba1ae86,Yoseph,8,95,40,80,4,8,235,
bcb40ca5-e402-45b8-9da4-8eaa412391bf,Yoshi,12,25,59,30,22,82,230,
05afb181-4a3d-461d-8e72-5b791b3a3aba,Yoshiaki,86,93,96,39,75,41,430,
c11f96a4-f94e-4294-aa1e-804e48fb3d35,Yoshie,57,43,97,62,81,7,347,
bcec7def-7372-4987-ae4c-e3d8bda84164,Yoshikatsu,99,64,47,15,31,36,292,
95789e00-dc31-4349-8723-853e65970110,Yoshino,57,42,56,95,40,46,336,
680f7d4d-4b5f-4c09-b9a3-14f80b473763,Yosuf,97,49,19,37,69,52,323,
c02628dc-e8ad-47ec-84e6-940042a90f99,Younes,9,53,20,28,20,29,159,
993bfbbd-92b8-4054-8c60-8583370a34a9,Younes,2,67,17,87,70,60,303,
72afb569-c69b-4d5d-9850-ac21014c6396,Yovany,56,66,92,33,93,33,373,
12f053d5-9f55-4d13-b491-cd29d766f2cd,Ysabel,55,43,54,14,1,10,177,
a7b69806-893f-47a4-afba-aa8fee8404ca,Ysenia,24,94,54,46,34,100,352,
2d2c6914-d83b-4ae8-8577-65bd45b4142e,Ytzel,61,37,98,24,73,42,335,
58d35cfa-a38d-435c-bc65-02db6c2b6c8b,Yuda,20,83,18,70,13,29,233,
84659149-d23c-4b65-ab3e-a22935162dd2,Yudelca,47,20,97,84,100,16,364,
6e620bf8-e8d4-433c-b973-524e9500b797,Yudelka,82,73,26,75,39,8,303,
7f130854-3254-45a9-bf84-7a93b710618c,Yue,9,45,17,23,34,40,168,
b61f15c2-cabc-4b9c-9d00-b743ccf85eb7,Yuhan,3,16,88,79,51,8,245,
885521d3-b569-4eaf-942a-73cd423e62b9,Yuhan,78,42,44,57,68,2,291,
dc9aacdc-6045-4db4-8725-86a53e89ebe4,Yukari,21,58,2,46,14,22,163,
8ea9ad06-0e99-4173-af1a-092b660ac820,Yukie,14,3,24,35,79,85,240,
cee02831-10a2-4fa0-bd21-5a0faadd4c88,Yuleidy,52,84,36,87,47,6,312,
19d2c3b3-7bca-442b-aaff-336221b2147f,Yuliana,84,21,10,3,90,18,226,
04487776-0a8e-447b-af74-e01074138b60,Yulianna,70,96,2,81,29,98,376,
1cba89ba-7bf2-48b6-9522-0ccb9d019ce1,Yulie,59,23,12,96,57,65,312,
489b0854-fa3f-4feb-a666-7c25bf0f142c,Yulie,45,10,1,62,62,36,216,
2b20706b-2044-48b1-b1a7-ed909f043e0c,Yulie,54,88,48,80,9,97,376,
a94f603a-1267-406a-8ebd-07b41dc9a260,Yuliya,58,32,80,37,30,30,267,
11a6e5b1-5e3d-4311-b20c-fa9eb47f0e76,Yuliza,81,26,49,100,10,68,334,
2fae7b99-976d-4f8b-bf1e-3fd7138aee78,Yumeka,72,54,63,74,55,28,346,
c2271477-e5c4-41cf-aacd-46dfd4cd447d,Yuna,40,30,56,33,12,5,176,
8ac0512c-4545-453d-b99e-687a2f7ee681,Yunuen,5,37,44,41,46,28,201,
d614c915-72aa-446f-b35e-2a69342acc91,Yurem,67,84,29,47,20,32,279,
635d5e4d-dd46-4daf-9b62-5a4274d98365,Yuren,34,88,55,13,38,65,293,
f5263325-7a38-4a05-bb46-d3a01ffff23f,Yuri,20,43,22,36,88,23,232,
ab77f261-cea5-492a-8f3e-6acf558e77c5,Yuriana,60,2,90,76,73,89,390,
9e30f4de-1b9e-4e6a-9cdf-d795fb4f8ed8,Yuriko,91,77,25,61,26,3,283,
cea8c347-0452-46bf-a836-b4ffde2664e0,Yuritzi,78,31,32,79,25,21,266,
55d5e768-2e16-4818-bf85-1a3d61ebae99,Yuritzy,51,95,94,12,44,44,340,
0a406348-220e-4518-b011-f3ad0cea1f9c,Yusif,32,86,0,4,15,45,182,
2993d7f5-827b-45f4-a83d-9abf7823f810,Yussuf,12,99,17,4,54,44,230,
011dd3f0-2341-44f5-9ee2-725440a7e6a0,Yuto,21,73,50,91,56,73,364,
ae0c192b-e31d-4cdd-bc7b-50ba8e2e1ece,Yuvraj,6,4,88,32,66,52,248,
ccec32b9-d0cf-4d6c-aa2e-3345bf1d406c,Yvanna,87,28,32,62,34,23,266,
72c97cf6-0e25-4e56-b8a7-4d1c6b8a3a64,Yvett,20,39,35,58,29,98,279,
be05d333-797b-4faf-9f89-c9f31a6b0e58,Yvett,67,57,52,59,89,6,330,
55465e5b-8085-469c-8a79-de32ec108665,Yvonna,8,48,32,73,88,79,328,
024518c7-100e-489e-8c5c-0d02c9d61770,Yvonnie,94,84,100,24,46,0,348,
b12a92ae-bb52-43f1-915a-db04843d6d56,Yvonnie,7,31,39,15,37,83,212,
bbef681c-ff5b-4930-b9e9-489c5f8f64d9,Yzabella,54,60,53,37,60,26,290,
dbdc9e9c-8c42-419f-ab93-800f5ae54f69,Zaahir,69,27,38,26,100,2,262,
a0784be4-e4c8-4e4a-b489-ddfd93f35ac2,Zabrina,47,69,11,42,90,63,322,
97f1d8a7-06c2-4f7c-b3b8-0ca445abae01,Zacari,65,37,32,64,48,100,346,
5eb476ba-841a-4b43-a97d-33cd0cd10fd6,Zacari,86,45,11,36,14,4,196,
3a092475-1ae2-4860-959b-f089fe5cd1ae,Zacaria,75,36,73,97,35,3,319,
662f3343-a770-448b-a50b-0ca1fccf59d3,Zacariah,55,64,37,3,80,29,268,
bf147109-64c4-420b-b897-822fde2bda90,Zacarias,65,54,9,47,20,93,288,
89aae3b7-6b1f-4263-b341-ba71e302f973,Zacarias,31,19,93,38,45,12,238,
6782050a-8502-4aae-adb3-8c3af43b6fa1,Zacary,70,88,20,16,52,61,307,
247ab137-8bef-4cca-b82d-9bce9200b793,Zaccheus,36,74,70,59,56,74,369,
c3793cd0-bf64-4c12-97b1-d61254cd7029,Zacharia,23,2,71,92,30,99,317,
8a66b554-d8cf-4a99-b272-511f7018a08f,Zacharie,46,84,9,96,81,73,389,
62cde890-50de-4d93-b517-bf30724bd3c0,Zachary,95,50,20,82,6,86,339,
f4150c55-1eec-44ff-a3b6-16cac831d6b7,Zacheriah,65,8,66,82,31,63,315,
96537066-739c-4f1f-8bef-41717a489ad2,Zack,48,82,6,6,23,82,247,
16cf9b1a-4d0b-4335-85b9-fb25f0a73e30,Zackry,100,93,73,24,90,99,479,
db76b6e2-2b9f-4a3d-aa1e-72038c9db9bc,Zade,74,49,56,20,84,41,324,
956c01bf-cefb-45fd-bde8-33817e1102d4,Zade,17,99,60,37,71,68,352,
d90e49c7-c5f4-422b-a23d-f130755160a9,Zaden,40,87,21,7,28,85,268,
f9e4692c-0a59-4120-8d37-cc3a7e5b897c,Zaden,63,8,84,75,100,56,386,
42b58148-6d9e-4896-a210-1db140767195,Zadie,27,29,68,18,62,11,215,
08daba34-fe3d-4adc-8a33-421e37041934,Zaedyn,91,21,33,48,99,36,328,
e8a1fc9c-74c9-40a5-b042-ecceed1ec110,Zaedyn,8,18,13,93,39,63,234,
a7ff0a31-d1d5-4ac2-a71d-d4d3f01342f2,Zahava,18,34,62,77,82,89,362,
b62a19c4-0943-47c4-b90f-e392fe21c02b,Zahira,5,75,91,41,48,59,319,
6eeb61b0-7db6-4e33-bccc-53ce8f79e9f6,Zahira,87,56,38,40,44,56,321,
aba13278-9240-4ed2-80ae-4d420807030c,Zahirah,7,21,17,84,44,19,192,
e69370de-2343-47fc-b848-7dbb9ec65b46,Zahra,2,31,37,64,12,0,146,
dcbc44ab-d4ff-4021-b94c-a4771ceeb92d,Zahraa,75,74,22,43,37,58,309,
aa5f90c4-91dd-40f7-8487-078137d59099,Zahrah,97,47,93,43,55,1,336,
f55dfb37-8c01-4aa7-951d-00746ba3d8ae,Zaidan,2,69,85,65,28,40,289,
fca64d26-d4c9-4cfe-8b35-bb0b30e24cdf,Zaidee,82,78,85,73,70,7,395,
4a7b3198-03c1-4fe3-af19-cdcbabebc4c9,Zaiden,7,40,73,7,10,61,198,
758ab583-4f3f-470a-b204-a1d18aab2cf7,Zair,93,86,30,41,17,65,332,
c83fb767-a75a-4478-821f-cf94e9b0aaa0,Zak,53,9,64,1,30,81,238,
345b6f60-8fcd-41c5-badb-7d27201bd307,Zakari,71,83,19,20,92,62,347,
eea66a03-088b-4d5c-b94e-22a1917499b3,Zakaria,10,20,96,20,67,92,305,
a1b3388c-88db-490f-b0c0-ea9666d6341d,Zakariah,34,32,33,27,54,49,229,
95456133-93ee-4961-a928-0037f0aeaef5,Zakee,68,83,81,55,27,38,352,
1fee8266-150f-4c8b-beb1-6b62015e6f3e,Zakee,24,53,35,53,76,71,312,
c25f34b8-a7b0-457a-99c4-2dfa3094c78e,Zakee,75,94,90,58,56,98,471,
8eb99d6e-c1f6-450c-b721-19c31482d03d,Zakiya,91,7,82,5,80,41,306,
560d8546-178c-4885-a75c-3b933c6b3571,Zakk,25,37,76,70,5,37,250,
48b9d07f-23a6-44fd-bcf6-9cdec33fa319,Zakkary,33,52,46,92,74,85,382,
ad7bd115-aec4-4967-8ee1-8b8bbe1ddac1,Zaliyah,6,90,88,46,53,29,312,
0d92a530-2da7-4965-a07a-7ec0144df45a,Zalma,48,17,37,50,90,53,295,
33e912c9-83d1-4277-963b-a2343a5a6102,Zamar,71,49,94,53,62,45,374,
1f3f1608-863f-47d0-8f7f-ab9cdb7c3344,Zamaria,37,23,36,93,64,9,262,
1a7720ee-c55c-4a80-8a98-16e5494451be,Zamauri,90,21,69,39,95,46,360,
26349d58-94b6-4561-bf7f-35f9c0867326,Zamauri,56,14,64,22,34,42,232,
4943883c-8315-4e6d-a248-e28d28d0636e,Zamaya,16,57,31,23,61,6,194,
5e8c0b1e-d55c-411a-9b26-5949e72279e9,Zamaya,5,23,28,98,42,42,238,
777d5e5d-87fb-4f95-91f6-9fe8ef07feaf,Zamir,40,89,93,6,96,26,350,
3168ace8-2afd-4aed-ac31-227d3205d56d,Zamuel,55,65,76,46,24,3,269,
69ad2265-e104-403f-bf1d-4b76c5eb35f7,Zamyra,13,52,82,51,37,89,324,
56b617bb-7af1-4d3f-a207-8eb37d741f3a,Zamyria,81,93,57,88,61,6,386,
e6a94c64-6b45-4689-a4f7-bb10a9f34a78,Zanai,95,60,2,88,77,95,417,
575b66cd-0389-47e5-a80c-fc70acc98d2e,Zanai,100,88,5,27,39,21,280,
e68bd002-f816-4429-856d-19b00cac7c53,Zanaya,83,28,16,93,15,95,330,
7660c60c-3f10-4fba-b4cd-2aab1703a617,Zandria,81,40,85,71,15,54,346,
25c17d7f-771d-4fe4-8826-38d58ead4678,Zanetta,98,75,5,76,55,68,377,
a4550c68-bf95-4d00-be28-734d530c0828,Zani,34,3,67,22,2,13,141,
9d2e78f7-f62c-4c0f-8032-1ede2aa5bff1,Zani,71,23,83,92,94,86,449,
d481b67e-0a93-4831-b841-2b0d460916d8,Zaniel,98,48,80,40,23,54,343,
8829f191-7b36-4d8a-a864-38e55fc3e1ed,Zanyah,84,39,35,23,39,86,306,
9aa86deb-f148-4066-b3ab-10d01f69f053,Zarahi,34,49,11,20,6,59,179,
ec356213-d68a-495a-bb62-f86e85b504f0,Zarahi,83,25,86,74,37,93,398,
dbc6f62f-c99a-4077-b113-da310389bfe9,Zarif,28,83,9,23,88,36,267,
a99ed5ee-3dd7-4c93-a29d-8f7a37e4c9c5,Zarina,92,83,30,32,85,96,418,
cd255511-ec70-4acb-b744-7af5b78c7d59,Zariya,6,17,21,10,6,97,157,
bad7ac3b-b733-4933-89de-4af2f66527cb,Zariya,98,64,88,42,13,79,384,
29670107-41ae-4263-8fde-14d4590a678f,Zaryan,69,7,77,99,21,99,372,
4ca6be3d-eb7b-4cc7-ab55-2429aa8729be,Zasha,9,82,14,42,28,80,255,
9d1c0096-291c-4d54-a218-25d3c3db0ef8,Zaveon,57,13,75,87,39,4,275,
92aa4a82-757d-4550-b3cf-12a441287b2a,Zavia,14,13,38,39,52,29,185,
16d87b2b-1f40-4892-a06f-64513015be60,Zayah,60,80,40,84,59,93,416,
2084b043-661f-4fc7-8102-fdf394eaee6e,Zaybree,33,96,42,67,82,77,397,
0d20204b-35f6-455f-b8f6-defa982ee4cc,Zaydan,47,59,61,56,73,59,355,
36b9f6c4-d581-43c2-893a-bcd1778791a2,Zaydan,20,76,32,19,40,78,265,
15f61294-ea4b-4bd9-8e31-4fbb94b35426,Zaydon,16,93,44,73,79,61,366,
76138485-20ca-4b20-af96-c9fba413e5b6,Zaydrian,45,45,76,5,48,63,282,
175eaaa4-7d97-4de8-905b-5830fd4e002e,Zaylee,82,83,62,88,39,27,381,
6c504dd1-56c7-46ee-931f-af9cbcf7d158,Zaylee,50,23,97,63,21,12,266,
4b0e6e75-7d77-4ccb-9c8b-ab3f51b38cf9,Zayli,78,97,100,50,0,5,330,
c13aad96-00e8-4824-aa87-c193516e8b4f,Zaylie,0,84,8,43,9,48,192,
9c9e37b1-8efd-4f89-a4ee-4f652b5b652e,Zaylon,16,88,77,81,39,83,384,
475b88f7-aabc-4cb0-86c4-1e0bcd4677e9,Zayvion,23,84,86,11,65,92,361,
716dca97-e7b6-49b1-a566-53f891119e9e,Zeandre,79,23,50,77,50,37,316,
f5c45d65-2cfb-4e8e-bffd-100a6ea99840,Zeba,0,74,15,76,36,14,215,
2c0cdba9-82b7-4c91-8289-0edff2d2db69,Zeenat,19,100,50,44,35,21,269,
f34bc6d3-2aac-4f68-86e9-1d7912a53136,Zehra,69,60,58,24,10,100,321,
f0aa21ff-45a3-476a-9956-69b1824875bb,Zekhi,13,2,24,84,87,27,237,
0043a617-f67e-4cae-a73f-373d1031df3b,Zell,100,8,2,58,68,50,286,
1290333a-02da-4f9f-8527-e16b8815e49a,Zelpha,46,50,15,39,58,15,223,
69e11a71-d78f-457d-a741-a722d6f199e8,Zenab,90,100,29,47,83,16,365,
e5aca9d1-0e52-4966-ab5c-49e733fddcce,Zendaya,35,1,11,10,55,80,192,
1a426ee1-3b34-4368-9974-ebb47c687122,Zeno,37,48,86,30,11,87,299,
d6ed8dc6-aaf5-4f02-9f0a-ebbbeea8acad,Zenon,61,5,63,62,73,69,333,
d6a57289-54e2-49b1-9b6c-625d8ceb0460,Zenovia,61,95,16,5,76,19,272,
a0254ba1-b7ab-482e-8d3e-91dd758b1846,Zephan,79,39,39,23,32,38,250,
45eff42a-3bfa-4223-bbea-07d385cf3302,Zephyr,0,95,31,20,41,49,236,
de11ffe5-0a81-4b0c-8dcb-7e405cbb6fa4,Zerenity,5,41,86,90,67,12,301,
8e27d348-bb26-4684-af7b-160b7474a85d,Zeth,5,84,1,89,5,76,260,
ce7b99e7-ad5b-43fb-ae14-d58e35c52495,Zettie,37,65,61,53,99,12,327,
24834dfb-a6ec-4de8-bf20-c0ba9512f4b7,Zeus,89,37,53,50,3,73,305,
cd073cdb-d92b-4ee5-9dc5-ebc77759ba01,Zeynep,32,55,97,0,77,97,358,
0c5070ba-3637-454a-999a-cb522cf69c5f,Zharia,44,30,88,52,42,7,263,
722c8be1-09a0-474f-ad93-f843c97c51e6,Zhen,100,69,8,74,67,2,320,
9ede6376-83c7-42ac-9061-3a90a997641a,Zi,57,50,71,55,98,98,429,
9796bc1d-fce7-43be-b1df-071d46fe7608,Zidane,49,12,48,84,41,92,326,
7cb63ea5-f90d-466b-a2ad-4b81ef1742ce,Zigmund,49,88,73,91,83,15,399,
20d94122-1e25-4ae4-b2ef-1ee60ac864e3,Zisel,12,64,14,2,77,49,218,
db61c48b-9fe2-4505-9073-b56435e91457,Zita,62,42,13,73,87,6,283,
8556397a-ab0d-401e-932b-f391fcff66a6,Zitlally,77,28,69,49,82,37,342,
7d711cca-e58f-4224-b44e-3a5496ffc6c3,Ziva,83,18,8,68,34,54,265,
3f26f25c-9253-4c03-8171-de4bc9f33203,Ziyah,37,53,70,46,10,63,279,
41758e62-e98d-4080-9654-a328525e972e,Zlata,53,91,2,38,39,26,249,
05dfebb4-55c2-4ef9-bd4d-5736c639c932,Zoei,94,68,17,70,95,89,433,
af2be65f-3f16-4794-8962-7346d3204403,Zoelle,2,83,94,95,47,7,328,
dbe70671-4bee-4b57-b475-3934b1109854,Zofia,15,33,38,1,82,60,229,
671df160-2383-47db-8cec-76a691f22ff5,Zofia,34,18,97,55,42,15,261,
264bcf7e-e8ca-4453-babb-480454251206,Zoha,9,10,37,83,87,20,246,
c79bf235-9eb9-41a8-ad09-d2467059b5f1,Zohar,64,9,2,36,4,1,116,
e58eb0a9-70d5-479d-a56a-6d353dc78ff7,Zola,74,55,76,75,83,73,436,
76c00bdb-6aa2-49b8-94a7-73113907cc7c,Zola,11,84,66,73,99,81,414,
598ace8e-fcd9-4797-a16f-ed0d11481e1b,Zollie,72,67,7,18,4,82,250,
b128c644-bea0-4f73-a55e-8edb69b27e29,Zollie,77,81,0,85,77,16,336,
4282f3ea-f251-4411-a640-27da6d342f47,Zolton,59,24,80,85,4,72,324,
9ad38fe1-efbb-4f3d-9bcf-47e3d49757be,Zong,45,71,85,11,36,1,249,
b0447e63-04f8-4452-b36d-0223c42ef659,Zooey,10,33,25,54,70,73,265,
89430f59-adc8-4d03-83f8-7d14f859902d,Zora,80,75,9,99,91,92,446,
d3395ce4-caae-4318-b200-6a2f073da97e,Zora,24,13,56,32,68,33,226,
55913e69-0333-48a0-855d-5ad8bec94a43,Zori,6,57,6,21,99,56,245,
5d748eb5-80a8-487d-b348-4797990b9413,Zori,35,72,5,19,78,19,228,
ce9e7189-b748-413c-a6b7-b948f917448b,Zori,57,2,81,98,2,67,307,
e4c6db2b-b96e-4a9e-bb49-0662b5d3e94d,Zoriah,92,70,52,98,3,36,351,
0008f226-3a81-421f-94cb-bfb3f8efad91,Zoua,4,69,7,17,3,54,154,
19f70721-cc29-46ac-8ee3-7ef4e66cfe79,Zowie,57,38,34,90,62,40,321,
476c3ea3-e350-4e7f-accb-345207e3be7c,Zudora,86,26,49,80,67,24,332,
b66d0614-bee3-41e4-99ee-347a13ad2db8,Zula,9,43,80,32,70,81,315,
4b8e3614-6673-43df-bbf7-c70b9ac90fae,Zulay,77,22,97,81,25,38,340,
fff7215a-8579-4888-b827-811b4bca27a2,Zulay,45,65,66,18,65,21,280,
08e5022e-1af6-4028-bcb2-3582252db083,Zuleyka,95,53,51,21,94,78,392,
1d6f20b0-a21b-43ce-b842-2990a3a1e86f,Zulma,62,74,40,56,6,54,292,
1c973c37-8981-4287-8c64-16b0ac087599,Zunaira,69,50,25,82,62,40,328,
dd7da6c4-3b56-42e2-b0de-92a68f709e20,Zurie,29,97,15,89,80,8,318,
c93334cb-5c45-4a85-ab33-ef7be959676a,Zuzanna,14,75,84,70,95,75,413,
5036d85a-2e5f-4e13-b98b-74e2a8d6b861,Zvi,89,71,19,52,15,58,304,
d756bb00-1947-4c58-8d66-d7cbc5300aa0,Zvi,40,20,29,56,55,63,263,
84b5066f-2443-403c-a9df-4d66e486d849,Zyair,1,41,60,14,78,1,195,
270f73a3-d87b-4a26-949e-c07d0f59a54f,Zyaira,68,82,53,8,71,10,292,
5f988b2f-4512-4b68-b907-d2be66323813,Zyaire,71,13,63,22,69,25,263,
e932af90-44eb-4bab-8914-54b1a32fe342,Zyana,39,76,88,27,58,2,290,
44df9752-273a-4223-b494-7a7c04953c3b,Zyire,43,76,48,67,49,96,379,
9247b8a3-b2a8-45c3-9d3e-85babfd7a3cc,Zyire,27,71,4,56,40,31,229,
bf941fd2-3039-4dfb-a8fa-2b413a5f9878,Zykeria,30,78,45,35,30,54,272,
d14b4f04-c7c9-4ed0-b8cf-de73050793f7,Zykeriah,76,28,82,83,23,53,345,
d0676bbc-55b5-4685-adcf-977912f9a3ba,Zykerria,20,98,50,85,97,22,372,
240e93d5-9683-4624-9b0f-97edade6f578,Zykia,14,53,52,86,16,11,232,
f962c340-4366-44eb-a8c3-c3b4c0c0df88,Zyla,62,88,60,59,0,36,305,
8ef7de0c-5201-4120-96a7-671efcb3fdf4,Zyla,85,56,16,59,75,87,378,
5ef93f4b-fcbc-4df3-91ab-cf6653774d78,Zylan,84,88,74,45,81,11,383,
a90e371b-9cd2-40e1-94c6-c758fd2b6de2,Zylan,37,22,20,77,14,19,189,
94c0545e-6303-435a-8d4d-237050d73a90,Zymier,19,25,55,75,5,44,223,
2dd2151e-e682-4dcd-ab47-b13a2620acda,Zymir,31,5,10,73,20,64,203,
dc9d1f5b-b290-4310-a0f0-b78fd29a63f2,Zyon,17,42,55,33,22,100,269,
5ee36be2-c7c4-47c4-9213-2a67485b988e,Zyquavious,27,29,76,11,78,87,308,
